scenario_id,time_max,simulation_id,planner,behavior_status,time_spent,robustness,concurrency_true,concurrency_false,ag_0_rest,ag_0_wait,ag_0_work,ag_0_total,ag_1_rest,ag_1_wait,ag_1_work,ag_1_total,ag_2_rest,ag_2_wait,ag_2_work,ag_2_total,ag_3_rest,ag_3_wait,ag_3_work,ag_3_total,ag_4_rest,ag_4_wait,ag_4_work,ag_4_total
8197047,1656,310811,base,completed,247.0,6.75,221,26,17,0,230,247,2,0,245,247,0,0,247,247,2,0,245,247,26,0,221,247
8197047,1656,310811,base+,completed,263.0,7.0,218,45,45,0,218,263,0,0,263,263,22,0,241,263,12,0,251,263,22,0,241,263
8197047,1656,310811,dpv1,completed,288.0,7.35,184,104,75,0,213,288,57,0,231,288,50,0,238,288,50,29,209,288,0,0,288,288
8197047,1656,310811,dpv2,completed,294.0,7.4,162,132,23,0,271,294,0,0,294,294,42,71,181,294,53,64,177,294,45,0,249,294
8197047,1656,310811,new-0.0,completed,265.0,7.3,210,55,55,0,210,265,36,0,229,265,29,0,236,265,49,0,216,265,0,0,265,265
8197047,1656,310811,new-0.5,completed,271.0,7.6,205,66,0,0,271,271,49,0,222,271,27,0,244,271,57,0,214,271,66,0,205,271
8197047,1656,310811,new-1.0,completed,241.0,7.6,222,19,19,0,222,241,18,0,223,241,7,0,234,241,4,0,237,241,0,0,241,241
8197047,1656,208428,base,completed,258.0,7.1,216,42,0,0,258,258,5,0,253,258,17,0,241,258,42,0,216,258,22,0,236,258
8197047,1656,208428,base+,completed,284.0,7.2,194,90,0,17,267,284,16,0,268,284,2,32,250,284,74,0,210,284,68,0,216,284
8197047,1656,208428,dpv1,completed,271.0,7.3,170,101,3,0,268,271,46,0,225,271,0,0,271,271,23,50,198,271,51,0,220,271
8197047,1656,208428,dpv2,completed,268.0,7.5,219,49,18,0,250,268,45,0,223,268,49,0,219,268,29,0,239,268,0,0,268,268
8197047,1656,208428,new-0.0,completed,262.0,7.3,211,51,27,1,234,262,0,2,260,262,47,0,215,262,19,0,243,262,48,0,214,262
8197047,1656,208428,new-0.5,completed,254.0,7.7,208,46,0,0,254,254,46,0,208,254,6,0,248,254,33,0,221,254,19,0,235,254
8197047,1656,208428,new-1.0,completed,254.0,7.5,219,35,34,0,220,254,11,0,243,254,7,0,247,254,0,0,254,254,35,0,219,254
8197047,1656,460300,base,completed,273.0,7.25,192,81,11,0,262,273,13,1,259,273,0,45,228,273,81,0,192,273,51,0,222,273
8197047,1656,460300,base+,completed,256.0,6.9,216,40,40,0,216,256,17,0,239,256,0,0,256,256,35,0,221,256,19,0,237,256
8197047,1656,460300,dpv1,completed,289.0,7.3,166,123,67,0,222,289,56,0,233,289,54,0,235,289,0,0,289,289,17,56,216,289
8197047,1656,460300,dpv2,completed,258.0,7.6,216,42,42,0,216,258,25,0,233,258,14,0,244,258,0,0,258,258,39,0,219,258
8197047,1656,460300,new-0.0,completed,259.0,7.25,218,41,41,0,218,259,36,0,223,259,0,0,259,259,15,0,244,259,34,0,225,259
8197047,1656,460300,new-0.5,completed,259.0,7.6,196,63,0,0,259,259,25,0,234,259,10,0,249,259,42,0,217,259,63,0,196,259
8197047,1656,460300,new-1.0,completed,268.0,7.5,219,49,48,1,219,268,38,0,230,268,0,0,268,268,27,0,241,268,43,0,225,268
8197047,1656,309704,base,completed,249.0,6.95,226,23,0,0,249,249,2,0,247,249,23,0,226,249,20,0,229,249,12,0,237,249
8197047,1656,309704,base+,completed,284.0,6.8,199,85,49,20,215,284,65,0,219,284,62,0,222,284,0,0,284,284,34,0,250,284
8197047,1656,309704,dpv1,completed,301.0,7.3,159,142,65,0,236,301,66,1,234,301,0,0,301,301,51,0,250,301,76,65,160,301
8197047,1656,309704,dpv2,completed,288.0,7.45,170,118,63,0,225,288,0,0,288,288,61,41,186,288,30,41,217,288,38,0,250,288
8197047,1656,309704,new-0.0,completed,266.0,7.35,203,63,47,0,219,266,0,0,266,266,15,0,251,266,58,0,208,266,63,0,203,266
8197047,1656,309704,new-0.5,completed,259.0,7.65,200,59,26,0,233,259,0,0,259,259,59,0,200,259,36,0,223,259,17,0,242,259
8197047,1656,309704,new-1.0,completed,256.0,7.55,215,41,24,0,232,256,1,0,255,256,41,0,215,256,0,0,256,256,40,0,216,256
8197047,1656,247588,base,completed,257.0,6.85,224,33,15,0,242,257,22,0,235,257,22,0,235,257,33,0,224,257,0,0,257,257
8197047,1656,247588,base+,completed,248.0,7.1,204,44,0,0,248,248,2,0,246,248,30,0,218,248,16,0,232,248,44,0,204,248
8197047,1656,247588,dpv1,completed,258.0,7.3,165,93,4,0,254,258,0,49,209,258,32,0,226,258,44,0,214,258,14,0,244,258
8197047,1656,247588,dpv2,completed,250.0,7.5,210,40,8,0,242,250,40,0,210,250,0,0,250,250,24,0,226,250,38,0,212,250
8197047,1656,247588,new-0.0,completed,251.0,7.2,205,46,46,0,205,251,30,0,221,251,0,0,251,251,19,0,232,251,46,0,205,251
8197047,1656,247588,new-0.5,completed,255.0,7.7,205,50,0,0,255,255,29,0,226,255,50,0,205,255,46,0,209,255,24,0,231,255
8197047,1656,247588,new-1.0,completed,248.0,7.5,224,24,24,0,224,248,22,0,226,248,0,0,248,248,2,0,246,248,21,0,227,248
8197047,1656,203195,base,completed,263.0,7.0,227,36,25,0,238,263,13,0,250,263,36,0,227,263,35,0,228,263,0,0,263,263
8197047,1656,203195,base+,completed,282.0,6.95,217,65,26,0,256,282,48,0,234,282,38,0,244,282,0,0,282,282,65,0,217,282
8197047,1656,203195,dpv1,completed,284.0,7.3,183,101,22,0,262,284,60,0,224,284,42,0,242,284,0,35,249,284,66,0,218,284
8197047,1656,203195,dpv2,completed,272.0,7.4,188,84,0,0,272,272,54,0,218,272,59,0,213,272,29,0,243,272,16,25,231,272
8197047,1656,203195,new-0.0,completed,244.0,7.2,198,46,0,0,244,244,14,0,230,244,11,0,233,244,46,0,198,244,18,0,226,244
8197047,1656,203195,new-0.5,completed,243.0,7.7,208,35,2,4,237,243,29,0,214,243,0,0,243,243,31,0,212,243,1,0,242,243
8197047,1656,203195,new-1.0,completed,243.0,7.55,227,16,14,0,229,243,10,0,233,243,8,0,235,243,16,0,227,243,0,0,243,243
8197047,1656,178029,base,completed,249.0,7.1,219,30,0,0,249,249,5,0,244,249,16,0,233,249,30,0,219,249,24,0,225,249
8197047,1656,178029,base+,completed,244.0,7.2,200,44,11,0,233,244,6,0,238,244,0,0,244,244,20,0,224,244,44,0,200,244
8197047,1656,178029,dpv1,completed,267.0,7.25,189,78,9,0,258,267,38,0,229,267,25,0,242,267,50,0,217,267,0,28,239,267
8197047,1656,178029,dpv2,completed,291.0,7.4,158,133,8,0,283,291,0,0,291,291,36,73,182,291,49,68,174,291,38,0,253,291
8197047,1656,178029,new-0.0,completed,265.0,7.3,217,48,0,0,265,265,48,0,217,265,31,0,234,265,44,0,221,265,46,0,219,265
8197047,1656,178029,new-0.5,completed,274.0,7.65,216,58,0,0,274,274,52,0,222,274,21,0,253,274,39,0,235,274,54,4,216,274
8197047,1656,178029,new-1.0,completed,261.0,7.6,223,38,11,0,250,261,38,0,223,261,0,0,261,261,29,0,232,261,22,0,239,261
8197047,1656,239735,base,completed,265.0,7.1,184,81,0,0,265,265,20,21,224,265,29,31,205,265,12,0,253,265,28,0,237,265
8197047,1656,239735,base+,completed,256.0,6.85,205,51,50,0,206,256,4,0,252,256,0,0,256,256,36,1,219,256,44,0,212,256
8197047,1656,239735,dpv1,completed,271.0,7.35,197,74,31,0,240,271,37,0,234,271,0,0,271,271,47,14,210,271,60,0,211,271
8197047,1656,239735,dpv2,completed,284.0,7.3,176,108,67,0,217,284,0,34,250,284,69,0,215,284,41,0,243,284,32,33,219,284
8197047,1656,239735,new-0.0,completed,257.0,7.2,209,48,48,0,209,257,40,0,217,257,0,0,257,257,28,0,229,257,45,0,212,257
8197047,1656,239735,new-0.5,completed,262.0,7.65,197,65,65,0,197,262,25,0,237,262,0,0,262,262,48,0,214,262,59,0,203,262
8197047,1656,239735,new-1.0,completed,262.0,7.6,215,47,40,0,222,262,47,0,215,262,0,0,262,262,46,0,216,262,38,0,224,262
8197047,1656,675528,base,completed,249.0,7.05,226,23,2,0,247,249,23,0,226,249,8,0,241,249,22,0,227,249,0,0,249,249
8197047,1656,675528,base+,completed,251.0,6.85,207,44,7,0,244,251,18,0,233,251,26,0,225,251,1,13,237,251,0,18,233,251
8197047,1656,675528,dpv1,completed,285.0,7.35,172,113,13,0,272,285,56,0,229,285,46,0,239,285,62,51,172,285,0,0,285,285
8197047,1656,675528,dpv2,completed,265.0,7.45,212,53,16,0,249,265,31,0,234,265,53,0,212,265,41,0,224,265,0,0,265,265
8197047,1656,675528,new-0.0,completed,252.0,7.35,208,44,0,0,252,252,23,0,229,252,44,0,208,252,2,0,250,252,44,0,208,252
8197047,1656,675528,new-0.5,completed,276.0,7.45,212,64,0,0,276,276,30,0,246,276,54,0,222,276,64,0,212,276,63,0,213,276
8197047,1656,675528,new-1.0,completed,255.0,7.6,217,38,0,0,255,255,38,0,217,255,28,0,227,255,22,0,233,255,6,0,249,255
8197047,1656,380692,base,completed,244.0,7.15,204,40,11,0,233,244,29,0,215,244,0,0,244,244,7,0,237,244,40,0,204,244
8197047,1656,380692,base+,completed,246.0,7.1,195,51,0,0,246,246,12,0,234,246,21,0,225,246,41,10,195,246,1,5,240,246
8197047,1656,380692,dpv1,completed,274.0,7.25,199,75,35,0,239,274,59,0,215,274,0,0,274,274,45,0,229,274,47,16,211,274
8197047,1656,380692,dpv2,completed,249.0,7.45,215,34,0,0,249,249,3,0,246,249,34,0,215,249,34,0,215,249,9,0,240,249
8197047,1656,380692,new-0.0,completed,248.0,7.35,205,43,43,0,205,248,0,0,248,248,13,0,235,248,11,0,237,248,29,0,219,248
8197047,1656,380692,new-0.5,completed,276.0,7.7,197,79,0,0,276,276,53,1,222,276,78,0,198,276,61,0,215,276,37,0,239,276
8197047,1656,380692,new-1.0,completed,252.0,7.55,220,32,24,0,228,252,26,0,226,252,0,0,252,252,32,0,220,252,9,0,243,252
2663286,1754,310811,base,completed,303.0,6.9,147,156,0,0,303,303,35,0,268,303,71,0,232,303,13,74,216,303,13,43,247,303
2663286,1754,310811,base+,completed,276.0,7.0,220,56,11,0,265,276,0,19,257,276,26,0,250,276,44,0,232,276,1,0,275,276
2663286,1754,310811,dpv1,completed,280.0,6.95,211,69,15,0,265,280,50,5,225,280,0,0,280,280,29,0,251,280,1,28,251,280
2663286,1754,310811,dpv2,completed,309.0,7.1,93,216,0,49,260,309,9,83,217,309,25,80,204,309,12,0,297,309,36,0,273,309
2663286,1754,310811,new-0.0,completed,278.0,7.0,226,52,52,0,226,278,44,0,234,278,0,0,278,278,46,0,232,278,30,0,248,278
2663286,1754,310811,new-0.5,completed,290.0,7.3,222,68,25,0,265,290,58,0,232,290,68,0,222,290,0,0,290,290,41,0,249,290
2663286,1754,310811,new-1.0,completed,298.0,7.35,194,104,0,0,298,298,23,0,275,298,77,0,221,298,33,0,265,298,73,27,198,298
2663286,1754,208428,base,completed,306.0,6.9,133,173,42,101,163,306,3,31,272,306,0,0,306,306,34,0,272,306,19,0,287,306
2663286,1754,208428,base+,completed,283.0,6.7,221,62,28,0,255,283,62,0,221,283,13,0,270,283,28,0,255,283,0,0,283,283
2663286,1754,208428,dpv1,completed,296.0,6.95,216,80,32,0,264,296,13,27,256,296,0,0,296,296,58,0,238,296,51,13,232,296
2663286,1754,208428,dpv2,completed,289.0,7.1,132,157,5,58,226,289,5,0,284,289,0,73,216,289,48,0,241,289,5,0,284,289
2663286,1754,208428,new-0.0,completed,287.0,7.0,227,60,44,0,243,287,59,0,228,287,27,0,260,287,0,0,287,287,60,0,227,287
2663286,1754,208428,new-0.5,completed,272.0,7.35,216,56,4,0,268,272,24,10,238,272,46,0,226,272,0,0,272,272,30,0,242,272
2663286,1754,208428,new-1.0,completed,282.0,7.2,189,93,69,0,213,282,44,0,238,282,24,7,251,282,0,17,265,282,7,0,275,282
2663286,1754,460300,base,completed,291.0,6.9,200,91,33,20,238,291,14,0,277,291,31,18,242,291,0,24,267,291,34,0,257,291
2663286,1754,460300,base+,completed,280.0,6.8,218,62,41,0,239,280,5,0,275,280,43,0,237,280,0,19,261,280,19,0,261,280
2663286,1754,460300,dpv1,completed,294.0,7.0,221,73,44,11,239,294,47,0,247,294,4,0,290,294,0,28,266,294,25,0,269,294
2663286,1754,460300,dpv2,completed,297.0,7.25,140,157,46,53,198,297,5,0,292,297,0,74,223,297,0,0,297,297,0,22,275,297
2663286,1754,460300,new-0.0,completed,288.0,6.95,221,67,40,0,248,288,42,0,246,288,0,0,288,288,51,2,235,288,65,0,223,288
2663286,1754,460300,new-0.5,completed,274.0,7.4,227,47,0,0,274,274,38,0,236,274,12,3,259,274,44,0,230,274,10,0,264,274
2663286,1754,460300,new-1.0,completed,309.0,7.3,191,118,88,0,221,309,36,30,243,309,35,0,274,309,0,0,309,309,72,0,237,309
2663286,1754,309704,base,completed,303.0,6.9,117,186,41,0,262,303,15,0,288,303,9,0,294,303,0,158,145,303,10,16,277,303
2663286,1754,309704,base+,completed,273.0,7.05,214,59,4,0,269,273,2,6,265,273,0,19,254,273,34,0,239,273,11,0,262,273
2663286,1754,309704,dpv1,completed,284.0,7.1,199,85,37,11,236,284,26,0,258,284,6,0,278,284,0,0,284,284,5,48,231,284
2663286,1754,309704,dpv2,completed,292.0,7.1,140,152,53,51,188,292,4,0,288,292,0,67,225,292,7,0,285,292,6,4,282,292
2663286,1754,309704,new-0.0,completed,285.0,7.0,217,68,53,0,232,285,56,0,229,285,68,0,217,285,0,0,285,285,34,0,251,285
2663286,1754,309704,new-0.5,completed,268.0,7.4,220,48,28,0,240,268,0,0,268,268,17,0,251,268,48,0,220,268,24,0,244,268
2663286,1754,309704,new-1.0,completed,298.0,7.25,187,111,0,0,298,298,45,0,253,298,91,5,202,298,51,0,247,298,28,15,255,298
2663286,1754,247588,base,completed,344.0,6.7,198,146,0,108,236,344,71,38,235,344,50,81,213,344,58,0,286,344,30,0,314,344
2663286,1754,247588,base+,completed,292.0,6.9,191,101,27,3,262,292,52,44,196,292,54,0,238,292,0,11,281,292,20,0,272,292
2663286,1754,247588,dpv1,completed,281.0,7.05,211,70,37,11,233,281,28,0,253,281,5,33,243,281,0,0,281,281,23,0,258,281
2663286,1754,247588,dpv2,completed,317.0,7.15,105,212,53,0,264,317,25,107,185,317,16,103,198,317,26,0,291,317,0,25,292,317
2663286,1754,247588,new-0.0,completed,289.0,6.95,221,68,52,0,237,289,57,0,232,289,40,0,249,289,0,0,289,289,68,0,221,289
2663286,1754,247588,new-0.5,completed,271.0,7.35,221,50,50,0,221,271,0,0,271,271,21,0,250,271,42,0,229,271,28,0,243,271
2663286,1754,247588,new-1.0,completed,303.0,7.3,177,126,50,0,253,303,57,36,210,303,70,0,233,303,0,24,279,303,13,20,270,303
2663286,1754,203195,base,completed,362.0,6.9,102,260,9,217,136,362,0,0,362,362,46,113,203,362,19,0,343,362,50,77,235,362
2663286,1754,203195,base+,completed,286.0,6.95,160,126,9,0,277,286,46,0,240,286,0,0,286,286,8,0,278,286,3,86,197,286
2663286,1754,203195,dpv1,completed,296.0,6.85,177,119,44,0,252,296,0,0,296,296,24,0,272,296,8,76,212,296,48,1,247,296
2663286,1754,203195,dpv2,completed,297.0,7.15,144,153,4,39,254,297,47,0,250,297,0,55,242,297,6,0,291,297,5,16,276,297
2663286,1754,203195,new-0.0,completed,270.0,6.9,227,43,0,0,270,270,26,0,244,270,43,0,227,270,29,0,241,270,14,0,256,270
2663286,1754,203195,new-0.5,completed,275.0,7.3,225,50,38,0,237,275,20,0,255,275,0,1,274,275,49,0,226,275,37,0,238,275
2663286,1754,203195,new-1.0,completed,283.0,7.4,191,92,0,0,283,283,14,0,269,283,46,0,237,283,81,11,191,283,32,0,251,283
2663286,1754,178029,base,completed,260.0,6.85,235,25,3,0,257,260,17,0,243,260,0,0,260,260,25,0,235,260,15,0,245,260
2663286,1754,178029,base+,completed,283.0,7.15,187,96,14,0,269,283,20,0,263,283,0,0,283,283,57,0,226,283,12,44,227,283
2663286,1754,178029,dpv1,completed,286.0,7.05,226,60,46,4,236,286,48,0,238,286,0,0,286,286,4,16,266,286,24,0,262,286
2663286,1754,178029,dpv2,completed,296.0,7.15,130,166,1,51,244,296,45,0,251,296,5,97,194,296,5,0,291,296,0,0,296,296
2663286,1754,178029,new-0.0,completed,287.0,7.0,219,68,57,0,230,287,53,0,234,287,0,0,287,287,68,0,219,287,33,0,254,287
2663286,1754,178029,new-0.5,completed,277.0,7.3,234,43,38,0,239,277,0,0,277,277,10,0,267,277,41,0,236,277,43,0,234,277
2663286,1754,178029,new-1.0,completed,290.0,7.15,182,108,12,0,278,290,47,0,243,290,25,0,265,290,0,0,290,290,75,33,182,290
2663286,1754,239735,base,completed,319.0,6.9,154,165,56,0,263,319,26,0,293,319,67,0,252,319,19,18,282,319,0,134,185,319
2663286,1754,239735,base+,completed,305.0,6.9,136,169,62,0,243,305,51,61,193,305,0,21,284,305,11,82,212,305,1,0,304,305
2663286,1754,239735,dpv1,completed,276.0,6.95,225,51,19,0,257,276,36,0,240,276,0,0,276,276,3,11,262,276,41,0,235,276
2663286,1754,239735,dpv2,completed,298.0,7.15,102,196,14,28,256,298,3,91,204,298,21,75,202,298,0,0,298,298,28,0,270,298
2663286,1754,239735,new-0.0,completed,266.0,6.9,226,40,34,0,232,266,1,0,265,266,33,0,233,266,40,0,226,266,0,0,266,266
2663286,1754,239735,new-0.5,completed,276.0,7.25,212,64,54,0,222,276,48,0,228,276,16,0,260,276,64,0,212,276,0,0,276,276
2663286,1754,239735,new-1.0,completed,287.0,7.3,191,96,0,0,287,287,73,23,191,287,59,0,228,287,5,0,282,287,35,0,252,287
2663286,1754,675528,base,completed,270.0,6.85,223,47,4,0,266,270,2,8,260,270,28,0,242,270,22,0,248,270,0,11,259,270
2663286,1754,675528,base+,completed,277.0,7.0,233,44,18,0,259,277,0,0,277,277,16,0,261,277,44,0,233,277,27,0,250,277
2663286,1754,675528,dpv1,completed,287.0,6.9,236,51,33,4,250,287,34,0,253,287,0,0,287,287,8,4,275,287,47,0,240,287
2663286,1754,675528,dpv2,completed,287.0,7.0,140,147,1,52,234,287,3,0,284,287,0,73,214,287,44,0,243,287,3,0,284,287
2663286,1754,675528,new-0.0,completed,290.0,7.0,227,63,63,0,227,290,60,0,230,290,35,0,255,290,48,0,242,290,0,0,290,290
2663286,1754,675528,new-0.5,completed,275.0,7.25,223,52,13,0,262,275,0,0,275,275,27,0,248,275,49,0,226,275,52,0,223,275
2663286,1754,675528,new-1.0,completed,286.0,7.25,204,82,74,0,212,286,36,0,250,286,0,0,286,286,2,8,276,286,42,0,244,286
2663286,1754,380692,base,completed,291.0,6.75,125,166,5,55,231,291,56,0,235,291,0,78,213,291,19,0,272,291,3,0,288,291
2663286,1754,380692,base+,completed,292.0,6.85,192,100,48,0,244,292,7,35,250,292,0,37,255,292,52,0,240,292,37,0,255,292
2663286,1754,380692,dpv1,completed,280.0,7.05,192,88,19,0,261,280,0,66,214,280,3,0,277,280,22,0,258,280,11,0,269,280
2663286,1754,380692,dpv2,completed,299.0,7.1,154,145,12,46,241,299,11,0,288,299,9,73,217,299,0,0,299,299,47,0,252,299
2663286,1754,380692,new-0.0,completed,266.0,6.95,231,35,33,0,233,266,0,0,266,266,31,2,233,266,9,0,257,266,10,0,256,266
2663286,1754,380692,new-0.5,completed,287.0,7.25,225,62,45,0,242,287,62,0,225,287,0,0,287,287,28,0,259,287,49,0,238,287
2663286,1754,380692,new-1.0,completed,300.0,7.2,191,109,0,11,289,300,77,32,191,300,76,0,224,300,31,0,269,300,16,0,284,300
7603660,1599,310811,base,completed,353.0,7.25,105,248,0,74,279,353,29,63,261,353,86,66,201,353,13,62,278,353,9,186,158,353
7603660,1599,310811,base+,completed,266.0,7.05,158,108,25,23,218,266,1,0,265,266,2,10,254,266,1,3,262,266,0,86,180,266
7603660,1599,310811,dpv1,completed,260.0,7.55,121,139,15,27,218,260,20,0,240,260,13,1,246,260,8,109,143,260,0,0,260,260
7603660,1599,310811,dpv2,completed,253.0,7.7,187,66,0,43,210,253,10,0,243,253,27,0,226,253,8,21,224,253,9,0,244,253
7603660,1599,310811,new-0.0,completed,244.0,7.25,190,54,35,5,204,244,2,13,229,244,36,0,208,244,0,0,244,244,21,0,223,244
7603660,1599,310811,new-0.5,completed,240.0,7.85,194,46,0,0,240,240,22,0,218,240,46,0,194,240,13,0,227,240,0,0,240,240
7603660,1599,310811,new-1.0,completed,257.0,7.8,171,86,23,17,217,257,36,23,198,257,0,10,247,257,31,0,226,257,24,0,233,257
7603660,1599,208428,base,completed,315.0,6.95,140,175,37,129,149,315,48,0,267,315,0,63,252,315,13,0,302,315,7,91,217,315
7603660,1599,208428,base+,completed,288.0,7.05,174,114,11,47,230,288,65,13,210,288,0,75,213,288,38,28,222,288,15,0,273,288
7603660,1599,208428,dpv1,completed,294.0,7.5,140,154,11,64,219,294,50,0,244,294,19,12,263,294,15,0,279,294,0,116,178,294
7603660,1599,208428,dpv2,completed,253.0,7.7,193,60,0,39,214,253,5,0,248,253,25,0,228,253,6,15,232,253,11,0,242,253
7603660,1599,208428,new-0.0,completed,246.0,7.35,207,39,4,0,242,246,24,0,222,246,30,0,216,246,0,0,246,246,24,9,213,246
7603660,1599,208428,new-0.5,completed,261.0,7.75,182,79,0,25,236,261,23,2,236,261,9,36,216,261,29,5,227,261,0,0,261,261
7603660,1599,208428,new-1.0,completed,268.0,7.9,161,107,41,8,219,268,0,14,254,268,49,36,183,268,4,0,264,268,46,0,222,268
7603660,1599,460300,base,completed,339.0,6.95,135,204,39,0,300,339,0,132,207,339,29,143,167,339,27,8,304,339,17,120,202,339
7603660,1599,460300,base+,completed,274.0,7.25,178,96,11,33,230,274,32,4,238,274,0,71,203,274,8,0,266,274,32,0,242,274
7603660,1599,460300,dpv1,completed,261.0,7.35,171,90,23,0,238,261,27,0,234,261,18,4,239,261,0,0,261,261,18,63,180,261
7603660,1599,460300,dpv2,completed,259.0,7.6,175,84,0,57,202,259,22,0,237,259,12,0,247,259,36,0,223,259,14,13,232,259
7603660,1599,460300,new-0.0,completed,252.0,7.1,209,43,14,0,238,252,40,0,212,252,35,0,217,252,0,0,252,252,27,3,222,252
7603660,1599,460300,new-0.5,completed,251.0,7.8,201,50,16,9,226,251,37,0,214,251,0,4,247,251,17,0,234,251,14,0,237,251
7603660,1599,460300,new-1.0,completed,267.0,7.8,171,96,0,28,239,267,46,0,221,267,24,14,229,267,28,0,239,267,54,0,213,267
7603660,1599,309704,base,completed,301.0,7.1,145,156,39,38,224,301,18,0,283,301,58,0,243,301,0,129,172,301,13,41,247,301
7603660,1599,309704,base+,completed,237.0,6.9,197,40,0,0,237,237,10,0,227,237,2,12,223,237,12,16,209,237,6,0,231,237
7603660,1599,309704,dpv1,completed,279.0,7.35,142,137,35,19,225,279,54,7,218,279,15,43,221,279,9,0,270,279,0,99,180,279
7603660,1599,309704,dpv2,completed,266.0,7.7,190,76,0,50,216,266,15,0,251,266,31,15,220,266,5,32,229,266,35,0,231,266
7603660,1599,309704,new-0.0,completed,247.0,7.25,196,51,0,3,244,247,33,0,214,247,40,0,207,247,5,0,242,247,37,8,202,247
7603660,1599,309704,new-0.5,completed,248.0,7.75,215,33,18,3,227,248,26,0,222,248,30,0,218,248,23,0,225,248,0,0,248,248
7603660,1599,309704,new-1.0,completed,264.0,7.85,168,96,23,0,241,264,0,0,264,264,31,48,185,264,24,11,229,264,37,0,227,264
7603660,1599,247588,base,completed,277.0,7.1,145,132,38,0,239,277,33,0,244,277,34,41,202,277,19,54,204,277,0,8,269,277
7603660,1599,247588,base+,completed,293.0,7.05,114,179,44,4,245,293,17,3,273,293,10,34,249,293,0,134,159,293,45,41,207,293
7603660,1599,247588,dpv1,completed,284.0,7.6,144,140,36,18,230,284,32,4,248,284,4,65,215,284,0,105,179,284,7,0,277,284
7603660,1599,247588,dpv2,completed,244.0,7.7,195,49,9,27,208,244,14,0,230,244,20,0,224,244,16,15,213,244,0,0,244,244
7603660,1599,247588,new-0.0,completed,237.0,7.35,195,42,6,0,231,237,19,14,204,237,21,0,216,237,0,0,237,237,28,0,209,237
7603660,1599,247588,new-0.5,completed,242.0,7.85,210,32,18,0,224,242,8,0,234,242,19,4,219,242,28,0,214,242,0,0,242,242
7603660,1599,247588,new-1.0,completed,262.0,7.9,155,107,24,9,229,262,0,17,245,262,40,41,181,262,11,0,251,262,32,0,230,262
7603660,1599,203195,base,completed,280.0,7.2,145,135,15,0,265,280,26,6,248,280,6,95,179,280,0,56,224,280,4,0,276,280
7603660,1599,203195,base+,completed,269.0,7.1,183,86,22,0,247,269,11,33,225,269,8,6,255,269,0,55,214,269,32,15,222,269
7603660,1599,203195,dpv1,completed,275.0,7.5,131,144,36,36,203,275,27,0,248,275,7,24,244,275,3,116,156,275,0,0,275,275
7603660,1599,203195,dpv2,completed,243.0,7.75,210,33,0,18,225,243,10,0,233,243,12,0,231,243,3,0,240,243,7,3,233,243
7603660,1599,203195,new-0.0,completed,250.0,7.4,192,58,24,0,226,250,0,0,250,250,53,0,197,250,13,0,237,250,28,5,217,250
7603660,1599,203195,new-0.5,completed,246.0,7.9,213,33,20,8,218,246,16,0,230,246,24,1,221,246,0,0,246,246,15,0,231,246
7603660,1599,203195,new-1.0,completed,255.0,7.75,176,79,9,0,246,255,7,33,215,255,0,14,241,255,8,36,211,255,9,0,246,255
7603660,1599,178029,base,completed,287.0,7.0,143,144,20,0,267,287,41,91,155,287,7,56,224,287,0,0,287,287,19,20,248,287
7603660,1599,178029,base+,completed,271.0,7.0,142,129,13,39,219,271,0,89,182,271,16,0,255,271,11,0,260,271,7,23,241,271
7603660,1599,178029,dpv1,completed,290.0,7.6,162,128,0,105,185,290,28,46,216,290,4,33,253,290,49,0,241,290,3,0,287,290
7603660,1599,178029,dpv2,completed,247.0,7.75,211,36,9,1,237,247,21,0,226,247,20,0,227,247,0,14,233,247,8,0,239,247
7603660,1599,178029,new-0.0,completed,256.0,7.25,190,66,12,0,244,256,27,24,205,256,31,0,225,256,0,0,256,256,42,0,214,256
7603660,1599,178029,new-0.5,completed,259.0,7.85,213,46,22,0,237,259,34,2,223,259,44,0,215,259,40,0,219,259,0,0,259,259
7603660,1599,178029,new-1.0,completed,275.0,7.8,172,103,20,0,255,275,36,14,225,275,33,12,230,275,0,0,275,275,47,30,198,275
7603660,1599,239735,base,completed,256.0,7.2,209,47,28,17,211,256,28,0,228,256,22,0,234,256,0,0,256,256,30,0,226,256
7603660,1599,239735,base+,completed,293.0,7.25,112,181,21,72,200,293,0,119,174,293,22,4,267,293,17,0,276,293,25,42,226,293
7603660,1599,239735,dpv1,completed,288.0,7.5,122,166,38,26,224,288,42,13,233,288,4,72,212,288,14,0,274,288,0,121,167,288
7603660,1599,239735,dpv2,completed,249.0,7.7,199,50,0,24,225,249,14,0,235,249,21,0,228,249,3,9,237,249,19,0,230,249
7603660,1599,239735,new-0.0,completed,253.0,7.35,196,57,37,2,214,253,31,0,222,253,30,0,223,253,0,0,253,253,41,14,198,253
7603660,1599,239735,new-0.5,completed,264.0,7.6,182,82,33,1,230,264,0,27,237,264,18,4,242,264,38,0,226,264,54,2,208,264
7603660,1599,239735,new-1.0,completed,241.0,7.85,182,59,0,0,241,241,1,0,240,241,26,32,183,241,22,0,219,241,27,0,214,241
7603660,1599,675528,base,completed,254.0,7.15,192,62,0,36,218,254,4,0,250,254,9,0,245,254,34,0,220,254,13,12,229,254
7603660,1599,675528,base+,completed,243.0,7.35,210,33,18,0,225,243,15,0,228,243,0,0,243,243,7,7,229,243,22,4,217,243
7603660,1599,675528,dpv1,completed,297.0,7.65,125,172,15,51,231,297,43,30,224,297,51,1,245,297,0,134,163,297,23,0,274,297
7603660,1599,675528,dpv2,completed,248.0,7.7,194,54,0,29,219,248,5,0,243,248,23,0,225,248,7,12,229,248,2,0,246,248
7603660,1599,675528,new-0.0,completed,247.0,7.1,185,62,0,6,241,247,3,4,240,247,21,0,226,247,35,1,211,247,15,23,209,247
7603660,1599,675528,new-0.5,completed,241.0,7.85,208,33,0,0,241,241,0,0,241,241,33,0,208,241,13,0,228,241,9,0,232,241
7603660,1599,675528,new-1.0,completed,272.0,7.85,179,93,0,0,272,272,30,35,207,272,19,23,230,272,26,5,241,272,28,0,244,272
7603660,1599,380692,base,completed,246.0,7.0,167,79,30,7,209,246,0,0,246,246,7,27,212,246,17,25,204,246,15,0,231,246
7603660,1599,380692,base+,completed,271.0,7.05,140,131,9,12,250,271,11,0,260,271,28,28,215,271,7,0,264,271,0,109,162,271
7603660,1599,380692,dpv1,completed,276.0,7.7,140,136,4,20,252,276,24,0,252,276,33,39,204,276,0,113,163,276,10,0,266,276
7603660,1599,380692,dpv2,completed,262.0,7.7,186,76,0,41,221,262,11,0,251,262,31,3,228,262,9,30,223,262,10,0,252,262
7603660,1599,380692,new-0.0,completed,242.0,7.4,209,33,9,0,233,242,23,0,219,242,0,0,242,242,20,0,222,242,33,0,209,242
7603660,1599,380692,new-0.5,completed,246.0,7.7,165,81,0,21,225,246,28,1,217,246,5,12,229,246,7,27,212,246,6,0,240,246
7603660,1599,380692,new-1.0,completed,262.0,7.85,197,65,0,0,262,262,28,13,221,262,26,15,221,262,25,9,228,262,27,0,235,262
6921862,1622,310811,base,completed,307.0,7.0,204,103,90,0,217,307,43,0,264,307,103,0,204,307,77,0,230,307,0,42,265,307
6921862,1622,310811,base+,completed,306.0,6.65,204,102,67,0,239,306,88,0,218,306,41,12,253,306,0,49,257,306,78,0,228,306
6921862,1622,310811,dpv1,completed,334.0,7.0,135,199,0,135,199,334,42,0,292,334,85,0,249,334,95,0,239,334,89,51,194,334
6921862,1622,310811,dpv2,completed,337.0,7.3,124,213,115,0,222,337,0,175,162,337,99,0,238,337,38,0,299,337,114,0,223,337
6921862,1622,310811,new-0.0,completed,299.0,6.75,198,101,0,36,263,299,101,0,198,299,88,0,211,299,92,0,207,299,39,0,260,299
6921862,1622,310811,new-0.5,completed,288.0,7.35,208,80,78,0,210,288,41,2,245,288,77,0,211,288,0,18,270,288,76,0,212,288
6921862,1622,310811,new-1.0,completed,265.0,7.3,181,84,41,0,224,265,4,14,247,265,44,0,221,265,45,19,201,265,0,10,255,265
6921862,1622,208428,base,completed,308.0,6.65,201,107,107,0,201,308,99,0,209,308,67,0,241,308,41,0,267,308,0,38,270,308
6921862,1622,208428,base+,completed,300.0,6.5,204,96,0,31,269,300,41,0,259,300,92,0,208,300,75,0,225,300,96,0,204,300
6921862,1622,208428,dpv1,completed,311.0,6.9,192,119,89,0,222,311,36,0,275,311,99,1,211,311,80,0,231,311,0,80,231,311
6921862,1622,208428,dpv2,completed,304.0,7.35,200,104,46,0,258,304,93,0,211,304,99,0,205,304,104,0,200,304,0,34,270,304
6921862,1622,208428,new-0.0,completed,275.0,6.85,205,70,63,0,212,275,69,0,206,275,70,0,205,275,0,0,275,275,44,0,231,275
6921862,1622,208428,new-0.5,completed,286.0,7.5,197,89,70,0,216,286,39,4,243,286,0,5,281,286,76,8,202,286,77,0,209,286
6921862,1622,208428,new-1.0,completed,281.0,7.3,158,123,40,0,241,281,19,24,238,281,64,0,217,281,47,29,205,281,0,30,251,281
6921862,1622,460300,base,completed,339.0,6.65,118,221,85,0,254,339,41,0,298,339,102,50,187,339,95,0,244,339,0,130,209,339
6921862,1622,460300,base+,completed,307.0,6.95,210,97,97,0,210,307,0,28,279,307,93,0,214,307,87,0,220,307,40,0,267,307
6921862,1622,460300,dpv1,completed,329.0,7.05,168,161,37,32,260,329,101,0,228,329,91,0,238,329,0,79,250,329,99,33,197,329
6921862,1622,460300,dpv2,completed,302.0,7.25,203,99,38,0,264,302,0,54,248,302,99,0,203,302,94,0,208,302,69,0,233,302
6921862,1622,460300,new-0.0,completed,288.0,6.85,207,81,79,0,209,288,60,0,228,288,0,11,277,288,41,0,247,288,81,0,207,288
6921862,1622,460300,new-0.5,completed,276.0,7.3,206,70,29,0,247,276,65,0,211,276,70,0,206,276,0,2,274,276,39,0,237,276
6921862,1622,460300,new-1.0,completed,283.0,7.3,153,130,39,0,244,283,8,32,243,283,52,0,231,283,41,46,196,283,0,13,270,283
6921862,1622,309704,base,completed,305.0,6.95,151,154,0,34,271,305,43,0,262,305,77,55,173,305,99,0,206,305,78,0,227,305
6921862,1622,309704,base+,completed,295.0,6.7,198,97,35,0,260,295,97,0,198,295,0,43,252,295,73,0,222,295,70,0,225,295
6921862,1622,309704,dpv1,completed,319.0,6.95,174,145,105,0,214,319,43,9,267,319,87,0,232,319,0,58,261,319,91,31,197,319
6921862,1622,309704,dpv2,completed,304.0,7.3,202,102,38,0,266,304,0,33,271,304,94,0,210,304,93,0,211,304,102,0,202,304
6921862,1622,309704,new-0.0,completed,300.0,6.7,202,98,37,0,263,300,98,0,202,300,91,0,209,300,72,0,228,300,0,47,253,300
6921862,1622,309704,new-0.5,completed,287.0,7.5,198,89,65,0,222,287,41,3,243,287,82,0,205,287,73,4,210,287,0,10,277,287
6921862,1622,309704,new-1.0,completed,307.0,7.4,154,153,93,0,214,307,0,67,240,307,46,0,261,307,89,23,195,307,64,0,243,307
6921862,1622,247588,base,completed,304.0,7.0,206,98,98,0,206,304,96,0,208,304,39,0,265,304,0,34,270,304,91,0,213,304
6921862,1622,247588,base+,completed,283.0,6.7,156,127,28,0,255,283,71,0,212,283,45,0,238,283,0,94,189,283,33,0,250,283
6921862,1622,247588,dpv1,completed,316.0,7.2,120,196,36,89,191,316,0,53,263,316,64,0,252,316,71,0,245,316,80,45,191,316
6921862,1622,247588,dpv2,completed,311.0,7.1,147,164,64,0,247,311,38,0,273,311,93,0,218,311,91,0,220,311,0,126,185,311
6921862,1622,247588,new-0.0,completed,293.0,6.9,199,94,88,0,205,293,34,0,259,293,0,31,262,293,74,0,219,293,94,0,199,293
6921862,1622,247588,new-0.5,completed,291.0,7.5,190,101,65,0,226,291,38,10,243,291,85,0,206,291,78,6,207,291,0,21,270,291
6921862,1622,247588,new-1.0,completed,291.0,7.3,161,130,39,0,252,291,71,37,183,291,72,0,219,291,22,21,248,291,0,32,259,291
6921862,1622,203195,base,completed,308.0,6.7,179,129,0,56,252,308,102,0,206,308,75,0,233,308,80,0,228,308,39,27,242,308
6921862,1622,203195,base+,completed,311.0,7.0,205,106,106,0,205,311,44,0,267,311,85,0,226,311,100,0,211,311,0,39,272,311
6921862,1622,203195,dpv1,completed,337.0,7.1,161,176,116,45,176,337,105,0,232,337,43,0,294,337,96,0,241,337,0,112,225,337
6921862,1622,203195,dpv2,completed,305.0,7.2,208,97,97,0,208,305,0,51,254,305,83,0,222,305,39,0,266,305,93,0,212,305
6921862,1622,203195,new-0.0,completed,308.0,6.9,187,121,113,0,195,308,40,0,268,308,121,0,187,308,89,0,219,308,0,45,263,308
6921862,1622,203195,new-0.5,completed,299.0,7.4,205,94,89,0,210,299,38,1,260,299,0,27,272,299,84,3,212,299,90,0,209,299
6921862,1622,203195,new-1.0,completed,301.0,7.45,152,149,77,0,224,301,77,70,154,301,0,17,284,301,79,0,222,301,39,0,262,301
6921862,1622,178029,base,completed,290.0,6.85,198,92,35,0,255,290,86,0,204,290,0,26,264,290,71,0,219,290,92,0,198,290
6921862,1622,178029,base+,completed,325.0,6.85,159,166,90,0,235,325,80,0,245,325,95,0,230,325,0,121,204,325,45,0,280,325
6921862,1622,178029,dpv1,completed,312.0,6.9,156,156,0,58,254,312,79,0,233,312,97,3,212,312,39,0,273,312,79,36,197,312
6921862,1622,178029,dpv2,completed,308.0,7.25,197,111,111,0,197,308,0,52,256,308,42,0,266,308,99,0,209,308,87,0,221,308
6921862,1622,178029,new-0.0,completed,277.0,6.8,193,84,69,0,208,277,0,7,270,277,80,4,193,277,35,0,242,277,44,0,233,277
6921862,1622,178029,new-0.5,completed,289.0,7.5,193,96,81,0,208,289,44,10,235,289,85,0,204,289,69,1,219,289,0,11,278,289
6921862,1622,178029,new-1.0,completed,295.0,7.3,166,129,43,0,252,295,19,20,256,295,73,0,222,295,57,36,202,295,0,23,272,295
6921862,1622,239735,base,completed,298.0,6.9,199,99,78,0,220,298,0,30,268,298,99,0,199,298,42,0,256,298,79,0,219,298
6921862,1622,239735,base+,completed,298.0,6.85,130,168,60,82,156,298,86,0,212,298,0,9,289,298,41,0,257,298,79,0,219,298
6921862,1622,239735,dpv1,completed,328.0,7.0,152,176,38,31,259,328,104,0,224,328,102,0,226,328,0,98,230,328,102,24,202,328
6921862,1622,239735,dpv2,completed,319.0,7.2,141,178,71,0,248,319,93,0,226,319,0,139,180,319,97,0,222,319,39,0,280,319
6921862,1622,239735,new-0.0,completed,286.0,6.75,200,86,82,0,204,286,66,0,220,286,86,0,200,286,43,0,243,286,0,35,251,286
6921862,1622,239735,new-0.5,completed,281.0,7.45,195,86,63,0,218,281,0,27,254,281,39,0,242,281,71,4,206,281,82,0,199,281
6921862,1622,239735,new-1.0,completed,281.0,7.3,166,115,43,0,238,281,67,39,175,281,69,0,212,281,13,7,261,281,0,18,263,281
6921862,1622,675528,base,completed,282.0,6.6,196,86,0,0,282,282,73,10,199,282,76,0,206,282,26,0,256,282,53,0,229,282
6921862,1622,675528,base+,completed,313.0,7.1,172,141,86,0,227,313,0,35,278,313,71,0,242,313,37,0,276,313,108,33,172,313
6921862,1622,675528,dpv1,completed,337.0,7.05,149,188,39,41,257,337,106,0,231,337,102,0,235,337,0,92,245,337,102,41,194,337
6921862,1622,675528,dpv2,completed,309.0,7.25,204,105,90,0,219,309,0,42,267,309,45,0,264,309,85,0,224,309,105,0,204,309
6921862,1622,675528,new-0.0,completed,305.0,6.9,197,108,108,0,197,305,42,0,263,305,0,37,268,305,76,0,229,305,106,0,199,305
6921862,1622,675528,new-0.5,completed,306.0,7.45,190,116,93,0,213,306,0,29,277,306,97,0,209,306,42,0,264,306,113,3,190,306
6921862,1622,675528,new-1.0,completed,279.0,7.5,155,124,40,0,239,279,7,43,229,279,47,0,232,279,20,31,228,279,0,21,258,279
6921862,1622,380692,base,completed,352.0,7.0,100,252,57,0,295,352,82,0,270,352,42,0,310,352,117,62,173,352,0,210,142,352
6921862,1622,380692,base+,completed,294.0,6.65,195,99,78,0,216,294,39,0,255,294,88,0,206,294,64,11,219,294,0,32,262,294
6921862,1622,380692,dpv1,completed,313.0,6.85,164,149,41,47,225,313,89,0,224,313,0,34,279,313,102,0,211,313,82,16,215,313
6921862,1622,380692,dpv2,completed,312.0,7.1,203,109,97,0,215,312,109,0,203,312,38,0,274,312,105,0,207,312,0,49,263,312
6921862,1622,380692,new-0.0,completed,272.0,6.85,203,69,60,0,212,272,0,13,259,272,44,0,228,272,36,0,236,272,69,0,203,272
6921862,1622,380692,new-0.5,completed,291.0,7.5,199,92,92,0,199,291,46,0,245,291,87,0,204,291,80,0,211,291,0,14,277,291
6921862,1622,380692,new-1.0,completed,264.0,7.35,185,79,54,0,210,264,7,25,232,264,37,0,227,264,52,0,212,264,0,9,255,264
2055956,1882,310811,base,completed,391.0,6.8,118,273,0,51,340,391,14,0,377,391,36,56,299,391,70,120,201,391,76,108,207,391
2055956,1882,310811,base+,completed,398.0,6.85,87,311,26,140,232,398,73,2,323,398,0,285,113,398,68,0,330,398,35,0,363,398
2055956,1882,310811,dpv1,completed,372.0,7.2,140,232,24,0,348,372,0,206,166,372,26,93,253,372,56,26,290,372,80,5,287,372
2055956,1882,310811,dpv2,completed,318.0,7.25,194,124,25,0,293,318,0,38,280,318,69,5,244,318,3,50,265,318,47,0,271,318
2055956,1882,310811,new-0.0,completed,300.0,7.1,236,64,41,0,259,300,17,6,277,300,0,0,300,300,52,6,242,300,29,0,271,300
2055956,1882,310811,new-0.5,completed,303.0,7.35,216,87,0,47,256,303,35,0,268,303,13,13,277,303,27,7,269,303,30,0,273,303
2055956,1882,310811,new-1.0,completed,304.0,7.35,227,77,53,4,247,304,9,28,267,304,28,0,276,304,0,3,301,304,35,5,264,304
2055956,1882,208428,base,completed,308.0,7.05,217,91,47,0,261,308,4,13,291,308,30,0,278,308,0,33,275,308,30,0,278,308
2055956,1882,208428,base+,completed,340.0,6.9,161,179,73,0,267,340,22,134,184,340,44,0,296,340,0,35,305,340,45,0,295,340
2055956,1882,208428,dpv1,completed,375.0,7.1,146,229,32,0,343,375,31,102,242,375,0,198,177,375,43,27,305,375,95,0,280,375
2055956,1882,208428,dpv2,completed,334.0,7.2,154,180,69,0,265,334,7,148,179,334,32,0,302,334,0,30,304,334,50,0,284,334
2055956,1882,208428,new-0.0,completed,289.0,7.15,243,46,37,1,251,289,12,8,269,289,33,0,256,289,0,0,289,289,30,0,259,289
2055956,1882,208428,new-0.5,completed,309.0,7.45,238,71,0,11,298,309,23,0,286,309,28,5,276,309,55,0,254,309,36,0,273,309
2055956,1882,208428,new-1.0,completed,330.0,7.5,149,181,0,31,299,330,66,55,209,330,31,41,258,330,27,0,303,330,32,0,298,330
2055956,1882,460300,base,completed,372.0,7.15,128,244,29,114,229,372,0,154,218,372,28,63,281,372,67,0,305,372,34,11,327,372
2055956,1882,460300,base+,completed,346.0,6.85,129,217,31,17,298,346,6,18,322,346,0,177,169,346,49,0,297,346,56,0,290,346
2055956,1882,460300,dpv1,completed,372.0,7.25,145,227,87,0,285,372,33,0,339,372,0,192,180,372,60,12,300,372,35,81,256,372
2055956,1882,460300,dpv2,completed,340.0,7.35,151,189,31,0,309,340,0,158,182,340,9,22,309,340,64,0,276,340,49,0,291,340
2055956,1882,460300,new-0.0,completed,319.0,7.0,239,80,21,2,296,319,32,23,264,319,53,0,266,319,0,41,278,319,39,0,280,319
2055956,1882,460300,new-0.5,completed,311.0,7.2,238,73,22,0,289,311,49,0,262,311,30,24,257,311,0,33,278,311,33,0,278,311
2055956,1882,460300,new-1.0,completed,336.0,7.4,185,151,0,24,312,336,83,12,241,336,54,36,246,336,27,0,309,336,79,0,257,336
2055956,1882,309704,base,completed,317.0,6.9,200,117,25,0,292,317,47,70,200,317,15,0,302,317,0,24,293,317,37,0,280,317
2055956,1882,309704,base+,completed,380.0,6.75,85,295,29,42,309,380,0,25,355,380,4,266,110,380,41,36,303,380,83,0,297,380
2055956,1882,309704,dpv1,completed,376.0,7.2,141,235,31,0,345,376,0,206,170,376,29,86,261,376,76,15,285,376,84,4,288,376
2055956,1882,309704,dpv2,completed,331.0,7.25,193,138,36,0,295,331,7,72,252,331,75,0,256,331,0,56,275,331,49,0,282,331
2055956,1882,309704,new-0.0,completed,308.0,6.95,227,81,6,9,293,308,30,0,278,308,39,0,269,308,0,42,266,308,53,0,255,308
2055956,1882,309704,new-0.5,completed,309.0,7.4,234,75,19,7,283,309,40,0,269,309,32,15,262,309,0,33,276,309,40,0,269,309
2055956,1882,309704,new-1.0,completed,311.0,7.4,208,103,0,11,300,311,66,11,234,311,51,4,256,311,14,0,297,311,20,26,265,311
2055956,1882,247588,base,completed,327.0,6.85,146,181,44,0,283,327,38,0,289,327,11,136,180,327,0,9,318,327,45,3,279,327
2055956,1882,247588,base+,completed,364.0,7.0,148,216,67,41,256,364,27,107,230,364,21,0,343,364,44,7,313,364,0,163,201,364
2055956,1882,247588,dpv1,completed,351.0,7.2,130,221,0,193,158,351,28,0,323,351,66,0,285,351,45,18,288,351,28,85,238,351
2055956,1882,247588,dpv2,completed,340.0,7.3,193,147,73,0,267,340,0,122,218,340,32,0,308,340,48,19,273,340,25,45,270,340
2055956,1882,247588,new-0.0,completed,310.0,7.05,238,72,29,0,281,310,29,25,256,310,51,0,259,310,0,43,267,310,21,0,289,310
2055956,1882,247588,new-0.5,completed,289.0,7.4,231,58,0,29,260,289,31,0,258,289,8,6,275,289,23,6,260,289,28,0,261,289
2055956,1882,247588,new-1.0,completed,322.0,7.35,153,169,72,26,224,322,57,38,227,322,50,31,241,322,13,0,309,322,0,2,320,322
2055956,1882,203195,base,completed,377.0,6.9,153,224,0,192,185,377,58,0,319,377,45,0,332,377,3,157,217,377,32,65,280,377
2055956,1882,203195,base+,completed,363.0,7.1,127,236,0,157,206,363,88,1,274,363,41,0,322,363,38,47,278,363,7,32,324,363
2055956,1882,203195,dpv1,completed,388.0,7.0,151,237,105,0,283,388,35,0,353,388,31,105,252,388,59,36,293,388,0,206,182,388
2055956,1882,203195,dpv2,completed,335.0,7.35,206,129,0,45,290,335,32,0,303,335,92,6,237,335,4,58,273,335,52,0,283,335
2055956,1882,203195,new-0.0,completed,311.0,7.1,219,92,30,19,262,311,24,0,287,311,34,0,277,311,0,62,249,311,36,0,275,311
2055956,1882,203195,new-0.5,completed,309.0,7.3,225,84,0,40,269,309,25,0,284,309,39,0,270,309,33,11,265,309,13,11,285,309
2055956,1882,203195,new-1.0,completed,320.0,7.35,191,129,75,12,233,320,0,28,292,320,59,10,251,320,12,0,308,320,34,28,258,320
2055956,1882,178029,base,completed,375.0,6.85,78,297,1,33,341,375,0,151,224,375,81,135,159,375,27,43,305,375,64,0,311,375
2055956,1882,178029,base+,completed,342.0,7.0,170,172,28,23,291,342,64,0,278,342,25,55,262,342,0,144,198,342,31,0,311,342
2055956,1882,178029,dpv1,completed,351.0,7.05,145,206,46,0,305,351,30,58,263,351,0,176,175,351,30,0,321,351,85,0,266,351
2055956,1882,178029,dpv2,completed,327.0,7.3,156,171,26,0,301,327,0,145,182,327,4,31,292,327,50,0,277,327,32,0,295,327
2055956,1882,178029,new-0.0,completed,294.0,7.1,234,60,44,0,250,294,0,16,278,294,30,0,264,294,2,2,290,294,38,0,256,294
2055956,1882,178029,new-0.5,completed,309.0,7.25,236,73,8,7,294,309,54,0,255,309,48,0,261,309,29,0,280,309,0,37,272,309
2055956,1882,178029,new-1.0,completed,312.0,7.3,191,121,0,29,283,312,48,21,243,312,5,21,286,312,15,0,297,312,50,0,262,312
2055956,1882,239735,base,completed,361.0,7.2,131,230,24,129,208,361,83,68,210,361,0,43,318,361,71,24,266,361,23,0,338,361
2055956,1882,239735,base+,completed,356.0,6.85,106,250,0,214,142,356,8,0,348,356,74,0,282,356,36,12,308,356,48,57,251,356
2055956,1882,239735,dpv1,completed,353.0,7.2,143,210,23,81,249,353,29,0,324,353,85,0,268,353,47,5,301,353,0,187,166,353
2055956,1882,239735,dpv2,completed,320.0,7.3,162,158,41,0,279,320,12,122,186,320,0,0,320,320,56,0,264,320,36,21,263,320
2055956,1882,239735,new-0.0,completed,290.0,7.05,225,65,0,8,282,290,38,0,252,290,38,0,252,290,5,23,262,290,33,6,251,290
2055956,1882,239735,new-0.5,completed,301.0,7.35,224,77,30,0,271,301,53,0,248,301,0,36,265,301,6,14,281,301,27,12,262,301
2055956,1882,239735,new-1.0,completed,328.0,7.35,166,162,67,30,231,328,0,22,306,328,41,53,234,328,17,0,311,328,67,15,246,328
2055956,1882,675528,base,completed,405.0,6.7,150,255,0,221,184,405,39,0,366,405,34,186,185,405,63,0,342,405,95,35,275,405
2055956,1882,675528,base+,completed,329.0,6.8,168,161,30,3,296,329,19,0,310,329,0,137,192,329,9,26,294,329,24,27,278,329
2055956,1882,675528,dpv1,completed,365.0,7.4,153,212,27,65,273,365,0,185,180,365,34,0,331,365,59,14,292,365,93,0,272,365
2055956,1882,675528,dpv2,completed,322.0,7.4,189,133,43,0,279,322,0,105,217,322,28,2,292,322,1,38,283,322,33,0,289,322
2055956,1882,675528,new-0.0,completed,308.0,6.95,232,76,0,42,266,308,24,3,281,308,28,0,280,308,27,0,281,308,31,25,252,308
2055956,1882,675528,new-0.5,completed,321.0,7.35,227,94,29,23,269,321,67,5,249,321,26,0,295,321,0,46,275,321,17,14,290,321
2055956,1882,675528,new-1.0,completed,317.0,7.4,195,122,63,12,242,317,0,35,282,317,18,0,299,317,41,0,276,317,12,34,271,317
2055956,1882,380692,base,completed,357.0,7.0,120,237,90,0,267,357,0,74,283,357,46,0,311,357,22,0,335,357,30,194,133,357
2055956,1882,380692,base+,completed,325.0,6.95,146,179,15,133,177,325,49,0,276,325,46,0,279,325,0,15,310,325,47,0,278,325
2055956,1882,380692,dpv1,completed,364.0,7.25,140,224,32,0,332,364,0,195,169,364,77,0,287,364,51,11,302,364,29,73,262,364
2055956,1882,380692,dpv2,completed,330.0,7.3,158,172,0,29,301,330,0,143,187,330,29,0,301,330,41,0,289,330,47,0,283,330
2055956,1882,380692,new-0.0,completed,293.0,7.15,233,60,28,3,262,293,0,25,268,293,29,0,264,293,0,7,286,293,32,0,261,293
2055956,1882,380692,new-0.5,completed,298.0,7.25,238,60,29,0,269,298,35,0,263,298,10,0,288,298,0,22,276,298,30,14,254,298
2055956,1882,380692,new-1.0,completed,332.0,7.4,176,156,0,36,296,332,69,12,251,332,68,10,254,332,17,0,315,332,41,30,261,332
8850189,1578,310811,base,completed,260.0,6.95,189,71,71,0,189,260,28,0,232,260,35,0,225,260,13,0,247,260,0,27,233,260
8850189,1578,310811,base+,completed,276.0,7.05,186,90,69,0,207,276,0,0,276,276,76,0,200,276,51,0,225,276,51,14,211,276
8850189,1578,310811,dpv1,completed,276.0,7.15,150,126,24,25,227,276,39,27,210,276,73,0,203,276,39,17,220,276,0,0,276,276
8850189,1578,310811,dpv2,completed,270.0,7.45,172,98,0,0,270,270,28,0,242,270,59,35,176,270,46,0,224,270,63,0,207,270
8850189,1578,310811,new-0.0,completed,263.0,7.15,191,72,61,0,202,263,72,0,191,263,44,0,219,263,44,0,219,263,0,0,263,263
8850189,1578,310811,new-0.5,completed,270.0,7.4,195,75,75,0,195,270,0,0,270,270,41,0,229,270,57,0,213,270,62,0,208,270
8850189,1578,310811,new-1.0,completed,267.0,7.35,192,75,69,0,198,267,53,0,214,267,0,0,267,267,48,0,219,267,44,6,217,267
8850189,1578,208428,base,completed,270.0,7.3,187,83,46,0,224,270,0,0,270,270,27,14,229,270,69,0,201,270,38,0,232,270
8850189,1578,208428,base+,completed,275.0,7.05,185,90,55,10,210,275,72,0,203,275,56,0,219,275,39,9,227,275,0,0,275,275
8850189,1578,208428,dpv1,completed,267.0,7.1,201,66,53,0,214,267,0,0,267,267,34,9,224,267,43,0,224,267,57,0,210,267
8850189,1578,208428,dpv2,completed,261.0,7.35,168,93,19,0,242,261,0,0,261,261,26,0,235,261,58,0,203,261,44,35,182,261
8850189,1578,208428,new-0.0,completed,263.0,7.05,185,78,40,0,223,263,77,1,185,263,59,0,204,263,0,0,263,263,19,0,244,263
8850189,1578,208428,new-0.5,completed,271.0,7.3,195,76,29,0,242,271,76,0,195,271,0,0,271,271,69,0,202,271,54,0,217,271
8850189,1578,208428,new-1.0,completed,260.0,7.45,176,84,46,19,195,260,0,0,260,260,18,0,242,260,42,0,218,260,23,19,218,260
8850189,1578,460300,base,completed,274.0,7.05,199,75,75,0,199,274,69,0,205,274,27,0,247,274,55,0,219,274,0,0,274,274
8850189,1578,460300,base+,completed,267.0,7.1,187,80,66,0,201,267,53,0,214,267,0,0,267,267,31,0,236,267,80,0,187,267
8850189,1578,460300,dpv1,completed,252.0,7.05,206,46,41,0,211,252,35,0,217,252,0,0,252,252,45,1,206,252,21,0,231,252
8850189,1578,460300,dpv2,completed,256.0,7.25,180,76,67,0,189,256,13,0,243,256,30,9,217,256,0,0,256,256,31,0,225,256
8850189,1578,460300,new-0.0,completed,271.0,7.05,193,78,48,0,223,271,0,0,271,271,54,0,217,271,50,0,221,271,78,0,193,271
8850189,1578,460300,new-0.5,completed,283.0,7.45,187,96,88,0,195,283,0,0,283,283,70,0,213,283,48,15,220,283,65,0,218,283
8850189,1578,460300,new-1.0,completed,273.0,7.3,186,87,0,0,273,273,87,0,186,273,38,0,235,273,71,0,202,273,24,0,249,273
8850189,1578,309704,base,completed,263.0,6.85,192,71,12,0,251,263,0,38,225,263,8,0,255,263,70,0,193,263,54,1,208,263
8850189,1578,309704,base+,completed,261.0,6.9,186,75,64,0,197,261,43,0,218,261,0,0,261,261,29,11,221,261,52,0,209,261
8850189,1578,309704,dpv1,completed,253.0,6.95,199,54,42,0,211,253,21,9,223,253,0,0,253,253,31,0,222,253,45,0,208,253
8850189,1578,309704,dpv2,completed,258.0,7.45,189,69,38,0,220,258,13,0,245,258,0,18,240,258,30,0,228,258,51,0,207,258
8850189,1578,309704,new-0.0,completed,270.0,7.25,189,81,46,0,224,270,0,0,270,270,58,0,212,270,61,0,209,270,81,0,189,270
8850189,1578,309704,new-0.5,completed,277.0,7.35,190,87,60,0,217,277,86,0,191,277,60,0,217,277,41,11,225,277,0,0,277,277
8850189,1578,309704,new-1.0,completed,253.0,7.45,174,79,39,17,197,253,2,1,250,253,0,0,253,253,45,16,192,253,11,0,242,253
8850189,1578,247588,base,completed,275.0,6.95,200,75,62,0,213,275,69,0,206,275,39,0,236,275,0,0,275,275,43,6,226,275
8850189,1578,247588,base+,completed,256.0,6.9,185,71,41,0,215,256,35,0,221,256,33,7,216,256,64,0,192,256,0,0,256,256
8850189,1578,247588,dpv1,completed,240.0,7.15,190,50,3,12,225,240,36,2,202,240,35,0,205,240,0,0,240,240,17,0,223,240
8850189,1578,247588,dpv2,completed,247.0,7.3,154,93,49,0,198,247,27,0,220,247,27,44,176,247,0,0,247,247,0,0,247,247
8850189,1578,247588,new-0.0,completed,259.0,7.05,180,79,56,0,203,259,0,0,259,259,37,0,222,259,79,0,180,259,40,0,219,259
8850189,1578,247588,new-0.5,completed,251.0,7.4,180,71,36,0,215,251,0,0,251,251,33,0,218,251,45,0,206,251,67,4,180,251
8850189,1578,247588,new-1.0,completed,255.0,7.45,173,82,40,25,190,255,0,9,246,255,8,0,247,255,30,0,225,255,48,0,207,255
8850189,1578,203195,base,completed,303.0,6.9,147,156,68,29,206,303,25,78,200,303,79,31,193,303,0,0,303,303,48,0,255,303
8850189,1578,203195,base+,completed,269.0,6.9,196,73,23,0,246,269,58,0,211,269,0,0,269,269,73,0,196,269,42,0,227,269
8850189,1578,203195,dpv1,completed,259.0,7.2,205,54,47,0,212,259,54,0,205,259,33,0,226,259,46,0,213,259,0,0,259,259
8850189,1578,203195,dpv2,completed,263.0,7.25,172,91,0,0,263,263,44,0,219,263,58,33,172,263,36,0,227,263,30,4,229,263
8850189,1578,203195,new-0.0,completed,261.0,6.95,187,74,44,0,217,261,74,0,187,261,28,0,233,261,32,0,229,261,0,0,261,261
8850189,1578,203195,new-0.5,completed,263.0,7.35,189,74,50,0,213,263,72,0,191,263,47,0,216,263,29,12,222,263,0,0,263,263
8850189,1578,203195,new-1.0,completed,285.0,7.35,201,84,74,10,201,285,74,0,211,285,0,0,285,285,72,0,213,285,65,0,220,285
8850189,1578,178029,base,completed,254.0,6.95,154,100,28,0,226,254,33,12,209,254,8,67,179,254,14,0,240,254,0,0,254,254
8850189,1578,178029,base+,completed,261.0,7.05,190,71,71,0,190,261,37,0,224,261,49,0,212,261,34,0,227,261,0,0,261,261
8850189,1578,178029,dpv1,completed,260.0,7.25,203,57,52,0,208,260,0,0,260,260,35,0,225,260,18,1,241,260,39,4,217,260
8850189,1578,178029,dpv2,completed,255.0,7.25,189,66,39,0,216,255,66,0,189,255,0,0,255,255,21,0,234,255,31,0,224,255
8850189,1578,178029,new-0.0,completed,259.0,7.15,194,65,25,0,234,259,65,0,194,259,39,0,220,259,48,0,211,259,0,0,259,259
8850189,1578,178029,new-0.5,completed,264.0,7.35,183,81,78,0,186,264,0,0,264,264,81,0,183,264,5,0,259,264,46,0,218,264
8850189,1578,178029,new-1.0,completed,250.0,7.45,185,65,30,0,220,250,0,0,250,250,11,0,239,250,37,8,205,250,16,20,214,250
8850189,1578,239735,base,completed,266.0,7.25,139,127,5,0,261,266,47,0,219,266,26,14,226,266,0,95,171,266,33,0,233,266
8850189,1578,239735,base+,completed,264.0,7.0,186,78,25,0,239,264,51,0,213,264,0,12,252,264,66,0,198,264,43,0,221,264
8850189,1578,239735,dpv1,completed,271.0,7.1,202,69,56,0,215,271,0,0,271,271,69,0,202,271,51,0,220,271,56,0,215,271
8850189,1578,239735,dpv2,completed,240.0,7.3,183,57,52,0,188,240,39,0,201,240,8,0,232,240,0,19,221,240,11,0,229,240
8850189,1578,239735,new-0.0,completed,264.0,7.15,191,73,28,0,236,264,73,0,191,264,53,0,211,264,59,0,205,264,0,0,264,264
8850189,1578,239735,new-0.5,completed,253.0,7.25,182,71,70,1,182,253,67,0,186,253,21,0,232,253,0,0,253,253,34,0,219,253
8850189,1578,239735,new-1.0,completed,250.0,7.25,187,63,0,0,250,250,40,0,210,250,47,0,203,250,22,16,212,250,13,0,237,250
8850189,1578,675528,base,completed,249.0,6.9,188,61,0,0,249,249,25,0,224,249,45,10,194,249,51,0,198,249,13,0,236,249
8850189,1578,675528,base+,completed,274.0,6.9,191,83,0,0,274,274,67,0,207,274,33,0,241,274,83,0,191,274,58,0,216,274
8850189,1578,675528,dpv1,completed,276.0,7.35,206,70,65,0,211,276,0,0,276,276,61,0,215,276,41,5,230,276,60,0,216,276
8850189,1578,675528,dpv2,completed,253.0,7.35,197,56,40,0,213,253,30,0,223,253,25,0,228,253,21,16,216,253,0,0,253,253
8850189,1578,675528,new-0.0,completed,254.0,6.95,184,70,36,0,218,254,70,0,184,254,25,0,229,254,36,0,218,254,0,0,254,254
8850189,1578,675528,new-0.5,completed,279.0,7.25,194,85,0,5,274,279,80,0,199,279,44,0,235,279,74,0,205,279,72,0,207,279
8850189,1578,675528,new-1.0,completed,280.0,7.45,179,101,72,12,196,280,0,17,263,280,37,0,243,280,68,0,212,280,66,0,214,280
8850189,1578,380692,base,completed,267.0,7.05,195,72,66,0,201,267,35,0,232,267,0,0,267,267,28,0,239,267,72,0,195,267
8850189,1578,380692,base+,completed,266.0,7.1,184,82,30,0,236,266,0,0,266,266,42,16,208,266,55,0,211,266,66,0,200,266
8850189,1578,380692,dpv1,completed,272.0,7.1,141,131,75,0,197,272,23,6,243,272,42,0,230,272,0,0,272,272,37,56,179,272
8850189,1578,380692,dpv2,completed,247.0,7.2,203,44,0,0,247,247,20,2,225,247,30,0,217,247,44,0,203,247,15,0,232,247
8850189,1578,380692,new-0.0,completed,265.0,7.15,183,82,31,0,234,265,82,0,183,265,56,0,209,265,49,0,216,265,0,0,265,265
8850189,1578,380692,new-0.5,completed,268.0,7.25,190,78,0,0,268,268,22,0,246,268,78,0,190,268,47,0,221,268,60,0,208,268
8850189,1578,380692,new-1.0,completed,265.0,7.35,194,71,63,0,202,265,63,8,194,265,23,0,242,265,55,0,210,265,0,0,265,265
3780976,1521,310811,base,completed,250.0,6.8,192,58,44,0,206,250,0,17,233,250,58,0,192,250,14,0,236,250,24,0,226,250
3780976,1521,310811,base+,completed,257.0,6.95,186,71,36,0,221,257,0,4,253,257,23,6,228,257,24,0,233,257,67,0,190,257
3780976,1521,310811,dpv1,completed,254.0,6.9,184,70,43,0,211,254,65,5,184,254,44,0,210,254,0,0,254,254,39,0,215,254
3780976,1521,310811,dpv2,completed,275.0,7.15,131,144,0,0,275,275,37,0,238,275,25,100,150,275,44,34,197,275,38,20,217,275
3780976,1521,310811,new-0.0,completed,246.0,7.0,179,67,0,0,246,246,49,0,197,246,67,0,179,246,35,0,211,246,43,0,203,246
3780976,1521,310811,new-0.5,completed,239.0,7.35,179,60,0,0,239,239,4,4,231,239,38,0,201,239,49,0,190,239,56,0,183,239
3780976,1521,310811,new-1.0,completed,265.0,7.2,134,131,0,14,251,265,37,0,228,265,62,30,173,265,42,25,198,265,56,0,209,265
3780976,1521,208428,base,completed,245.0,7.0,182,63,43,1,201,245,14,0,231,245,14,0,231,245,0,1,244,245,34,19,192,245
3780976,1521,208428,base+,completed,249.0,7.05,154,95,10,30,209,249,19,33,197,249,0,16,233,249,21,0,228,249,22,0,227,249
3780976,1521,208428,dpv1,completed,256.0,6.9,188,68,29,0,227,256,68,0,188,256,33,0,223,256,0,0,256,256,53,0,203,256
3780976,1521,208428,dpv2,completed,241.0,7.05,176,65,6,28,207,241,35,2,204,241,0,0,241,241,21,0,220,241,18,0,223,241
3780976,1521,208428,new-0.0,completed,257.0,6.9,190,67,0,0,257,257,46,0,211,257,67,0,190,257,34,0,223,257,47,0,210,257
3780976,1521,208428,new-0.5,completed,249.0,7.3,180,69,0,0,249,249,28,7,214,249,46,0,203,249,36,0,213,249,62,0,187,249
3780976,1521,208428,new-1.0,completed,263.0,7.4,150,113,36,0,227,263,67,5,191,263,47,26,190,263,30,0,233,263,0,20,243,263
3780976,1521,460300,base,completed,266.0,6.95,166,100,39,26,201,266,37,44,185,266,4,0,262,266,0,0,266,266,58,0,208,266
3780976,1521,460300,base+,completed,258.0,7.0,204,54,0,0,258,258,49,0,209,258,40,0,218,258,29,0,229,258,54,0,204,258
3780976,1521,460300,dpv1,completed,252.0,6.9,190,62,30,0,222,252,56,6,190,252,32,0,220,252,0,0,252,252,42,0,210,252
3780976,1521,460300,dpv2,completed,270.0,7.2,135,135,0,22,248,270,49,6,215,270,46,19,205,270,27,58,185,270,12,0,258,270
3780976,1521,460300,new-0.0,completed,256.0,7.05,182,74,74,0,182,256,39,0,217,256,0,0,256,256,42,0,214,256,44,0,212,256
3780976,1521,460300,new-0.5,completed,242.0,7.35,178,64,15,0,227,242,0,10,232,242,28,0,214,242,27,0,215,242,54,0,188,242
3780976,1521,460300,new-1.0,completed,273.0,7.4,155,118,46,0,227,273,72,5,196,273,59,21,193,273,29,0,244,273,0,25,248,273
3780976,1521,309704,base,completed,243.0,6.95,190,53,18,0,225,243,47,0,196,243,0,0,243,243,20,0,223,243,53,0,190,243
3780976,1521,309704,base+,completed,256.0,7.2,189,67,61,0,195,256,51,0,205,256,10,0,246,256,61,0,195,256,0,35,221,256
3780976,1521,309704,dpv1,completed,259.0,7.0,175,84,53,0,206,259,37,0,222,259,54,1,204,259,67,0,192,259,0,16,243,259
3780976,1521,309704,dpv2,completed,277.0,7.15,121,156,0,0,277,277,32,0,245,277,23,112,142,277,44,37,196,277,35,33,209,277
3780976,1521,309704,new-0.0,completed,237.0,6.9,186,51,0,0,237,237,34,0,203,237,51,0,186,237,20,0,217,237,29,0,208,237
3780976,1521,309704,new-0.5,completed,245.0,7.35,180,65,21,0,224,245,0,0,245,245,40,0,205,245,50,0,195,245,65,0,180,245
3780976,1521,309704,new-1.0,completed,255.0,7.35,157,98,40,0,215,255,71,0,184,255,54,10,191,255,0,0,255,255,34,17,204,255
3780976,1521,247588,base,completed,250.0,7.1,151,99,0,0,250,250,3,56,191,250,15,0,235,250,54,0,196,250,11,0,239,250
3780976,1521,247588,base+,completed,235.0,6.85,151,84,45,5,185,235,16,0,219,235,12,0,223,235,0,38,197,235,16,0,219,235
3780976,1521,247588,dpv1,completed,259.0,7.0,180,79,0,0,259,259,61,18,180,259,55,0,204,259,56,0,203,259,61,0,198,259
3780976,1521,247588,dpv2,completed,259.0,7.25,132,127,18,24,217,259,17,101,141,259,0,0,259,259,26,0,233,259,22,0,237,259
3780976,1521,247588,new-0.0,completed,236.0,7.0,175,61,0,0,236,236,44,0,192,236,61,0,175,236,12,0,224,236,33,0,203,236
3780976,1521,247588,new-0.5,completed,234.0,7.3,175,59,0,0,234,234,20,8,206,234,34,0,200,234,20,0,214,234,51,0,183,234
3780976,1521,247588,new-1.0,completed,258.0,7.2,128,130,0,14,244,258,26,5,227,258,44,30,184,258,26,36,196,258,51,0,207,258
3780976,1521,203195,base,completed,235.0,6.95,168,67,11,0,224,235,17,0,218,235,0,6,229,235,37,26,172,235,10,0,225,235
3780976,1521,203195,base+,completed,261.0,6.85,198,63,0,0,261,261,63,0,198,261,36,0,225,261,37,0,224,261,46,0,215,261
3780976,1521,203195,dpv1,completed,241.0,7.0,181,60,0,0,241,241,31,0,210,241,28,0,213,241,60,0,181,241,34,0,207,241
3780976,1521,203195,dpv2,completed,251.0,7.45,127,124,19,0,232,251,15,0,236,251,10,0,241,251,40,0,211,251,0,84,167,251
3780976,1521,203195,new-0.0,completed,247.0,7.0,183,64,0,0,247,247,47,0,200,247,64,0,183,247,33,0,214,247,44,0,203,247
3780976,1521,203195,new-0.5,completed,265.0,7.3,184,81,0,0,265,265,44,5,216,265,68,0,197,265,50,0,215,265,76,0,189,265
3780976,1521,203195,new-1.0,completed,278.0,7.2,139,139,46,16,216,278,64,4,210,278,0,19,259,278,36,35,207,278,69,0,209,278
3780976,1521,178029,base,completed,285.0,6.95,105,180,0,0,285,285,55,40,190,285,72,30,183,285,68,46,171,285,20,0,265,285
3780976,1521,178029,base+,completed,244.0,6.95,181,63,14,0,230,244,0,0,244,244,63,0,181,244,50,0,194,244,18,0,226,244
3780976,1521,178029,dpv1,completed,268.0,7.0,182,86,0,23,245,268,58,0,210,268,63,0,205,268,60,0,208,268,59,0,209,268
3780976,1521,178029,dpv2,completed,258.0,7.25,126,132,0,0,258,258,9,114,135,258,18,58,182,258,11,0,247,258,11,0,247,258
3780976,1521,178029,new-0.0,completed,245.0,7.0,182,63,0,0,245,245,37,0,208,245,63,0,182,245,19,0,226,245,32,0,213,245
3780976,1521,178029,new-0.5,completed,243.0,7.35,183,60,10,0,233,243,0,0,243,243,31,0,212,243,25,0,218,243,60,0,183,243
3780976,1521,178029,new-1.0,completed,255.0,7.4,153,102,57,0,198,255,0,3,252,255,3,26,226,255,52,0,203,255,43,19,193,255
3780976,1521,239735,base,completed,243.0,6.95,200,43,0,0,243,243,9,0,234,243,35,0,208,243,42,0,201,243,43,0,200,243
3780976,1521,239735,base+,completed,246.0,6.9,182,64,46,0,200,246,27,0,219,246,0,0,246,246,48,0,198,246,64,0,182,246
3780976,1521,239735,dpv1,completed,264.0,7.2,177,87,50,0,214,264,70,0,194,264,68,0,196,264,66,0,198,264,0,17,247,264
3780976,1521,239735,dpv2,completed,267.0,7.4,109,158,25,40,202,267,13,0,254,267,48,0,219,267,52,54,161,267,0,44,223,267
3780976,1521,239735,new-0.0,completed,239.0,6.95,169,70,38,0,201,239,24,0,215,239,0,0,239,239,70,0,169,239,33,0,206,239
3780976,1521,239735,new-0.5,completed,234.0,7.35,182,52,0,0,234,234,7,0,227,234,37,0,197,234,37,0,197,234,52,0,182,234
3780976,1521,239735,new-1.0,completed,258.0,7.2,147,111,0,9,249,258,53,0,205,258,31,0,227,258,41,23,194,258,63,16,179,258
3780976,1521,675528,base,completed,248.0,6.95,172,76,22,0,226,248,60,0,188,248,35,0,213,248,24,24,200,248,0,0,248,248
3780976,1521,675528,base+,completed,255.0,7.05,192,63,35,0,220,255,57,0,198,255,63,0,192,255,35,0,220,255,0,0,255,255
3780976,1521,675528,dpv1,completed,270.0,7.1,184,86,46,0,224,270,64,22,184,270,56,0,214,270,0,0,270,270,57,0,213,270
3780976,1521,675528,dpv2,completed,283.0,7.3,111,172,23,0,260,283,1,138,144,283,0,0,283,283,25,51,207,283,34,35,214,283
3780976,1521,675528,new-0.0,completed,249.0,7.0,180,69,0,0,249,249,49,0,200,249,69,0,180,249,21,0,228,249,44,0,205,249
3780976,1521,675528,new-0.5,completed,263.0,7.35,177,86,0,0,263,263,76,10,177,263,56,0,207,263,56,0,207,263,35,0,228,263
3780976,1521,675528,new-1.0,completed,262.0,7.4,166,96,46,0,216,262,58,0,204,262,50,25,187,262,29,0,233,262,0,13,249,262
3780976,1521,380692,base,completed,262.0,6.85,191,71,44,8,210,262,63,0,199,262,0,0,262,262,53,0,209,262,34,0,228,262
3780976,1521,380692,base+,completed,246.0,6.9,181,65,48,0,198,246,18,14,214,246,32,0,214,246,0,3,243,246,38,0,208,246
3780976,1521,380692,dpv1,completed,274.0,7.15,186,88,64,0,210,274,62,13,199,274,69,9,196,274,62,0,212,274,0,0,274,274
3780976,1521,380692,dpv2,completed,264.0,7.3,105,159,12,0,252,264,0,127,137,264,7,0,257,264,32,33,199,264,22,31,211,264
3780976,1521,380692,new-0.0,completed,222.0,7.0,183,39,0,0,222,222,10,0,212,222,39,0,183,222,7,0,215,222,15,0,207,222
3780976,1521,380692,new-0.5,completed,245.0,7.35,182,63,27,0,218,245,0,0,245,245,49,0,196,245,30,0,215,245,63,0,182,245
3780976,1521,380692,new-1.0,completed,262.0,7.3,125,137,46,29,187,262,0,0,262,262,61,22,179,262,31,0,231,262,52,30,180,262
9970504,1617,310811,base,completed,280.0,7.05,152,128,50,25,205,280,53,0,227,280,5,0,275,280,0,0,280,280,30,62,188,280
9970504,1617,310811,base+,completed,286.0,7.15,144,142,57,62,167,286,0,31,255,286,24,0,262,286,22,0,264,286,51,0,235,286
9970504,1617,310811,dpv1,completed,269.0,7.15,152,117,59,28,182,269,12,21,236,269,0,16,253,269,15,0,254,269,8,22,239,269
9970504,1617,310811,dpv2,completed,272.0,7.5,138,134,36,37,199,272,35,49,188,272,0,0,272,272,4,0,268,272,5,36,231,272
9970504,1617,310811,new-0.0,completed,268.0,6.85,177,91,61,10,197,268,0,10,258,268,43,0,225,268,10,20,238,268,59,0,209,268
9970504,1617,310811,new-0.5,completed,268.0,7.4,186,82,0,2,266,268,68,0,200,268,23,0,245,268,62,11,195,268,10,1,257,268
9970504,1617,310811,new-1.0,completed,266.0,7.5,191,75,20,0,246,266,0,0,266,266,21,1,244,266,47,0,219,266,55,20,191,266
9970504,1617,208428,base,completed,275.0,7.1,177,98,70,0,205,275,28,0,247,275,2,23,250,275,52,0,223,275,0,39,236,275
9970504,1617,208428,base+,completed,283.0,6.75,170,113,50,48,185,283,42,7,234,283,0,0,283,283,65,0,218,283,16,0,267,283
9970504,1617,208428,dpv1,completed,262.0,7.2,185,77,12,0,250,262,54,22,186,262,0,0,262,262,22,0,240,262,7,24,231,262
9970504,1617,208428,dpv2,completed,292.0,7.4,146,146,0,0,292,292,57,0,235,292,53,36,203,292,46,49,197,292,14,28,250,292
9970504,1617,208428,new-0.0,completed,275.0,6.9,173,102,48,0,227,275,40,25,210,275,51,15,209,275,2,25,248,275,0,13,262,275
9970504,1617,208428,new-0.5,completed,278.0,7.4,199,79,0,0,278,278,16,0,262,278,56,0,222,278,61,9,208,278,70,0,208,278
9970504,1617,208428,new-1.0,completed,270.0,7.5,175,95,53,0,217,270,23,19,228,270,14,0,256,270,59,10,201,270,0,8,262,270
9970504,1617,460300,base,completed,256.0,6.95,192,64,49,0,207,256,0,55,201,256,4,0,252,256,9,0,247,256,0,0,256,256
9970504,1617,460300,base+,completed,275.0,7.15,178,97,0,12,263,275,65,0,210,275,52,3,220,275,17,0,258,275,6,35,234,275
9970504,1617,460300,dpv1,completed,284.0,7.1,149,135,0,21,263,284,14,65,205,284,76,15,193,284,25,0,259,284,17,0,267,284
9970504,1617,460300,dpv2,completed,268.0,7.3,164,104,8,0,260,268,36,24,208,268,13,0,255,268,0,30,238,268,42,8,218,268
9970504,1617,460300,new-0.0,completed,270.0,6.9,195,75,19,0,251,270,38,10,222,270,55,0,215,270,0,18,252,270,47,0,223,270
9970504,1617,460300,new-0.5,completed,267.0,7.45,182,85,47,0,220,267,5,0,262,267,58,3,206,267,0,8,259,267,53,16,198,267
9970504,1617,460300,new-1.0,completed,261.0,7.55,199,62,24,0,237,261,20,0,241,261,31,0,230,261,0,31,230,261,12,0,249,261
9970504,1617,309704,base,completed,270.0,6.95,184,86,30,11,229,270,68,14,188,270,37,0,233,270,0,4,266,270,24,0,246,270
9970504,1617,309704,base+,completed,262.0,6.95,202,60,23,0,239,262,48,0,214,262,0,12,250,262,10,8,244,262,47,0,215,262
9970504,1617,309704,dpv1,completed,279.0,7.25,173,106,38,2,239,279,71,31,177,279,0,0,279,279,46,0,233,279,16,4,259,279
9970504,1617,309704,dpv2,completed,293.0,7.35,150,143,17,0,276,293,70,7,216,293,0,0,293,293,57,57,179,293,62,17,214,293
9970504,1617,309704,new-0.0,completed,273.0,6.9,174,99,54,17,202,273,45,21,207,273,0,17,256,273,3,14,256,273,58,0,215,273
9970504,1617,309704,new-0.5,completed,269.0,7.4,186,83,12,0,257,269,75,0,194,269,76,4,189,269,35,0,234,269,0,3,266,269
9970504,1617,309704,new-1.0,completed,285.0,7.55,193,92,0,0,285,285,34,2,249,285,79,0,206,285,64,0,221,285,64,11,210,285
9970504,1617,247588,base,completed,276.0,7.0,167,109,10,15,251,276,25,29,222,276,65,0,211,276,0,3,273,276,34,35,207,276
9970504,1617,247588,base+,completed,270.0,6.85,156,114,2,0,268,270,0,34,236,270,67,0,203,270,26,49,195,270,31,0,239,270
9970504,1617,247588,dpv1,completed,252.0,7.0,167,85,0,0,252,252,54,28,170,252,18,3,231,252,10,9,233,252,4,0,248,252
9970504,1617,247588,dpv2,completed,269.0,7.4,156,113,0,0,269,269,4,8,257,269,38,0,231,269,22,53,194,269,30,30,209,269
9970504,1617,247588,new-0.0,completed,269.0,6.85,178,91,0,7,262,269,47,15,207,269,58,0,211,269,53,0,216,269,8,27,234,269
9970504,1617,247588,new-0.5,completed,275.0,7.35,189,86,69,0,206,275,12,17,246,275,57,0,218,275,0,11,264,275,51,11,213,275
9970504,1617,247588,new-1.0,completed,255.0,7.6,186,69,43,0,212,255,11,23,221,255,6,20,229,255,0,0,255,255,35,3,217,255
9970504,1617,203195,base,completed,275.0,7.2,156,119,24,0,251,275,17,14,244,275,61,32,182,275,0,26,249,275,29,0,246,275
9970504,1617,203195,base+,completed,268.0,7.15,200,68,0,0,268,268,0,0,268,268,62,0,206,268,19,43,206,268,25,0,243,268
9970504,1617,203195,dpv1,completed,295.0,7.2,164,131,42,0,253,295,34,33,228,295,89,8,198,295,46,11,238,295,0,10,285,295
9970504,1617,203195,dpv2,completed,303.0,7.5,146,157,67,0,236,303,29,43,231,303,0,58,245,303,44,0,259,303,68,50,185,303
9970504,1617,203195,new-0.0,completed,263.0,7.0,181,82,47,0,216,263,65,0,198,263,6,6,251,263,54,0,209,263,0,17,246,263
9970504,1617,203195,new-0.5,completed,273.0,7.2,178,95,0,10,263,273,43,0,230,273,54,6,213,273,56,0,217,273,0,26,247,273
9970504,1617,203195,new-1.0,completed,261.0,7.55,180,81,19,5,237,261,18,0,243,261,16,0,245,261,0,46,215,261,30,0,231,261
9970504,1617,178029,base,completed,300.0,7.05,140,160,58,0,242,300,68,0,232,300,0,103,197,300,2,82,216,300,50,0,250,300
9970504,1617,178029,base+,completed,279.0,7.05,174,105,0,48,231,279,57,0,222,279,45,0,234,279,10,0,269,279,39,4,236,279
9970504,1617,178029,dpv1,completed,283.0,7.0,175,108,43,0,240,283,78,16,189,283,0,3,280,283,27,0,256,283,23,39,221,283
9970504,1617,178029,dpv2,completed,286.0,7.4,164,122,50,3,233,286,9,45,232,286,71,4,211,286,29,12,245,286,0,37,249,286
9970504,1617,178029,new-0.0,completed,265.0,6.95,198,67,47,0,218,265,41,10,214,265,3,6,256,265,0,10,255,265,47,0,218,265
9970504,1617,178029,new-0.5,completed,271.0,7.6,201,70,44,0,227,271,11,0,260,271,0,0,271,271,55,2,214,271,37,24,210,271
9970504,1617,178029,new-1.0,completed,258.0,7.55,197,61,16,11,231,258,21,0,237,258,21,0,237,258,0,26,232,258,24,0,234,258
9970504,1617,239735,base,completed,293.0,6.85,146,147,37,19,237,293,29,64,200,293,76,0,217,293,22,47,224,293,0,0,293,293
9970504,1617,239735,base+,completed,270.0,6.8,156,114,11,2,257,270,49,26,195,270,41,14,215,270,52,0,218,270,0,30,240,270
9970504,1617,239735,dpv1,completed,282.0,7.1,183,99,0,0,282,282,79,15,188,282,48,5,229,282,75,0,207,282,60,0,222,282
9970504,1617,239735,dpv2,completed,277.0,7.45,157,120,55,28,194,277,41,0,236,277,12,11,254,277,0,23,254,277,68,0,209,277
9970504,1617,239735,new-0.0,completed,265.0,7.0,162,103,51,9,205,265,40,15,210,265,51,0,214,265,6,11,248,265,0,35,230,265
9970504,1617,239735,new-0.5,completed,261.0,7.4,171,90,44,0,217,261,14,0,247,261,0,12,249,261,55,10,196,261,60,8,193,261
9970504,1617,239735,new-1.0,completed,285.0,7.6,179,106,77,0,208,285,33,11,241,285,0,0,285,285,76,0,209,285,71,18,196,285
9970504,1617,675528,base,completed,276.0,7.3,139,137,0,72,204,276,4,4,268,276,42,0,234,276,28,61,187,276,34,0,242,276
9970504,1617,675528,base+,completed,287.0,7.1,186,101,87,0,200,287,68,0,219,287,8,24,255,287,0,42,245,287,52,0,235,287
9970504,1617,675528,dpv1,completed,271.0,7.25,152,119,0,13,258,271,37,11,223,271,32,63,176,271,17,0,254,271,25,0,246,271
9970504,1617,675528,dpv2,completed,282.0,7.25,143,139,5,0,277,282,32,62,188,282,0,20,262,282,17,0,265,282,42,32,208,282
9970504,1617,675528,new-0.0,completed,259.0,7.0,189,70,41,0,218,259,33,24,202,259,57,0,202,259,1,0,258,259,0,5,254,259
9970504,1617,675528,new-0.5,completed,257.0,7.4,200,57,36,9,212,257,4,0,253,257,44,0,213,257,27,0,230,257,0,4,253,257
9970504,1617,675528,new-1.0,completed,270.0,7.55,185,85,13,0,257,270,2,25,243,270,0,16,254,270,52,0,218,270,51,13,206,270
9970504,1617,380692,base,completed,287.0,7.2,146,141,10,26,251,287,40,0,247,287,0,56,231,287,0,83,204,287,8,61,218,287
9970504,1617,380692,base+,completed,279.0,7.1,126,153,46,0,233,279,69,0,210,279,17,63,199,279,0,0,279,279,40,51,188,279
9970504,1617,380692,dpv1,completed,269.0,7.2,177,92,31,0,238,269,39,10,220,269,59,23,187,269,0,0,269,269,23,0,246,269
9970504,1617,380692,dpv2,completed,272.0,7.4,141,131,0,1,271,272,27,52,193,272,0,0,272,272,10,19,243,272,31,36,205,272
9970504,1617,380692,new-0.0,completed,271.0,6.95,181,90,0,27,244,271,58,0,213,271,12,2,257,271,52,10,209,271,52,0,219,271
9970504,1617,380692,new-0.5,completed,281.0,7.2,189,92,68,0,213,281,60,1,220,281,0,15,266,281,17,19,245,281,54,0,227,281
9970504,1617,380692,new-1.0,completed,290.0,7.5,188,102,76,0,214,290,47,22,221,290,67,0,223,290,69,0,221,290,0,4,286,290
8339622,1708,310811,base,completed,273.0,7.2,165,108,9,0,264,273,28,0,245,273,0,0,273,273,8,0,265,273,20,80,173,273
8339622,1708,310811,base+,completed,291.0,6.7,159,132,12,0,279,291,54,0,237,291,0,78,213,291,28,0,263,291,38,0,253,291
8339622,1708,310811,dpv1,completed,292.0,7.2,208,84,84,0,208,292,84,0,208,292,5,0,287,292,56,0,236,292,0,0,292,292
8339622,1708,310811,dpv2,completed,297.0,7.55,114,183,0,0,297,297,45,0,252,297,44,0,253,297,77,106,114,297,24,0,273,297
8339622,1708,310811,new-0.0,completed,284.0,7.25,212,72,70,0,214,284,69,2,213,284,63,0,221,284,0,0,284,284,37,0,247,284
8339622,1708,310811,new-0.5,completed,299.0,7.9,209,90,86,0,213,299,0,0,299,299,54,0,245,299,74,4,221,299,74,0,225,299
8339622,1708,310811,new-1.0,completed,263.0,7.85,198,65,2,0,261,263,42,0,221,263,29,0,234,263,0,23,240,263,14,0,249,263
8339622,1708,208428,base,completed,291.0,7.1,233,58,58,0,233,291,51,0,240,291,0,0,291,291,29,0,262,291,41,0,250,291
8339622,1708,208428,base+,completed,255.0,7.05,227,28,28,0,227,255,0,0,255,255,14,0,241,255,16,0,239,255,24,0,231,255
8339622,1708,208428,dpv1,completed,275.0,7.3,216,59,46,0,229,275,0,0,275,275,19,0,256,275,59,0,216,275,34,0,241,275
8339622,1708,208428,dpv2,completed,277.0,7.6,177,100,26,0,251,277,19,0,258,277,32,68,177,277,32,0,245,277,0,0,277,277
8339622,1708,208428,new-0.0,completed,257.0,7.1,220,37,7,0,250,257,4,0,253,257,37,0,220,257,28,0,229,257,0,0,257,257
8339622,1708,208428,new-0.5,completed,253.0,7.75,219,34,8,3,242,253,31,0,222,253,0,0,253,253,11,0,242,253,10,0,243,253
8339622,1708,208428,new-1.0,completed,269.0,7.85,211,58,1,0,268,269,40,0,229,269,36,0,233,269,0,18,251,269,23,0,246,269
8339622,1708,460300,base,completed,273.0,6.9,246,27,23,0,250,273,16,0,257,273,21,0,252,273,27,0,246,273,0,0,273,273
8339622,1708,460300,base+,completed,265.0,7.0,237,28,20,0,245,265,28,0,237,265,13,0,252,265,18,0,247,265,0,0,265,265
8339622,1708,460300,dpv1,completed,286.0,7.3,215,71,64,0,222,286,16,0,270,286,71,0,215,286,60,0,226,286,0,0,286,286
8339622,1708,460300,dpv2,completed,255.0,7.45,217,38,0,16,239,255,11,0,244,255,22,5,228,255,2,0,253,255,19,0,236,255
8339622,1708,460300,new-0.0,completed,251.0,7.25,208,43,14,0,237,251,2,8,241,251,14,0,237,251,35,0,216,251,0,0,251,251
8339622,1708,460300,new-0.5,completed,296.0,7.95,220,76,0,0,296,296,76,0,220,296,72,0,224,296,57,0,239,296,72,0,224,296
8339622,1708,460300,new-1.0,completed,294.0,7.85,218,76,0,0,294,294,76,0,218,294,56,0,238,294,26,0,268,294,76,0,218,294
8339622,1708,309704,base,completed,283.0,6.75,224,59,0,0,283,283,32,0,251,283,51,0,232,283,59,0,224,283,31,0,252,283
8339622,1708,309704,base+,completed,258.0,6.75,239,19,17,0,241,258,15,2,241,258,6,0,252,258,3,0,255,258,0,0,258,258
8339622,1708,309704,dpv1,completed,290.0,7.25,210,80,80,0,210,290,64,0,226,290,0,0,290,290,29,0,261,290,61,0,229,290
8339622,1708,309704,dpv2,completed,271.0,7.45,203,68,32,15,224,271,0,0,271,271,31,12,228,271,41,0,230,271,37,0,234,271
8339622,1708,309704,new-0.0,completed,283.0,7.15,213,70,70,0,213,283,67,0,216,283,63,0,220,283,20,0,263,283,0,0,283,283
8339622,1708,309704,new-0.5,completed,275.0,7.95,213,62,61,0,214,275,0,0,275,275,52,1,222,275,19,0,256,275,45,0,230,275
8339622,1708,309704,new-1.0,completed,269.0,7.95,203,66,35,0,234,269,53,0,216,269,4,0,265,269,0,13,256,269,31,0,238,269
8339622,1708,247588,base,completed,326.0,7.2,136,190,0,0,326,326,18,0,308,326,57,96,173,326,56,0,270,326,25,148,153,326
8339622,1708,247588,base+,completed,275.0,6.8,230,45,40,0,235,275,14,0,261,275,0,0,275,275,44,0,231,275,45,0,230,275
8339622,1708,247588,dpv1,completed,277.0,7.4,205,72,7,0,270,277,72,0,205,277,70,0,207,277,66,0,211,277,0,0,277,277
8339622,1708,247588,dpv2,completed,291.0,7.75,127,164,0,0,291,291,42,0,249,291,21,0,270,291,54,110,127,291,25,0,266,291
8339622,1708,247588,new-0.0,completed,256.0,7.2,213,43,0,0,256,256,10,0,246,256,28,0,228,256,43,0,213,256,4,0,252,256
8339622,1708,247588,new-0.5,completed,282.0,7.9,208,74,27,0,255,282,0,0,282,282,74,0,208,282,65,0,217,282,58,0,224,282
8339622,1708,247588,new-1.0,completed,268.0,7.95,205,63,36,0,232,268,0,0,268,268,14,0,254,268,63,0,205,268,35,0,233,268
8339622,1708,203195,base,completed,279.0,6.8,223,56,51,0,228,279,35,0,244,279,6,0,273,279,56,0,223,279,0,0,279,279
8339622,1708,203195,base+,completed,275.0,6.75,181,94,23,0,252,275,16,0,259,275,5,0,270,275,0,0,275,275,45,49,181,275
8339622,1708,203195,dpv1,completed,282.0,7.3,218,64,64,0,218,282,0,0,282,282,15,0,267,282,51,0,231,282,61,0,221,282
8339622,1708,203195,dpv2,completed,269.0,7.3,204,65,26,0,243,269,65,0,204,269,27,0,242,269,38,0,231,269,0,0,269,269
8339622,1708,203195,new-0.0,completed,279.0,7.25,204,75,48,0,231,279,74,1,204,279,61,0,218,279,37,0,242,279,0,0,279,279
8339622,1708,203195,new-0.5,completed,296.0,7.95,211,85,0,0,296,296,85,0,211,296,77,0,219,296,60,0,236,296,65,0,231,296
8339622,1708,203195,new-1.0,completed,303.0,8.0,217,86,0,0,303,303,86,0,217,303,67,0,236,303,82,0,221,303,61,0,242,303
8339622,1708,178029,base,completed,253.0,7.05,213,40,0,0,253,253,30,0,223,253,19,10,224,253,7,0,246,253,0,0,253,253
8339622,1708,178029,base+,completed,284.0,6.8,213,71,71,0,213,284,47,0,237,284,0,0,284,284,71,0,213,284,25,0,259,284
8339622,1708,178029,dpv1,completed,293.0,7.15,202,91,66,0,227,293,33,0,260,293,72,0,221,293,91,0,202,293,0,0,293,293
8339622,1708,178029,dpv2,completed,306.0,7.6,110,196,0,0,306,306,72,0,234,306,40,0,266,306,59,124,123,306,36,0,270,306
8339622,1708,178029,new-0.0,completed,290.0,6.95,220,70,62,0,228,290,70,0,220,290,0,0,290,290,62,0,228,290,46,0,244,290
8339622,1708,178029,new-0.5,completed,300.0,7.95,220,80,0,0,300,300,80,0,220,300,72,0,228,300,64,0,236,300,76,0,224,300
8339622,1708,178029,new-1.0,completed,274.0,7.85,210,64,0,0,274,274,20,0,254,274,38,0,236,274,64,0,210,274,52,0,222,274
8339622,1708,239735,base,completed,288.0,7.1,215,73,73,0,215,288,60,0,228,288,43,0,245,288,0,0,288,288,33,0,255,288
8339622,1708,239735,base+,completed,295.0,7.55,143,152,0,0,295,295,10,0,285,295,85,67,143,295,48,0,247,295,67,0,228,295
8339622,1708,239735,dpv1,completed,283.0,7.1,206,77,0,0,283,283,34,0,249,283,77,0,206,283,64,0,219,283,60,0,223,283
8339622,1708,239735,dpv2,completed,250.0,7.4,219,31,0,0,250,250,12,0,238,250,15,6,229,250,16,0,234,250,25,0,225,250
8339622,1708,239735,new-0.0,completed,240.0,7.25,214,26,18,0,222,240,8,0,232,240,4,0,236,240,26,0,214,240,0,0,240,240
8339622,1708,239735,new-0.5,completed,273.0,7.9,200,73,73,0,200,273,0,0,273,273,10,0,263,273,61,0,212,273,55,0,218,273
8339622,1708,239735,new-1.0,completed,251.0,7.85,204,47,26,0,225,251,3,0,248,251,23,0,228,251,0,21,230,251,7,0,244,251
8339622,1708,675528,base,completed,285.0,7.1,204,81,65,0,220,285,17,0,268,285,0,0,285,285,62,0,223,285,81,0,204,285
8339622,1708,675528,base+,completed,276.0,6.8,195,81,36,0,240,276,57,24,195,276,27,0,249,276,11,0,265,276,0,0,276,276
8339622,1708,675528,dpv1,completed,284.0,7.4,215,69,15,0,269,284,69,0,215,284,56,0,228,284,66,0,218,284,0,0,284,284
8339622,1708,675528,dpv2,completed,263.0,7.3,206,57,0,13,250,263,22,0,241,263,16,0,247,263,13,0,250,263,44,0,219,263
8339622,1708,675528,new-0.0,completed,258.0,7.15,218,40,4,0,254,258,2,0,256,258,33,0,225,258,0,0,258,258,40,0,218,258
8339622,1708,675528,new-0.5,completed,298.0,7.95,221,77,0,0,298,298,77,0,221,298,70,0,228,298,63,0,235,298,60,0,238,298
8339622,1708,675528,new-1.0,completed,265.0,7.95,222,43,36,0,229,265,0,7,258,265,1,0,264,265,32,0,233,265,32,0,233,265
8339622,1708,380692,base,completed,307.0,6.75,160,147,92,53,162,307,72,0,235,307,0,0,307,307,94,0,213,307,25,0,282,307
8339622,1708,380692,base+,completed,264.0,6.95,228,36,31,0,233,264,20,0,244,264,36,0,228,264,0,0,264,264,15,0,249,264
8339622,1708,380692,dpv1,completed,285.0,7.3,204,81,68,0,217,285,49,0,236,285,81,0,204,285,19,0,266,285,0,0,285,285
8339622,1708,380692,dpv2,completed,274.0,7.4,206,68,0,0,274,274,17,0,257,274,12,42,220,274,41,0,233,274,51,0,223,274
8339622,1708,380692,new-0.0,completed,287.0,7.15,212,75,48,1,238,287,65,0,222,287,70,0,217,287,68,4,215,287,0,0,287,287
8339622,1708,380692,new-0.5,completed,301.0,7.95,211,90,0,0,301,301,90,0,211,301,77,0,224,301,68,0,233,301,87,0,214,301
8339622,1708,380692,new-1.0,completed,274.0,7.8,206,68,57,0,217,274,24,0,250,274,0,0,274,274,46,11,217,274,41,0,233,274
3186328,1934,310811,base,completed,340.0,7.05,245,95,47,0,293,340,95,0,245,340,0,0,340,340,86,0,254,340,70,0,270,340
3186328,1934,310811,base+,completed,319.0,6.95,210,109,0,0,319,319,81,0,238,319,43,28,248,319,25,0,294,319,38,0,281,319
3186328,1934,310811,dpv1,completed,370.0,7.15,158,212,42,0,328,370,0,8,362,370,82,100,188,370,103,0,267,370,50,63,257,370
3186328,1934,310811,dpv2,completed,378.0,7.3,67,311,0,224,154,378,28,0,350,378,67,67,244,378,45,14,319,378,67,0,311,378
3186328,1934,310811,new-0.0,completed,307.0,7.15,233,74,26,0,281,307,31,0,276,307,32,0,275,307,74,0,233,307,0,8,299,307
3186328,1934,310811,new-0.5,completed,308.0,7.45,248,60,52,2,254,308,19,6,283,308,45,0,263,308,29,0,279,308,0,0,308,308
3186328,1934,310811,new-1.0,completed,316.0,7.55,185,131,18,55,243,316,5,0,311,316,0,0,316,316,52,0,264,316,42,24,250,316
3186328,1934,208428,base,completed,372.0,7.0,138,234,91,143,138,372,62,0,310,372,48,48,276,372,36,0,336,372,0,0,372,372
3186328,1934,208428,base+,completed,299.0,7.15,241,58,4,23,272,299,29,0,270,299,35,0,264,299,14,0,285,299,0,0,299,299
3186328,1934,208428,dpv1,completed,389.0,7.25,138,251,73,0,316,389,0,88,301,389,97,94,198,389,64,58,267,389,56,0,333,389
3186328,1934,208428,dpv2,completed,347.0,7.4,99,248,1,180,166,347,23,0,324,347,20,120,207,347,0,0,347,347,12,0,335,347
3186328,1934,208428,new-0.0,completed,288.0,7.1,230,58,21,0,267,288,6,0,282,288,0,0,288,288,58,0,230,288,4,0,284,288
3186328,1934,208428,new-0.5,completed,299.0,7.55,235,64,4,0,295,299,26,4,269,299,47,0,252,299,0,11,288,299,49,0,250,299
3186328,1934,208428,new-1.0,completed,318.0,7.45,209,109,0,48,270,318,13,0,305,318,55,0,263,318,58,3,257,318,18,0,300,318
3186328,1934,460300,base,completed,366.0,6.95,127,239,17,11,338,366,0,0,366,366,62,2,302,366,65,43,258,366,32,174,160,366
3186328,1934,460300,base+,completed,339.0,6.8,243,96,59,0,280,339,47,0,292,339,73,9,257,339,0,0,339,339,87,0,252,339
3186328,1934,460300,dpv1,completed,353.0,7.4,155,198,62,0,291,353,39,0,314,353,82,0,271,353,0,102,251,353,32,65,256,353
3186328,1934,460300,dpv2,completed,372.0,7.3,66,306,62,11,299,372,11,0,361,372,28,78,266,372,0,212,160,372,58,0,314,372
3186328,1934,460300,new-0.0,completed,334.0,7.1,213,121,32,0,302,334,52,19,263,334,0,0,334,334,102,0,232,334,70,0,264,334
3186328,1934,460300,new-0.5,completed,328.0,7.3,234,94,0,4,324,328,35,0,293,328,54,0,274,328,90,0,238,328,59,0,269,328
3186328,1934,460300,new-1.0,completed,331.0,7.6,194,137,60,67,204,331,33,0,298,331,0,0,331,331,8,2,321,331,70,0,261,331
3186328,1934,309704,base,completed,351.0,6.8,223,128,93,14,244,351,32,0,319,351,101,0,250,351,0,52,299,351,61,0,290,351
3186328,1934,309704,base+,completed,336.0,7.15,213,123,73,0,263,336,65,0,271,336,24,43,269,336,0,0,336,336,82,0,254,336
3186328,1934,309704,dpv1,completed,394.0,7.45,73,321,47,0,347,394,0,0,394,394,72,62,260,394,91,98,205,394,25,171,198,394
3186328,1934,309704,dpv2,completed,367.0,7.3,66,301,72,5,290,367,13,0,354,367,28,66,273,367,0,191,176,367,73,0,294,367
3186328,1934,309704,new-0.0,completed,289.0,7.4,250,39,0,0,289,289,10,0,279,289,19,0,270,289,39,0,250,289,14,0,275,289
3186328,1934,309704,new-0.5,completed,321.0,7.55,220,101,23,0,298,321,0,51,270,321,46,0,275,321,61,0,260,321,72,0,249,321
3186328,1934,309704,new-1.0,completed,337.0,7.65,153,184,52,0,285,337,2,0,335,337,0,0,337,337,76,37,224,337,31,71,235,337
3186328,1934,247588,base,completed,361.0,6.85,184,177,29,0,332,361,7,119,235,361,0,0,361,361,37,75,249,361,43,74,244,361
3186328,1934,247588,base+,completed,371.0,6.65,147,224,65,149,157,371,0,0,371,371,41,149,181,371,49,0,322,371,31,0,340,371
3186328,1934,247588,dpv1,completed,361.0,7.45,145,216,42,0,319,361,47,0,314,361,77,0,284,361,50,55,256,361,0,138,223,361
3186328,1934,247588,dpv2,completed,356.0,7.15,88,268,0,198,158,356,32,0,324,356,43,108,205,356,12,0,344,356,24,0,332,356
3186328,1934,247588,new-0.0,completed,297.0,7.0,219,78,29,0,268,297,0,29,268,297,42,0,255,297,44,5,248,297,4,0,293,297
3186328,1934,247588,new-0.5,completed,296.0,7.55,237,59,2,0,294,296,25,0,271,296,44,0,252,296,0,12,284,296,47,0,249,296
3186328,1934,247588,new-1.0,completed,309.0,7.7,223,86,16,0,293,309,0,32,277,309,51,0,258,309,56,0,253,309,42,0,267,309
3186328,1934,203195,base,completed,373.0,7.0,177,196,91,0,282,373,0,47,326,373,59,105,209,373,76,0,297,373,63,0,310,373
3186328,1934,203195,base+,completed,362.0,6.9,182,180,0,0,362,362,57,69,236,362,83,0,279,362,67,97,198,362,21,0,341,362
3186328,1934,203195,dpv1,completed,390.0,7.4,126,264,0,0,390,390,91,111,188,390,41,75,274,390,76,105,209,390,53,0,337,390
3186328,1934,203195,dpv2,completed,345.0,7.5,94,251,0,0,345,345,37,0,308,345,20,64,261,345,11,165,169,345,30,0,315,345
3186328,1934,203195,new-0.0,completed,317.0,7.05,229,88,0,0,317,317,38,0,279,317,87,0,230,317,40,1,276,317,69,0,248,317
3186328,1934,203195,new-0.5,completed,312.0,7.55,246,66,0,0,312,312,22,0,290,312,64,0,248,312,14,0,298,312,66,0,246,312
3186328,1934,203195,new-1.0,completed,327.0,7.6,174,153,0,71,256,327,25,0,302,327,52,0,275,327,16,6,305,327,48,27,252,327
3186328,1934,178029,base,completed,354.0,7.25,90,264,40,57,257,354,40,0,314,354,80,114,160,354,18,0,336,354,0,59,295,354
3186328,1934,178029,base+,completed,375.0,6.85,105,270,47,0,328,375,80,0,295,375,0,0,375,375,58,190,127,375,74,0,301,375
3186328,1934,178029,dpv1,completed,376.0,7.25,127,249,67,0,309,376,16,0,360,376,32,68,276,376,88,109,179,376,0,89,287,376
3186328,1934,178029,dpv2,completed,412.0,7.2,72,340,24,1,387,412,110,0,302,412,103,108,201,412,0,243,169,412,62,0,350,412
3186328,1934,178029,new-0.0,completed,302.0,7.2,238,64,15,1,286,302,31,0,271,302,24,0,278,302,63,0,239,302,0,0,302,302
3186328,1934,178029,new-0.5,completed,307.0,7.55,234,73,2,0,305,307,27,1,279,307,47,0,260,307,55,0,252,307,0,20,287,307
3186328,1934,178029,new-1.0,completed,314.0,7.5,225,89,43,0,271,314,0,0,314,314,35,46,233,314,23,0,291,314,27,0,287,314
3186328,1934,239735,base,completed,332.0,6.8,217,115,26,0,306,332,77,0,255,332,0,61,271,332,60,0,272,332,28,0,304,332
3186328,1934,239735,base+,completed,364.0,6.7,160,204,35,0,329,364,106,0,258,364,0,67,297,364,56,0,308,364,88,77,199,364
3186328,1934,239735,dpv1,completed,348.0,7.2,77,271,45,0,303,348,31,0,317,348,8,163,177,348,0,82,266,348,31,43,274,348
3186328,1934,239735,dpv2,completed,378.0,7.1,69,309,0,216,162,378,70,0,308,378,39,131,208,378,28,0,350,378,26,0,352,378
3186328,1934,239735,new-0.0,completed,293.0,7.15,219,74,38,0,255,293,34,0,259,293,26,0,267,293,74,0,219,293,0,0,293,293
3186328,1934,239735,new-0.5,completed,291.0,7.45,227,64,2,17,272,291,0,0,291,291,20,0,271,291,21,8,262,291,39,0,252,291
3186328,1934,239735,new-1.0,completed,333.0,7.6,176,157,55,79,199,333,0,2,331,333,46,0,287,333,35,10,288,333,78,0,255,333
3186328,1934,675528,base,completed,330.0,6.8,216,114,43,0,287,330,85,0,245,330,61,0,269,330,0,0,330,330,55,29,246,330
3186328,1934,675528,base+,completed,303.0,6.95,250,53,53,0,250,303,0,0,303,303,24,0,279,303,10,0,293,303,31,0,272,303
3186328,1934,675528,dpv1,completed,366.0,7.35,141,225,54,0,312,366,75,0,291,366,31,64,271,366,31,98,237,366,0,75,291,366
3186328,1934,675528,dpv2,completed,380.0,7.15,89,291,12,23,345,380,35,24,321,380,27,163,190,380,0,215,165,380,28,0,352,380
3186328,1934,675528,new-0.0,completed,301.0,6.95,248,53,6,0,295,301,7,0,294,301,53,0,248,301,52,0,249,301,0,0,301,301
3186328,1934,675528,new-0.5,completed,347.0,7.55,216,131,44,0,303,347,0,69,278,347,58,0,289,347,76,0,271,347,99,0,248,347
3186328,1934,675528,new-1.0,completed,326.0,7.7,209,117,1,6,319,326,0,63,263,326,45,0,281,326,48,0,278,326,45,0,281,326
3186328,1934,380692,base,completed,364.0,6.75,163,201,42,51,271,364,57,105,202,364,91,0,273,364,38,0,326,364,0,47,317,364
3186328,1934,380692,base+,completed,327.0,6.85,237,90,90,0,237,327,57,0,270,327,72,0,255,327,0,0,327,327,56,0,271,327
3186328,1934,380692,dpv1,completed,353.0,7.15,145,208,34,0,319,353,37,0,316,353,57,100,196,353,95,0,258,353,0,68,285,353
3186328,1934,380692,dpv2,completed,384.0,7.5,131,253,25,189,170,384,0,186,198,384,52,0,332,384,42,0,342,384,58,0,326,384
3186328,1934,380692,new-0.0,completed,301.0,7.05,244,57,16,0,285,301,22,0,279,301,30,0,271,301,57,0,244,301,0,0,301,301
3186328,1934,380692,new-0.5,completed,314.0,7.45,231,83,0,20,294,314,39,4,271,314,29,0,285,314,53,2,259,314,60,0,254,314
3186328,1934,380692,new-1.0,completed,313.0,7.6,187,126,50,0,263,313,6,0,307,313,50,0,263,313,0,0,313,313,10,76,227,313
4721516,1571,310811,base,completed,308.0,6.9,115,193,80,0,228,308,64,0,244,308,66,6,236,308,88,0,220,308,0,122,186,308
4721516,1571,310811,base+,completed,334.0,7.0,98,236,90,0,244,334,59,23,252,334,0,117,217,334,57,75,202,334,121,0,213,334
4721516,1571,310811,dpv1,completed,319.0,7.6,105,214,0,56,263,319,63,0,256,319,86,49,184,319,62,86,171,319,39,73,207,319
4721516,1571,310811,dpv2,completed,287.0,7.55,91,196,47,12,228,287,87,13,187,287,0,131,156,287,47,0,240,287,18,0,269,287
4721516,1571,310811,new-0.0,completed,277.0,7.45,145,132,51,1,225,277,78,36,163,277,61,0,216,277,0,30,247,277,73,4,200,277
4721516,1571,310811,new-0.5,completed,296.0,7.55,162,134,87,0,209,296,0,32,264,296,67,0,229,296,100,30,166,296,67,7,222,296
4721516,1571,310811,new-1.0,completed,285.0,7.7,136,149,55,2,228,285,87,32,166,285,55,0,230,285,0,55,230,285,43,0,242,285
4721516,1571,208428,base,completed,319.0,7.2,143,176,57,30,232,319,96,0,223,319,0,81,238,319,108,0,211,319,57,41,221,319
4721516,1571,208428,base+,completed,348.0,6.95,142,206,0,129,219,348,120,0,228,348,134,14,200,348,67,49,232,348,67,0,281,348
4721516,1571,208428,dpv1,completed,355.0,7.5,109,246,65,0,290,355,0,146,209,355,89,0,266,355,64,107,184,355,96,49,210,355
4721516,1571,208428,dpv2,completed,293.0,7.4,155,138,76,0,217,293,84,0,209,293,0,69,224,293,62,48,183,293,25,0,268,293
4721516,1571,208428,new-0.0,completed,298.0,7.35,166,132,87,0,211,298,103,0,195,298,67,0,231,298,72,13,213,298,0,50,248,298
4721516,1571,208428,new-0.5,completed,277.0,7.65,165,112,59,0,218,277,0,13,264,277,81,29,167,277,54,2,221,277,68,0,209,277
4721516,1571,208428,new-1.0,completed,280.0,7.7,146,134,91,13,176,280,38,0,242,280,65,13,202,280,0,39,241,280,36,0,244,280
4721516,1571,460300,base,completed,321.0,6.95,134,187,73,43,205,321,99,0,222,321,86,0,235,321,0,47,274,321,66,46,209,321
4721516,1571,460300,base+,completed,258.0,7.15,179,79,56,5,197,258,35,0,223,258,0,18,240,258,28,0,230,258,22,0,236,258
4721516,1571,460300,dpv1,completed,321.0,7.4,131,190,103,0,218,321,67,57,197,321,63,73,185,321,87,0,234,321,0,49,272,321
4721516,1571,460300,dpv2,completed,307.0,7.4,96,211,54,75,178,307,87,0,220,307,0,81,226,307,61,0,246,307,67,0,240,307
4721516,1571,460300,new-0.0,completed,300.0,7.45,161,139,59,13,228,300,102,30,168,300,67,0,233,300,0,34,266,300,86,0,214,300
4721516,1571,460300,new-0.5,completed,297.0,7.4,139,158,72,0,225,297,0,43,254,297,65,2,230,297,61,9,227,297,82,35,180,297
4721516,1571,460300,new-1.0,completed,291.0,7.6,139,152,90,29,172,291,65,0,226,291,65,0,226,291,0,50,241,291,45,0,246,291
4721516,1571,309704,base,completed,297.0,7.15,142,155,47,0,250,297,66,0,231,297,0,99,198,297,44,0,253,297,47,27,223,297
4721516,1571,309704,base+,completed,263.0,7.0,207,56,44,0,219,263,45,0,218,263,0,0,263,263,56,0,207,263,54,0,209,263
4721516,1571,309704,dpv1,completed,348.0,7.5,102,246,0,133,215,348,75,0,273,348,89,0,259,348,78,97,173,348,95,38,215,348
4721516,1571,309704,dpv2,completed,304.0,7.35,90,214,101,84,119,304,63,0,241,304,0,80,224,304,62,3,239,304,36,0,268,304
4721516,1571,309704,new-0.0,completed,300.0,7.5,154,146,89,0,211,300,109,32,159,300,66,0,234,300,0,39,261,300,63,0,237,300
4721516,1571,309704,new-0.5,completed,291.0,7.5,160,131,72,0,219,291,56,0,235,291,68,7,216,291,85,0,206,291,0,48,243,291
4721516,1571,309704,new-1.0,completed,294.0,7.65,134,160,102,31,161,294,66,8,220,294,72,0,222,294,0,50,244,294,37,0,257,294
4721516,1571,247588,base,completed,313.0,6.85,115,198,87,81,145,313,52,0,261,313,0,79,234,313,60,0,253,313,62,9,242,313
4721516,1571,247588,base+,completed,312.0,6.8,116,196,55,0,257,312,26,0,286,312,0,96,216,312,50,29,233,312,89,74,149,312
4721516,1571,247588,dpv1,completed,306.0,7.65,101,205,65,0,241,306,56,0,250,306,0,108,198,306,54,78,174,306,22,61,223,306
4721516,1571,247588,dpv2,completed,277.0,7.4,91,186,13,87,177,277,56,27,194,277,0,39,238,277,49,0,228,277,37,0,240,277
4721516,1571,247588,new-0.0,completed,285.0,7.45,168,117,64,5,216,285,90,21,174,285,64,0,221,285,0,21,264,285,68,0,217,285
4721516,1571,247588,new-0.5,completed,280.0,7.55,143,137,64,0,216,280,53,0,227,280,67,12,201,280,0,18,262,280,81,37,162,280
4721516,1571,247588,new-1.0,completed,272.0,7.6,147,125,74,20,178,272,53,0,219,272,54,4,214,272,0,51,221,272,31,0,241,272
4721516,1571,203195,base,completed,292.0,7.1,155,137,69,0,223,292,68,0,224,292,0,64,228,292,94,0,198,292,40,0,252,292
4721516,1571,203195,base+,completed,288.0,6.8,173,115,62,0,226,288,62,0,226,288,40,0,248,288,62,10,216,288,0,51,237,288
4721516,1571,203195,dpv1,completed,328.0,7.65,95,233,86,0,242,328,55,0,273,328,0,146,182,328,54,105,169,328,60,49,219,328
4721516,1571,203195,dpv2,completed,300.0,7.4,91,209,27,77,196,300,60,0,240,300,0,93,207,300,60,9,231,300,86,0,214,300
4721516,1571,203195,new-0.0,completed,291.0,7.45,158,133,65,1,225,291,98,29,164,291,66,0,225,291,0,31,260,291,83,0,208,291
4721516,1571,203195,new-0.5,completed,283.0,7.55,168,115,64,2,217,283,51,0,232,283,60,0,223,283,0,16,267,283,84,25,174,283
4721516,1571,203195,new-1.0,completed,286.0,7.6,148,138,84,26,176,286,53,0,233,286,68,6,212,286,0,38,248,286,36,0,250,286
4721516,1571,178029,base,completed,256.0,7.1,141,115,48,0,208,256,39,0,217,256,0,41,215,256,13,26,217,256,21,0,235,256
4721516,1571,178029,base+,completed,291.0,7.2,179,112,52,0,239,291,77,0,214,291,71,0,220,291,63,0,228,291,0,43,248,291
4721516,1571,178029,dpv1,completed,330.0,7.6,115,215,67,0,263,330,0,110,220,330,85,0,245,330,66,50,214,330,116,32,182,330
4721516,1571,178029,dpv2,completed,273.0,7.5,136,137,62,0,211,273,25,14,234,273,0,53,220,273,56,0,217,273,71,0,202,273
4721516,1571,178029,new-0.0,completed,289.0,7.35,151,138,70,0,219,289,89,31,169,289,79,3,207,289,0,20,269,289,66,13,210,289
4721516,1571,178029,new-0.5,completed,292.0,7.55,165,127,61,1,230,292,0,19,273,292,75,1,216,292,84,36,172,292,50,0,242,292
4721516,1571,178029,new-1.0,completed,280.0,7.65,137,143,63,6,211,280,79,0,201,280,32,29,219,280,0,43,237,280,30,0,250,280
4721516,1571,239735,base,completed,306.0,6.9,150,156,47,0,259,306,60,0,246,306,0,84,222,306,59,31,216,306,114,6,186,306
4721516,1571,239735,base+,completed,316.0,6.85,104,212,87,0,229,316,70,0,246,316,69,70,177,316,0,136,180,316,31,0,285,316
4721516,1571,239735,dpv1,completed,316.0,7.65,106,210,72,0,244,316,48,78,190,316,0,68,248,316,46,99,171,316,70,38,208,316
4721516,1571,239735,dpv2,completed,291.0,7.45,88,203,89,84,118,291,31,0,260,291,0,79,212,291,50,0,241,291,60,0,231,291
4721516,1571,239735,new-0.0,completed,288.0,7.4,154,134,61,13,214,288,0,62,226,288,68,0,220,288,97,0,191,288,94,0,194,288
4721516,1571,239735,new-0.5,completed,280.0,7.55,151,129,60,0,220,280,0,25,255,280,62,0,218,280,84,36,160,280,60,4,216,280
4721516,1571,239735,new-1.0,completed,266.0,7.65,139,127,80,22,164,266,48,1,217,266,59,0,207,266,0,40,226,266,23,0,243,266
4721516,1571,675528,base,completed,300.0,7.15,132,168,0,96,204,300,32,15,253,300,67,0,233,300,68,0,232,300,84,35,181,300
4721516,1571,675528,base+,completed,324.0,7.1,155,169,0,98,226,324,106,0,218,324,62,0,262,324,64,56,204,324,113,0,211,324
4721516,1571,675528,dpv1,completed,313.0,7.45,107,206,107,0,206,313,50,57,206,313,0,115,198,313,55,36,222,313,43,12,258,313
4721516,1571,675528,dpv2,completed,284.0,7.45,110,174,65,0,219,284,63,10,211,284,0,109,175,284,38,0,246,284,19,0,265,284
4721516,1571,675528,new-0.0,completed,299.0,7.45,166,133,62,15,222,299,104,25,170,299,61,0,238,299,0,40,259,299,95,0,204,299
4721516,1571,675528,new-0.5,completed,296.0,7.65,161,135,0,63,233,296,105,0,191,296,63,0,233,296,57,23,216,296,84,0,212,296
4721516,1571,675528,new-1.0,completed,285.0,7.65,137,148,62,0,223,285,23,0,262,285,84,30,171,285,0,47,238,285,42,0,243,285
4721516,1571,380692,base,completed,308.0,6.85,164,144,0,60,248,308,62,51,195,308,64,0,244,308,59,0,249,308,91,0,217,308
4721516,1571,380692,base+,completed,339.0,6.7,100,239,104,0,235,339,0,48,291,339,63,0,276,339,66,86,187,339,86,119,134,339
4721516,1571,380692,dpv1,completed,311.0,7.55,104,207,92,0,219,311,69,0,242,311,68,64,179,311,39,58,214,311,0,60,251,311
4721516,1571,380692,dpv2,completed,303.0,7.4,93,210,29,78,196,303,64,8,231,303,0,89,214,303,65,0,238,303,99,0,204,303
4721516,1571,380692,new-0.0,completed,295.0,7.25,157,138,61,7,227,295,90,0,205,295,72,0,223,295,0,26,269,295,102,34,159,295
4721516,1571,380692,new-0.5,completed,274.0,7.65,159,115,61,2,211,274,0,43,231,274,60,0,214,274,79,0,195,274,55,0,219,274
4721516,1571,380692,new-1.0,completed,288.0,7.65,143,145,88,17,183,288,55,0,233,288,68,0,220,288,0,56,232,288,48,0,240,288
5038385,1782,310811,base,completed,363.0,7.15,143,220,71,38,254,363,99,76,188,363,37,0,326,363,0,144,219,363,51,0,312,363
5038385,1782,310811,base+,completed,376.0,7.5,163,213,58,58,260,376,26,80,270,376,24,0,352,376,22,153,201,376,0,166,210,376
5038385,1782,310811,dpv1,completed,300.0,7.6,201,99,68,0,232,300,49,0,251,300,0,31,269,300,32,0,268,300,63,0,237,300
5038385,1782,310811,dpv2,completed,361.0,7.5,149,212,80,78,203,361,20,38,303,361,51,101,209,361,0,97,264,361,81,15,265,361
5038385,1782,310811,new-0.0,completed,304.0,7.15,191,113,0,11,293,304,49,29,226,304,22,0,282,304,57,0,247,304,80,18,206,304
5038385,1782,310811,new-0.5,completed,293.0,7.8,211,82,50,0,243,293,63,0,230,293,39,0,254,293,54,0,239,293,0,19,274,293
5038385,1782,310811,new-1.0,completed,336.0,7.7,179,157,0,55,281,336,39,0,297,336,83,6,247,336,82,0,254,336,104,35,197,336
5038385,1782,208428,base,completed,364.0,6.95,162,202,49,70,245,364,0,128,236,364,106,0,258,364,64,0,300,364,40,41,283,364
5038385,1782,208428,base+,completed,282.0,7.1,207,75,42,15,225,282,5,13,264,282,0,0,282,282,47,0,235,282,1,0,281,282
5038385,1782,208428,dpv1,completed,302.0,7.5,204,98,20,0,282,302,51,0,251,302,48,0,254,302,41,18,243,302,0,29,273,302
5038385,1782,208428,dpv2,completed,364.0,7.5,152,212,4,52,308,364,75,0,289,364,73,89,202,364,0,102,262,364,34,126,204,364
5038385,1782,208428,new-0.0,completed,298.0,7.2,181,117,0,30,268,298,62,0,236,298,72,0,226,298,51,20,227,298,18,0,280,298
5038385,1782,208428,new-0.5,completed,316.0,7.75,199,117,76,0,240,316,81,0,235,316,0,48,268,316,66,0,250,316,42,0,274,316
5038385,1782,208428,new-1.0,completed,322.0,7.55,200,122,54,0,268,322,0,35,287,322,36,0,286,322,90,21,211,322,82,0,240,322
5038385,1782,460300,base,completed,433.0,6.85,133,300,48,73,312,433,79,133,221,433,97,0,336,433,0,231,202,433,86,120,227,433
5038385,1782,460300,base+,completed,304.0,6.75,198,106,55,0,249,304,31,0,273,304,66,40,198,304,0,0,304,304,18,0,286,304
5038385,1782,460300,dpv1,completed,322.0,7.5,191,131,62,0,260,322,53,0,269,322,76,0,246,322,80,0,242,322,0,56,266,322
5038385,1782,460300,dpv2,completed,339.0,7.55,171,168,53,44,242,339,54,61,224,339,74,10,255,339,70,0,269,339,0,62,277,339
5038385,1782,460300,new-0.0,completed,294.0,7.55,199,95,60,0,234,294,58,0,236,294,28,0,266,294,48,15,231,294,0,20,274,294
5038385,1782,460300,new-0.5,completed,329.0,7.75,206,123,83,0,246,329,97,0,232,329,0,45,284,329,87,2,240,329,49,0,280,329
5038385,1782,460300,new-1.0,completed,349.0,7.7,166,183,103,21,225,349,59,5,285,349,114,0,235,349,50,38,261,349,0,40,309,349
5038385,1782,309704,base,completed,399.0,7.0,142,257,94,79,226,399,119,86,194,399,70,29,300,399,52,0,347,399,0,182,217,399
5038385,1782,309704,base+,completed,380.0,6.95,147,233,0,69,311,380,51,0,329,380,106,101,173,380,52,82,246,380,106,61,213,380
5038385,1782,309704,dpv1,completed,323.0,7.5,186,137,91,0,232,323,74,0,249,323,71,0,252,323,0,47,276,323,55,12,256,323
5038385,1782,309704,dpv2,completed,368.0,7.65,150,218,38,93,237,368,66,105,197,368,58,0,310,368,55,57,256,368,0,100,268,368
5038385,1782,309704,new-0.0,completed,291.0,7.5,183,108,0,9,282,291,50,0,241,291,9,0,282,291,39,21,231,291,75,14,202,291
5038385,1782,309704,new-0.5,completed,317.0,7.8,201,116,65,0,252,317,48,0,269,317,91,0,226,317,74,0,243,317,0,43,274,317
5038385,1782,309704,new-1.0,completed,340.0,7.6,180,160,111,0,229,340,55,0,285,340,79,1,260,340,0,83,257,340,84,0,256,340
5038385,1782,247588,base,completed,358.0,7.0,129,229,5,20,333,358,48,0,310,358,16,142,200,358,86,20,252,358,0,131,227,358
5038385,1782,247588,base+,completed,289.0,7.15,225,64,52,7,230,289,0,5,284,289,40,0,249,289,44,0,245,289,33,0,256,289
5038385,1782,247588,dpv1,completed,311.0,7.55,186,125,79,0,232,311,64,0,247,311,64,0,247,311,50,0,261,311,0,58,253,311
5038385,1782,247588,dpv2,completed,340.0,7.55,156,184,4,47,289,340,58,73,209,340,30,109,201,340,0,86,254,340,63,0,277,340
5038385,1782,247588,new-0.0,completed,281.0,7.2,192,89,2,10,269,281,39,0,242,281,54,0,227,281,37,13,231,281,0,12,269,281
5038385,1782,247588,new-0.5,completed,315.0,7.8,201,114,63,0,252,315,47,0,268,315,88,0,227,315,65,0,250,315,0,46,269,315
5038385,1782,247588,new-1.0,completed,322.0,7.6,199,123,95,0,227,322,75,0,247,322,47,25,250,322,71,0,251,322,0,47,275,322
5038385,1782,203195,base,completed,372.0,7.2,143,229,0,89,283,372,44,130,198,372,62,93,217,372,99,0,273,372,39,0,333,372
5038385,1782,203195,base+,completed,311.0,6.95,186,125,44,0,267,311,36,0,275,311,0,47,264,311,91,7,213,311,19,0,292,311
5038385,1782,203195,dpv1,completed,301.0,7.45,226,75,60,0,241,301,57,0,244,301,48,0,253,301,52,2,247,301,0,13,288,301
5038385,1782,203195,dpv2,completed,368.0,7.5,141,227,75,87,206,368,14,50,304,368,45,124,199,368,0,108,260,368,74,15,279,368
5038385,1782,203195,new-0.0,completed,304.0,7.4,187,117,67,0,237,304,50,38,216,304,30,0,274,304,76,0,228,304,0,27,277,304
5038385,1782,203195,new-0.5,completed,314.0,7.7,207,107,79,0,235,314,80,0,234,314,42,0,272,314,71,0,243,314,0,36,278,314
5038385,1782,203195,new-1.0,completed,336.0,7.7,180,156,67,0,269,336,78,0,258,336,0,47,289,336,49,0,287,336,113,38,185,336
5038385,1782,178029,base,completed,362.0,7.4,106,256,9,185,168,362,38,0,324,362,42,99,221,362,0,11,351,362,68,94,200,362
5038385,1782,178029,base+,completed,328.0,6.9,173,155,92,15,221,328,62,16,250,328,42,0,286,328,0,48,280,328,99,12,217,328
5038385,1782,178029,dpv1,completed,298.0,7.45,201,97,23,0,275,298,35,0,263,298,67,0,231,298,0,27,271,298,42,6,250,298
5038385,1782,178029,dpv2,completed,334.0,7.5,165,169,42,51,241,334,69,0,265,334,66,17,251,334,0,53,281,334,54,67,213,334
5038385,1782,178029,new-0.0,completed,298.0,7.5,189,109,0,6,292,298,61,0,237,298,18,0,280,298,40,35,223,298,74,19,205,298
5038385,1782,178029,new-0.5,completed,303.0,7.75,203,100,60,0,243,303,0,31,272,303,65,0,238,303,40,0,263,303,63,4,236,303
5038385,1782,178029,new-1.0,completed,344.0,7.75,198,146,44,0,300,344,81,2,261,344,96,0,248,344,113,0,231,344,0,76,268,344
5038385,1782,239735,base,completed,343.0,7.05,145,198,38,51,254,343,16,0,327,343,0,125,218,343,94,6,243,343,13,118,212,343
5038385,1782,239735,base+,completed,310.0,7.2,166,144,0,37,273,310,63,31,216,310,34,33,243,310,37,0,273,310,55,0,255,310
5038385,1782,239735,dpv1,completed,276.0,7.5,206,70,24,0,252,276,48,0,228,276,28,0,248,276,39,0,237,276,0,22,254,276
5038385,1782,239735,dpv2,completed,300.0,7.55,156,144,36,31,233,300,27,0,273,300,0,32,268,300,61,41,198,300,53,13,234,300
5038385,1782,239735,new-0.0,completed,278.0,7.55,185,93,57,0,221,278,45,0,233,278,4,15,259,278,35,30,213,278,0,6,272,278
5038385,1782,239735,new-0.5,completed,298.0,7.8,198,100,58,0,240,298,81,0,217,298,57,0,241,298,45,0,253,298,0,36,262,298
5038385,1782,239735,new-1.0,completed,328.0,7.65,159,169,111,0,217,328,83,0,245,328,40,46,242,328,74,0,254,328,0,55,273,328
5038385,1782,675528,base,completed,363.0,6.7,163,200,116,0,247,363,0,128,235,363,109,40,214,363,52,0,311,363,96,0,267,363
5038385,1782,675528,base+,completed,303.0,7.1,169,134,76,0,227,303,66,0,237,303,51,3,249,303,0,14,289,303,12,48,243,303
5038385,1782,675528,dpv1,completed,301.0,7.45,211,90,29,0,272,301,49,0,252,301,47,0,254,301,0,32,269,301,58,0,243,301
5038385,1782,675528,dpv2,completed,380.0,7.45,145,235,76,98,206,380,0,20,360,380,25,62,293,380,80,94,206,380,41,143,196,380
5038385,1782,675528,new-0.0,completed,291.0,7.55,190,101,55,0,236,291,61,0,230,291,13,19,259,291,45,24,222,291,0,8,283,291
5038385,1782,675528,new-0.5,completed,314.0,7.75,213,101,80,0,234,314,71,0,243,314,0,35,279,314,68,0,246,314,38,0,276,314
5038385,1782,675528,new-1.0,completed,320.0,7.65,186,134,96,5,219,320,80,0,240,320,37,10,273,320,46,0,274,320,0,55,265,320
5038385,1782,380692,base,completed,324.0,6.8,171,153,69,0,255,324,49,0,275,324,49,51,224,324,81,39,204,324,0,26,298,324
5038385,1782,380692,base+,completed,331.0,7.1,188,143,47,2,282,331,94,20,217,331,33,45,253,331,87,0,244,331,0,62,269,331
5038385,1782,380692,dpv1,completed,316.0,7.65,205,111,67,0,249,316,49,0,267,316,66,0,250,316,71,0,245,316,0,40,276,316
5038385,1782,380692,dpv2,completed,290.0,7.55,162,128,5,16,269,290,2,2,286,290,78,0,212,290,40,32,218,290,0,24,266,290
5038385,1782,380692,new-0.0,completed,297.0,7.2,182,115,0,9,288,297,61,0,236,297,76,0,221,297,50,26,221,297,1,22,274,297
5038385,1782,380692,new-0.5,completed,324.0,7.75,206,118,93,0,231,324,102,0,222,324,0,46,278,324,81,0,243,324,48,0,276,324
5038385,1782,380692,new-1.0,completed,317.0,7.65,164,153,48,0,269,317,29,0,288,317,107,37,173,317,71,0,246,317,0,50,267,317
7110755,1805,310811,base,completed,317.0,6.9,192,125,59,64,194,317,17,0,300,317,42,0,275,317,0,9,308,317,57,0,260,317
7110755,1805,310811,base+,completed,316.0,7.15,194,122,37,43,236,316,63,0,253,316,59,0,257,316,57,20,239,316,0,0,316,316
7110755,1805,310811,dpv1,completed,305.0,7.6,228,77,0,0,305,305,77,0,228,305,38,0,267,305,49,0,256,305,29,11,265,305
7110755,1805,310811,dpv2,completed,303.0,7.6,207,96,47,0,256,303,2,0,301,303,0,45,258,303,74,5,224,303,25,0,278,303
7110755,1805,310811,new-0.0,completed,306.0,7.65,214,92,83,0,223,306,44,0,262,306,86,0,220,306,0,6,300,306,46,0,260,306
7110755,1805,310811,new-0.5,completed,293.0,7.75,221,72,0,24,269,293,50,0,243,293,33,22,238,293,21,0,272,293,6,0,287,293
7110755,1805,310811,new-1.0,completed,295.0,7.85,214,81,22,0,273,295,27,0,268,295,53,5,237,295,0,3,292,295,73,0,222,295
7110755,1805,208428,base,completed,348.0,7.0,140,208,0,0,348,348,76,0,272,348,84,0,264,348,62,60,226,348,83,78,187,348
7110755,1805,208428,base+,completed,332.0,7.25,176,156,0,42,290,332,36,0,296,332,44,68,220,332,52,48,232,332,23,44,265,332
7110755,1805,208428,dpv1,completed,312.0,7.55,240,72,52,0,260,312,72,0,240,312,0,0,312,312,53,0,259,312,33,18,261,312
7110755,1805,208428,dpv2,completed,314.0,7.9,194,120,51,0,263,314,57,40,217,314,35,53,226,314,0,0,314,314,14,50,250,314
7110755,1805,208428,new-0.0,completed,309.0,7.8,218,91,20,0,289,309,89,0,220,309,91,0,218,309,0,0,309,309,47,0,262,309
7110755,1805,208428,new-0.5,completed,292.0,7.85,220,72,9,13,270,292,42,26,224,292,0,0,292,292,30,0,262,292,46,0,246,292
7110755,1805,208428,new-1.0,completed,303.0,7.9,192,111,48,0,255,303,61,17,225,303,7,9,287,303,74,11,218,303,0,0,303,303
7110755,1805,460300,base,completed,301.0,7.2,177,124,29,41,231,301,20,11,270,301,15,0,286,301,0,41,260,301,6,33,262,301
7110755,1805,460300,base+,completed,310.0,7.1,209,101,0,0,310,310,58,13,239,310,32,2,276,310,13,15,282,310,36,41,233,310
7110755,1805,460300,dpv1,completed,320.0,7.4,212,108,43,0,277,320,81,0,239,320,55,15,250,320,0,12,308,320,48,0,272,320
7110755,1805,460300,dpv2,completed,328.0,7.55,203,125,52,0,276,328,0,36,292,328,14,15,299,328,41,44,243,328,59,45,224,328
7110755,1805,460300,new-0.0,completed,291.0,7.25,250,41,4,3,284,291,29,0,262,291,0,0,291,291,38,0,253,291,39,0,252,291
7110755,1805,460300,new-0.5,completed,297.0,7.8,212,85,0,17,280,297,1,0,296,297,36,27,234,297,25,0,272,297,58,0,239,297
7110755,1805,460300,new-1.0,completed,311.0,7.9,216,95,35,14,262,311,82,0,229,311,68,0,243,311,0,13,298,311,29,0,282,311
7110755,1805,309704,base,completed,319.0,6.95,196,123,15,7,297,319,0,21,298,319,59,18,242,319,36,64,219,319,52,0,267,319
7110755,1805,309704,base+,completed,344.0,6.8,201,143,71,0,273,344,0,29,315,344,52,2,290,344,78,54,212,344,89,27,228,344
7110755,1805,309704,dpv1,completed,322.0,7.3,192,130,45,18,259,322,57,0,265,322,68,35,219,322,0,27,295,322,37,0,285,322
7110755,1805,309704,dpv2,completed,320.0,7.8,210,110,0,25,295,320,15,18,287,320,38,54,228,320,45,0,275,320,56,31,233,320
7110755,1805,309704,new-0.0,completed,302.0,7.65,218,84,83,0,219,302,20,0,282,302,77,0,225,302,0,1,301,302,45,0,257,302
7110755,1805,309704,new-0.5,completed,295.0,7.75,223,72,46,20,229,295,0,0,295,295,8,9,278,295,34,0,261,295,52,0,243,295
7110755,1805,309704,new-1.0,completed,307.0,8.0,194,113,40,0,267,307,65,13,229,307,89,6,212,307,17,5,285,307,0,0,307,307
7110755,1805,247588,base,completed,288.0,7.2,206,82,32,0,256,288,26,0,262,288,7,29,252,288,5,0,283,288,0,38,250,288
7110755,1805,247588,base+,completed,318.0,7.45,186,132,62,29,227,318,20,12,286,318,39,22,257,318,0,33,285,318,50,21,247,318
7110755,1805,247588,dpv1,completed,319.0,7.15,222,97,60,0,259,319,0,0,319,319,39,0,280,319,86,11,222,319,57,0,262,319
7110755,1805,247588,dpv2,completed,307.0,7.75,200,107,0,0,307,307,45,0,262,307,79,2,226,307,35,0,272,307,16,52,239,307
7110755,1805,247588,new-0.0,completed,296.0,7.75,222,74,74,0,222,296,59,0,237,296,0,0,296,296,67,0,229,296,43,0,253,296
7110755,1805,247588,new-0.5,completed,276.0,7.85,201,75,18,0,258,276,24,29,223,276,8,0,268,276,18,0,258,276,0,28,248,276
7110755,1805,247588,new-1.0,completed,293.0,7.9,211,82,14,0,279,293,69,13,211,293,44,0,249,293,0,0,293,293,25,0,268,293
7110755,1805,203195,base,completed,333.0,7.55,184,149,55,0,278,333,48,0,285,333,24,101,208,333,9,0,324,333,0,104,229,333
7110755,1805,203195,base+,completed,301.0,7.05,226,75,49,6,246,301,28,4,269,301,34,0,267,301,0,0,301,301,48,17,236,301
7110755,1805,203195,dpv1,completed,309.0,7.35,238,71,0,0,309,309,71,0,238,309,48,0,261,309,54,0,255,309,31,15,263,309
7110755,1805,203195,dpv2,completed,323.0,7.65,188,135,62,0,261,323,0,37,286,323,11,12,300,323,52,53,218,323,36,44,243,323
7110755,1805,203195,new-0.0,completed,284.0,7.6,245,39,0,0,284,284,39,0,245,284,35,0,249,284,25,0,259,284,4,12,268,284
7110755,1805,203195,new-0.5,completed,300.0,7.8,214,86,7,14,279,300,0,0,300,300,35,18,247,300,30,0,270,300,68,0,232,300
7110755,1805,203195,new-1.0,completed,294.0,7.85,206,88,11,7,276,294,15,2,277,294,48,0,246,294,0,15,279,294,71,0,223,294
7110755,1805,178029,base,completed,316.0,7.4,200,116,48,0,268,316,53,32,231,316,55,54,207,316,0,0,316,316,14,40,262,316
7110755,1805,178029,base+,completed,290.0,7.25,230,60,10,23,257,290,31,0,259,290,21,0,269,290,31,6,253,290,0,0,290,290
7110755,1805,178029,dpv1,completed,309.0,7.6,232,77,0,0,309,309,59,0,250,309,51,13,245,309,41,4,264,309,41,1,267,309
7110755,1805,178029,dpv2,completed,308.0,7.7,199,109,39,0,269,308,0,15,293,308,43,48,217,308,20,12,276,308,61,22,225,308
7110755,1805,178029,new-0.0,completed,296.0,7.6,234,62,0,0,296,296,62,0,234,296,46,0,250,296,32,0,264,296,8,14,274,296
7110755,1805,178029,new-0.5,completed,302.0,7.6,215,87,15,0,287,302,55,0,247,302,54,0,248,302,39,0,263,302,0,37,265,302
7110755,1805,178029,new-1.0,completed,306.0,7.9,222,84,18,17,271,306,72,0,234,306,51,9,246,306,0,3,303,306,40,0,266,306
7110755,1805,239735,base,completed,313.0,7.3,138,175,21,83,209,313,0,0,313,313,34,0,279,313,5,14,294,313,46,67,200,313
7110755,1805,239735,base+,completed,277.0,7.25,222,55,7,0,270,277,21,0,256,277,34,0,243,277,44,6,227,277,0,11,266,277
7110755,1805,239735,dpv1,completed,297.0,7.4,212,85,42,1,254,297,57,0,240,297,0,21,276,297,36,6,255,297,37,0,260,297
7110755,1805,239735,dpv2,completed,308.0,7.8,202,106,37,0,271,308,36,56,216,308,41,38,229,308,12,14,282,308,0,24,284,308
7110755,1805,239735,new-0.0,completed,286.0,7.3,227,59,0,0,286,286,50,0,236,286,59,0,227,286,20,0,266,286,50,0,236,286
7110755,1805,239735,new-0.5,completed,297.0,7.6,203,94,25,26,246,297,67,0,230,297,0,20,277,297,53,0,244,297,46,1,250,297
7110755,1805,239735,new-1.0,completed,293.0,7.9,192,101,32,0,261,293,59,13,221,293,15,7,271,293,0,9,284,293,72,0,221,293
7110755,1805,675528,base,completed,323.0,7.55,162,161,31,69,223,323,21,0,302,323,32,37,254,323,52,9,262,323,0,61,262,323
7110755,1805,675528,base+,completed,309.0,6.65,202,107,37,36,236,309,0,0,309,309,13,8,288,309,35,0,274,309,47,38,224,309
7110755,1805,675528,dpv1,completed,298.0,7.35,247,51,37,0,261,298,49,0,249,298,12,14,272,298,0,0,298,298,45,0,253,298
7110755,1805,675528,dpv2,completed,324.0,7.8,205,119,51,0,273,324,24,15,285,324,0,32,292,324,56,41,227,324,48,43,233,324
7110755,1805,675528,new-0.0,completed,306.0,7.8,230,76,0,0,306,306,47,0,259,306,76,0,230,306,61,0,245,306,47,0,259,306
7110755,1805,675528,new-0.5,completed,292.0,7.75,220,72,50,20,222,292,52,0,240,292,0,0,292,292,22,0,270,292,0,28,264,292
7110755,1805,675528,new-1.0,completed,299.0,7.85,205,94,17,0,282,299,31,11,257,299,60,4,235,299,0,10,289,299,69,0,230,299
7110755,1805,380692,base,completed,312.0,7.25,212,100,50,0,262,312,71,0,241,312,0,0,312,312,65,29,218,312,41,7,264,312
7110755,1805,380692,base+,completed,294.0,6.85,187,107,27,0,267,294,72,6,216,294,1,0,293,294,0,46,248,294,22,0,272,294
7110755,1805,380692,dpv1,completed,309.0,7.45,226,83,47,0,262,309,0,0,309,309,54,0,255,309,71,12,226,309,43,0,266,309
7110755,1805,380692,dpv2,completed,325.0,7.7,184,141,63,4,258,325,14,16,295,325,0,33,292,325,49,53,223,325,37,55,233,325
7110755,1805,380692,new-0.0,completed,292.0,7.6,237,55,0,0,292,292,52,0,240,292,41,0,251,292,44,3,245,292,14,0,278,292
7110755,1805,380692,new-0.5,completed,291.0,7.75,188,103,1,55,235,291,0,0,291,291,25,0,266,291,29,0,262,291,57,0,234,291
7110755,1805,380692,new-1.0,completed,289.0,7.9,208,81,6,7,276,289,66,6,217,289,39,0,250,289,0,9,280,289,12,0,277,289
9201302,1645,310811,base,completed,298.0,7.05,110,188,33,0,265,298,61,0,237,298,0,37,261,298,36,118,144,298,22,0,276,298
9201302,1645,310811,base+,completed,321.0,6.85,153,168,67,12,242,321,0,0,321,321,90,1,230,321,42,31,248,321,81,34,206,321
9201302,1645,310811,dpv1,completed,301.0,7.0,119,182,44,0,257,301,21,77,203,301,83,27,191,301,0,0,301,301,40,51,210,301
9201302,1645,310811,dpv2,completed,309.0,7.35,147,162,62,0,247,309,32,71,206,309,0,3,306,309,97,0,212,309,51,40,218,309
9201302,1645,310811,new-0.0,completed,294.0,7.05,202,92,92,0,202,294,80,0,214,294,0,0,294,294,63,0,231,294,44,0,250,294
9201302,1645,310811,new-0.5,completed,282.0,7.2,191,91,24,16,242,282,19,15,248,282,73,0,209,282,59,0,223,282,0,3,279,282
9201302,1645,310811,new-1.0,completed,267.0,7.4,174,93,25,0,242,267,31,16,220,267,12,0,255,267,0,4,263,267,22,43,202,267
9201302,1645,208428,base,completed,297.0,6.85,148,149,73,0,224,297,15,0,282,297,56,75,166,297,74,0,223,297,0,0,297,297
9201302,1645,208428,base+,completed,311.0,7.2,140,171,51,50,210,311,0,0,311,311,82,0,229,311,94,27,190,311,47,0,264,311
9201302,1645,208428,dpv1,completed,309.0,6.95,119,190,36,67,206,309,49,0,260,309,18,102,189,309,76,0,233,309,0,1,308,309
9201302,1645,208428,dpv2,completed,286.0,7.25,145,141,30,4,252,286,0,34,252,286,33,26,227,286,65,0,221,286,5,39,242,286
9201302,1645,208428,new-0.0,completed,271.0,7.15,200,71,26,2,243,271,54,0,217,271,36,7,228,271,0,2,269,271,60,0,211,271
9201302,1645,208428,new-0.5,completed,277.0,7.2,196,81,35,6,236,277,0,0,277,277,24,8,245,277,54,0,223,277,69,0,208,277
9201302,1645,208428,new-1.0,completed,265.0,7.3,183,82,19,55,191,265,27,0,238,265,11,0,254,265,0,0,265,265,22,0,243,265
9201302,1645,460300,base,completed,299.0,6.75,207,92,59,0,240,299,0,0,299,299,69,0,230,299,20,23,256,299,90,0,209,299
9201302,1645,460300,base+,completed,270.0,7.05,216,54,0,0,270,270,39,0,231,270,25,0,245,270,54,0,216,270,35,0,235,270
9201302,1645,460300,dpv1,completed,308.0,7.1,153,155,15,82,211,308,90,0,218,308,54,0,254,308,46,28,234,308,0,10,298,308
9201302,1645,460300,dpv2,completed,315.0,7.25,162,153,96,0,219,315,74,0,241,315,0,8,307,315,75,26,214,315,31,60,224,315
9201302,1645,460300,new-0.0,completed,272.0,7.2,179,93,28,0,244,272,35,7,230,272,3,43,226,272,43,0,229,272,0,0,272,272
9201302,1645,460300,new-0.5,completed,297.0,7.35,202,95,45,13,239,297,0,0,297,297,46,0,251,297,81,0,216,297,82,0,215,297
9201302,1645,460300,new-1.0,completed,264.0,7.3,185,79,29,10,225,264,0,0,264,264,21,49,194,264,2,1,261,264,15,0,249,264
9201302,1645,309704,base,completed,312.0,6.9,116,196,50,0,262,312,0,105,207,312,17,146,149,312,4,0,308,312,20,0,292,312
9201302,1645,309704,base+,completed,313.0,6.85,133,180,0,0,313,313,61,28,224,313,71,49,193,313,72,0,241,313,24,31,258,313
9201302,1645,309704,dpv1,completed,357.0,7.0,122,235,0,0,357,357,52,5,300,357,60,116,181,357,62,108,187,357,86,99,172,357
9201302,1645,309704,dpv2,completed,293.0,7.3,134,159,35,0,258,293,12,76,205,293,75,8,210,293,0,0,293,293,48,40,205,293
9201302,1645,309704,new-0.0,completed,283.0,7.0,202,81,0,0,283,283,60,0,223,283,37,0,246,283,40,6,237,283,75,0,208,283
9201302,1645,309704,new-0.5,completed,293.0,7.3,193,100,0,0,293,293,63,0,230,293,100,0,193,293,76,0,217,293,55,0,238,293
9201302,1645,309704,new-1.0,completed,284.0,7.2,153,131,50,67,167,284,6,0,278,284,0,1,283,284,47,29,208,284,45,0,239,284
9201302,1645,247588,base,completed,323.0,6.75,117,206,52,124,147,323,1,67,255,323,46,0,277,323,79,11,233,323,0,33,290,323
9201302,1645,247588,base+,completed,302.0,6.95,173,129,87,0,215,302,85,0,217,302,0,7,295,302,45,17,240,302,76,29,197,302
9201302,1645,247588,dpv1,completed,300.0,7.1,105,195,0,36,264,300,10,77,213,300,37,0,263,300,75,0,225,300,34,62,204,300
9201302,1645,247588,dpv2,completed,282.0,7.2,128,154,25,0,257,282,58,0,224,282,15,38,229,282,0,27,255,282,8,54,220,282
9201302,1645,247588,new-0.0,completed,270.0,7.25,198,72,40,0,230,270,50,0,220,270,20,18,232,270,0,0,270,270,54,0,216,270
9201302,1645,247588,new-0.5,completed,271.0,7.4,196,75,32,4,235,271,30,10,231,271,70,0,201,271,50,0,221,271,0,0,271,271
9201302,1645,247588,new-1.0,completed,268.0,7.2,171,97,1,2,265,268,0,0,268,268,34,43,191,268,52,0,216,268,28,0,240,268
9201302,1645,203195,base,completed,296.0,7.05,137,159,47,0,249,296,71,0,225,296,5,19,272,296,44,88,164,296,0,0,296,296
9201302,1645,203195,base+,completed,298.0,6.95,177,121,49,26,223,298,80,0,218,298,24,24,250,298,0,1,297,298,75,0,223,298
9201302,1645,203195,dpv1,completed,301.0,7.15,133,168,51,0,250,301,28,68,205,301,0,0,301,301,71,0,230,301,26,79,196,301
9201302,1645,203195,dpv2,completed,305.0,7.25,149,156,75,0,230,305,59,0,246,305,13,73,219,305,45,36,224,305,0,20,285,305
9201302,1645,203195,new-0.0,completed,286.0,7.05,197,89,0,0,286,286,68,0,218,286,31,0,255,286,84,0,202,286,64,5,217,286
9201302,1645,203195,new-0.5,completed,273.0,7.25,203,70,30,5,238,273,51,0,222,273,65,0,208,273,0,0,273,273,41,0,232,273
9201302,1645,203195,new-1.0,completed,265.0,7.25,186,79,15,51,199,265,22,0,243,265,28,6,231,265,0,0,265,265,16,0,249,265
9201302,1645,178029,base,completed,278.0,6.95,133,145,10,0,268,278,16,15,247,278,17,24,237,278,0,0,278,278,42,79,157,278
9201302,1645,178029,base+,completed,304.0,6.75,152,152,63,0,241,304,0,6,298,304,63,0,241,304,12,62,230,304,35,74,195,304
9201302,1645,178029,dpv1,completed,318.0,7.05,126,192,45,0,273,318,92,0,226,318,0,30,288,318,16,85,217,318,47,48,223,318
9201302,1645,178029,dpv2,completed,312.0,7.2,152,160,59,4,249,312,86,0,226,312,12,57,243,312,0,10,302,312,57,56,199,312
9201302,1645,178029,new-0.0,completed,264.0,7.25,197,67,25,6,233,264,40,0,224,264,0,0,264,264,58,0,206,264,41,3,220,264
9201302,1645,178029,new-0.5,completed,281.0,7.4,196,85,36,0,245,281,81,0,200,281,39,6,236,281,64,0,217,281,0,0,281,281
9201302,1645,178029,new-1.0,completed,270.0,7.3,178,92,23,0,247,270,7,0,263,270,17,53,200,270,15,9,246,270,0,7,263,270
9201302,1645,239735,base,completed,303.0,6.75,163,140,85,0,218,303,62,0,241,303,22,14,267,303,0,51,252,303,59,4,240,303
9201302,1645,239735,base+,completed,296.0,6.7,151,145,0,99,197,296,3,15,278,296,43,0,253,296,73,0,223,296,59,14,223,296
9201302,1645,239735,dpv1,completed,301.0,7.05,112,189,0,0,301,301,24,68,209,301,49,25,227,301,68,0,233,301,25,77,199,301
9201302,1645,239735,dpv2,completed,300.0,7.25,151,149,86,9,205,300,57,0,243,300,51,27,222,300,0,0,300,300,28,70,202,300
9201302,1645,239735,new-0.0,completed,282.0,7.05,173,109,47,18,217,282,22,35,225,282,80,0,202,282,0,0,282,282,44,0,238,282
9201302,1645,239735,new-0.5,completed,275.0,7.2,181,94,0,2,273,275,13,27,235,275,44,0,231,275,65,0,210,275,20,33,222,275
9201302,1645,239735,new-1.0,completed,250.0,7.3,178,72,27,37,186,250,23,8,219,250,0,0,250,250,0,0,250,250,6,0,244,250
9201302,1645,675528,base,completed,290.0,6.8,128,162,23,0,267,290,0,106,184,290,56,0,234,290,19,29,242,290,26,0,264,290
9201302,1645,675528,base+,completed,280.0,7.05,203,77,0,0,280,280,59,2,219,280,34,0,246,280,75,0,205,280,61,0,219,280
9201302,1645,675528,dpv1,completed,319.0,6.95,126,193,77,0,242,319,0,0,319,319,51,78,190,319,82,0,237,319,30,73,216,319
9201302,1645,675528,dpv2,completed,307.0,7.3,145,162,0,0,307,307,36,72,199,307,54,0,253,307,90,0,217,307,45,54,208,307
9201302,1645,675528,new-0.0,completed,294.0,6.95,206,88,44,0,250,294,80,0,214,294,88,0,206,294,57,0,237,294,0,0,294,294
9201302,1645,675528,new-0.5,completed,286.0,7.25,206,80,0,4,282,286,69,0,217,286,70,0,216,286,42,3,241,286,42,3,241,286
9201302,1645,675528,new-1.0,completed,256.0,7.3,165,91,4,53,199,256,17,21,218,256,2,0,254,256,0,0,256,256,0,1,255,256
9201302,1645,380692,base,completed,323.0,6.85,154,169,0,0,323,323,39,0,284,323,69,100,154,323,59,56,208,323,39,61,223,323
9201302,1645,380692,base+,completed,272.0,6.9,183,89,61,0,211,272,57,0,215,272,23,0,249,272,0,0,272,272,14,32,226,272
9201302,1645,380692,dpv1,completed,315.0,7.1,146,169,64,0,251,315,38,66,211,315,0,8,307,315,80,0,235,315,33,67,215,315
9201302,1645,380692,dpv2,completed,280.0,7.25,133,147,30,0,250,280,5,28,247,280,22,24,234,280,53,0,227,280,0,55,225,280
9201302,1645,380692,new-0.0,completed,273.0,7.0,206,67,0,0,273,273,58,0,215,273,34,0,239,273,34,2,237,273,65,0,208,273
9201302,1645,380692,new-0.5,completed,277.0,7.3,201,76,0,0,277,277,52,0,225,277,31,0,246,277,35,6,236,277,70,0,207,277
9201302,1645,380692,new-1.0,completed,265.0,7.3,176,89,21,58,186,265,26,9,230,265,11,0,254,265,0,0,265,265,18,0,247,265
4405979,1638,310811,base,completed,269.0,7.1,162,107,43,0,226,269,9,68,192,269,9,0,260,269,0,0,269,269,39,0,230,269
4405979,1638,310811,base+,completed,267.0,7.5,213,54,35,0,232,267,54,0,213,267,46,0,221,267,28,0,239,267,0,0,267,267
4405979,1638,310811,dpv1,completed,308.0,7.3,217,91,91,0,217,308,80,0,228,308,68,0,240,308,0,0,308,308,91,0,217,308
4405979,1638,310811,dpv2,completed,276.0,7.75,202,74,0,0,276,276,53,0,223,276,20,0,256,276,42,0,234,276,40,21,215,276
4405979,1638,310811,new-0.0,completed,255.0,7.3,211,44,44,0,211,255,18,0,237,255,0,0,255,255,24,0,231,255,28,0,227,255
4405979,1638,310811,new-0.5,completed,287.0,7.95,204,83,65,0,222,287,83,0,204,287,0,0,287,287,62,0,225,287,48,0,239,287
4405979,1638,310811,new-1.0,completed,282.0,8.1,201,81,0,0,282,282,34,0,248,282,20,0,262,282,81,0,201,282,76,0,206,282
4405979,1638,208428,base,completed,259.0,7.4,227,32,29,0,230,259,32,0,227,259,13,0,246,259,24,0,235,259,0,0,259,259
4405979,1638,208428,base+,completed,288.0,7.2,225,63,50,0,238,288,43,0,245,288,0,0,288,288,40,0,248,288,63,0,225,288
4405979,1638,208428,dpv1,completed,291.0,7.4,158,133,39,45,207,291,61,0,230,291,57,0,234,291,0,27,264,291,22,0,269,291
4405979,1638,208428,dpv2,completed,271.0,7.7,217,54,54,0,217,271,45,0,226,271,0,0,271,271,23,0,248,271,29,0,242,271
4405979,1638,208428,new-0.0,completed,263.0,7.3,201,62,51,0,212,263,52,0,211,263,62,0,201,263,0,0,263,263,14,0,249,263
4405979,1638,208428,new-0.5,completed,266.0,8.0,217,49,19,0,247,266,0,0,266,266,49,0,217,266,40,0,226,266,25,0,241,266
4405979,1638,208428,new-1.0,completed,279.0,8.05,201,78,0,1,278,279,27,0,252,279,30,0,249,279,56,3,220,279,74,0,205,279
4405979,1638,460300,base,completed,276.0,7.3,226,50,35,0,241,276,0,0,276,276,46,0,230,276,40,0,236,276,50,0,226,276
4405979,1638,460300,base+,completed,294.0,7.2,223,71,0,0,294,294,71,0,223,294,40,0,254,294,67,0,227,294,66,0,228,294
4405979,1638,460300,dpv1,completed,300.0,7.4,157,143,64,0,236,300,34,35,231,300,0,0,300,300,73,44,183,300,36,0,264,300
4405979,1638,460300,dpv2,completed,269.0,7.5,215,54,47,0,222,269,54,0,215,269,0,0,269,269,20,0,249,269,29,0,240,269
4405979,1638,460300,new-0.0,completed,279.0,7.4,208,71,54,0,225,279,66,0,213,279,0,0,279,279,71,0,208,279,29,0,250,279
4405979,1638,460300,new-0.5,completed,263.0,7.9,217,46,0,0,263,263,46,0,217,263,25,0,238,263,40,0,223,263,13,0,250,263
4405979,1638,460300,new-1.0,completed,288.0,8.05,203,85,0,0,288,288,50,0,238,288,76,1,211,288,18,0,270,288,84,0,204,288
4405979,1638,309704,base,completed,296.0,7.1,196,100,52,0,244,296,0,2,294,296,74,0,222,296,61,24,211,296,62,0,234,296
4405979,1638,309704,base+,completed,293.0,7.45,205,88,60,0,233,293,0,0,293,293,59,8,226,293,80,0,213,293,59,0,234,293
4405979,1638,309704,dpv1,completed,275.0,7.45,210,65,61,0,214,275,17,0,258,275,0,0,275,275,65,0,210,275,32,0,243,275
4405979,1638,309704,dpv2,completed,274.0,7.75,203,71,0,0,274,274,56,0,218,274,22,3,249,274,35,0,239,274,41,15,218,274
4405979,1638,309704,new-0.0,completed,273.0,7.3,204,69,67,0,206,273,53,0,220,273,69,0,204,273,0,0,273,273,36,0,237,273
4405979,1638,309704,new-0.5,completed,287.0,7.95,214,73,37,0,250,287,73,0,214,287,0,0,287,287,59,0,228,287,70,0,217,287
4405979,1638,309704,new-1.0,completed,276.0,8.05,202,74,5,0,271,276,30,0,246,276,64,10,202,276,62,0,214,276,0,0,276,276
4405979,1638,247588,base,completed,296.0,7.6,215,81,53,0,243,296,80,0,216,296,71,0,225,296,0,0,296,296,81,0,215,296
4405979,1638,247588,base+,completed,274.0,7.45,174,100,52,0,222,274,44,7,223,274,0,0,274,274,17,53,204,274,12,0,262,274
4405979,1638,247588,dpv1,completed,298.0,7.5,142,156,70,0,228,298,42,24,232,298,0,0,298,298,71,62,165,298,47,0,251,298
4405979,1638,247588,dpv2,completed,275.0,7.75,190,85,0,46,229,275,85,0,190,275,56,0,219,275,15,0,260,275,30,0,245,275
4405979,1638,247588,new-0.0,completed,261.0,7.5,200,61,57,0,204,261,47,0,214,261,0,0,261,261,61,0,200,261,9,0,252,261
4405979,1638,247588,new-0.5,completed,252.0,7.95,210,42,0,0,252,252,42,0,210,252,9,0,243,252,15,0,237,252,35,0,217,252
4405979,1638,247588,new-1.0,completed,270.0,8.05,189,81,0,1,269,270,12,0,258,270,21,0,249,270,45,10,215,270,70,0,200,270
4405979,1638,203195,base,completed,268.0,7.3,158,110,0,41,227,268,39,0,229,268,6,0,262,268,15,13,240,268,15,47,206,268
4405979,1638,203195,base+,completed,297.0,7.75,217,80,0,0,297,297,75,0,222,297,70,0,227,297,66,5,226,297,58,0,239,297
4405979,1638,203195,dpv1,completed,291.0,7.5,219,72,69,3,219,291,63,0,228,291,0,0,291,291,51,0,240,291,49,0,242,291
4405979,1638,203195,dpv2,completed,283.0,7.65,203,80,0,0,283,283,59,0,224,283,80,0,203,283,63,0,220,283,24,0,259,283
4405979,1638,203195,new-0.0,completed,247.0,7.2,201,46,12,0,235,247,45,0,202,247,15,0,232,247,0,0,247,247,9,1,237,247
4405979,1638,203195,new-0.5,completed,276.0,7.95,205,71,0,0,276,276,70,0,206,276,44,1,231,276,32,0,244,276,44,0,232,276
4405979,1638,203195,new-1.0,completed,266.0,8.05,210,56,1,0,265,266,21,0,245,266,55,1,210,266,0,0,266,266,44,0,222,266
4405979,1638,178029,base,completed,262.0,7.25,192,70,9,0,253,262,13,4,245,262,0,40,222,262,30,0,232,262,28,0,234,262
4405979,1638,178029,base+,completed,274.0,7.55,224,50,50,0,224,274,22,0,252,274,47,0,227,274,50,0,224,274,0,0,274,274
4405979,1638,178029,dpv1,completed,294.0,7.2,148,146,12,0,282,294,71,0,223,294,61,0,233,294,0,0,294,294,38,85,171,294
4405979,1638,178029,dpv2,completed,273.0,7.5,213,60,16,0,257,273,58,0,215,273,60,0,213,273,53,0,220,273,0,0,273,273
4405979,1638,178029,new-0.0,completed,270.0,7.3,205,65,50,0,220,270,63,2,205,270,53,0,217,270,0,0,270,270,4,0,266,270
4405979,1638,178029,new-0.5,completed,271.0,8.0,216,55,0,0,271,271,52,0,219,271,21,0,250,271,33,3,235,271,35,0,236,271
4405979,1638,178029,new-1.0,completed,282.0,8.1,206,76,0,0,282,282,36,0,246,282,23,0,259,282,76,0,206,282,48,0,234,282
4405979,1638,239735,base,completed,250.0,7.4,221,29,0,0,250,250,5,0,245,250,2,0,248,250,12,0,238,250,29,0,221,250
4405979,1638,239735,base+,completed,263.0,7.15,222,41,35,0,228,263,41,0,222,263,36,0,227,263,0,0,263,263,39,0,224,263
4405979,1638,239735,dpv1,completed,263.0,7.75,154,109,27,0,236,263,0,21,242,263,9,5,249,263,17,61,185,263,6,0,257,263
4405979,1638,239735,dpv2,completed,271.0,7.5,214,57,55,0,216,271,33,0,238,271,0,0,271,271,20,0,251,271,57,0,214,271
4405979,1638,239735,new-0.0,completed,263.0,7.35,201,62,61,0,202,263,62,0,201,263,0,0,263,263,48,0,215,263,15,0,248,263
4405979,1638,239735,new-0.5,completed,270.0,7.95,215,55,0,0,270,270,54,0,216,270,9,0,261,270,55,0,215,270,36,0,234,270
4405979,1638,239735,new-1.0,completed,282.0,8.1,198,84,0,0,282,282,41,0,241,282,19,3,260,282,58,0,224,282,81,0,201,282
4405979,1638,675528,base,completed,276.0,7.15,210,66,27,0,249,276,49,0,227,276,63,0,213,276,66,0,210,276,0,0,276,276
4405979,1638,675528,base+,completed,272.0,7.4,209,63,0,0,272,272,63,0,209,272,37,0,235,272,25,0,247,272,32,0,240,272
4405979,1638,675528,dpv1,completed,301.0,7.35,150,151,72,0,229,301,45,27,229,301,25,0,276,301,0,52,249,301,70,0,231,301
4405979,1638,675528,dpv2,completed,270.0,7.65,217,53,0,0,270,270,53,0,217,270,34,0,236,270,44,0,226,270,0,0,270,270
4405979,1638,675528,new-0.0,completed,250.0,7.35,198,52,8,0,242,250,0,0,250,250,25,1,224,250,51,0,199,250,6,0,244,250
4405979,1638,675528,new-0.5,completed,273.0,7.95,214,59,0,0,273,273,59,0,214,273,37,0,236,273,33,0,240,273,44,0,229,273
4405979,1638,675528,new-1.0,completed,274.0,8.05,197,77,0,2,272,274,29,0,245,274,72,0,202,274,50,3,221,274,13,0,261,274
4405979,1638,380692,base,completed,269.0,7.55,196,73,0,0,269,269,48,0,221,269,49,0,220,269,46,0,223,269,73,0,196,269
4405979,1638,380692,base+,completed,267.0,7.35,209,58,57,0,210,267,31,0,236,267,10,0,257,267,58,0,209,267,0,0,267,267
4405979,1638,380692,dpv1,completed,288.0,7.3,137,151,60,0,228,288,33,0,255,288,59,70,159,288,0,0,288,288,32,21,235,288
4405979,1638,380692,dpv2,completed,265.0,7.7,217,48,0,0,265,265,44,0,221,265,10,0,255,265,48,0,217,265,9,0,256,265
4405979,1638,380692,new-0.0,completed,263.0,7.4,210,53,43,0,220,263,31,0,232,263,0,0,263,263,52,0,211,263,25,1,237,263
4405979,1638,380692,new-0.5,completed,269.0,8.05,224,45,0,0,269,269,11,0,258,269,45,0,224,269,39,0,230,269,31,0,238,269
4405979,1638,380692,new-1.0,completed,280.0,8.05,209,71,0,0,280,280,39,0,241,280,71,0,209,280,67,0,213,280,18,0,262,280
7148489,1700,310811,base,completed,284.0,7.0,157,127,31,0,253,284,18,0,266,284,0,21,263,284,13,0,271,284,27,81,176,284
7148489,1700,310811,base+,completed,304.0,7.0,137,167,17,0,287,304,39,66,199,304,57,0,247,304,0,91,213,304,19,0,285,304
7148489,1700,310811,dpv1,completed,274.0,7.1,214,60,58,0,216,274,29,0,245,274,0,17,257,274,33,0,241,274,19,0,255,274
7148489,1700,310811,dpv2,completed,333.0,7.3,94,239,0,167,166,333,51,0,282,333,18,81,234,333,44,0,289,333,19,95,219,333
7148489,1700,310811,new-0.0,completed,275.0,7.05,205,70,63,0,212,275,70,0,205,275,31,0,244,275,69,0,206,275,0,0,275,275
7148489,1700,310811,new-0.5,completed,289.0,7.5,216,73,73,0,216,289,0,0,289,289,34,0,255,289,56,0,233,289,66,0,223,289
7148489,1700,310811,new-1.0,completed,283.0,7.55,169,114,44,0,239,283,47,0,236,283,4,0,279,283,0,5,278,283,32,62,189,283
7148489,1700,208428,base,completed,297.0,7.1,166,131,44,0,253,297,7,0,290,297,25,70,202,297,0,13,284,297,24,43,230,297
7148489,1700,208428,base+,completed,341.0,7.1,141,200,0,159,182,341,74,0,267,341,89,0,252,341,29,0,312,341,79,0,262,341
7148489,1700,208428,dpv1,completed,295.0,7.15,211,84,78,0,217,295,45,0,250,295,46,6,243,295,30,0,265,295,0,28,267,295
7148489,1700,208428,dpv2,completed,322.0,7.3,97,225,0,158,164,322,18,0,304,322,49,0,273,322,39,0,283,322,72,66,184,322
7148489,1700,208428,new-0.0,completed,279.0,7.05,211,68,46,0,233,279,63,2,214,279,30,0,249,279,66,0,213,279,0,0,279,279
7148489,1700,208428,new-0.5,completed,283.0,7.55,209,74,49,0,234,283,69,0,214,283,22,5,256,283,0,0,283,283,68,0,215,283
7148489,1700,208428,new-1.0,completed,281.0,7.5,167,114,29,0,252,281,67,0,214,281,3,0,278,281,0,0,281,281,51,47,183,281
7148489,1700,460300,base,completed,286.0,6.9,180,106,25,0,261,286,31,17,238,286,55,0,231,286,0,3,283,286,29,45,212,286
7148489,1700,460300,base+,completed,294.0,6.9,165,129,47,0,247,294,20,15,259,294,27,48,219,294,0,19,275,294,81,0,213,294
7148489,1700,460300,dpv1,completed,289.0,7.1,206,83,79,0,210,289,31,0,258,289,33,4,252,289,0,29,260,289,22,0,267,289
7148489,1700,460300,dpv2,completed,329.0,7.3,106,223,0,162,167,329,51,0,278,329,23,0,306,329,53,0,276,329,64,69,196,329
7148489,1700,460300,new-0.0,completed,278.0,7.1,206,72,14,0,264,278,68,2,208,278,57,0,221,278,0,0,278,278,70,0,208,278
7148489,1700,460300,new-0.5,completed,288.0,7.45,208,80,44,0,244,288,80,0,208,288,30,0,258,288,68,0,220,288,0,3,285,288
7148489,1700,460300,new-1.0,completed,287.0,7.45,176,111,42,0,245,287,2,0,285,287,67,0,220,287,0,0,287,287,57,44,186,287
7148489,1700,309704,base,completed,299.0,6.85,191,108,49,0,250,299,0,0,299,299,44,40,215,299,35,0,264,299,68,0,231,299
7148489,1700,309704,base+,completed,295.0,7.1,175,120,45,0,250,295,0,0,295,295,44,4,247,295,55,60,180,295,60,0,235,295
7148489,1700,309704,dpv1,completed,296.0,7.15,212,84,65,0,231,296,74,0,222,296,0,38,258,296,30,0,266,296,59,0,237,296
7148489,1700,309704,dpv2,completed,317.0,7.3,102,215,0,143,174,317,7,0,310,317,24,36,257,317,31,0,286,317,49,81,187,317
7148489,1700,309704,new-0.0,completed,280.0,7.0,199,81,19,0,261,280,59,0,221,280,55,0,225,280,81,0,199,280,0,0,280,280
7148489,1700,309704,new-0.5,completed,289.0,7.5,220,69,67,0,222,289,0,0,289,289,43,0,246,289,69,0,220,289,67,0,222,289
7148489,1700,309704,new-1.0,completed,292.0,7.45,184,108,76,23,193,292,60,0,232,292,5,0,287,292,0,9,283,292,52,0,240,292
7148489,1700,247588,base,completed,308.0,6.95,145,163,44,102,162,308,4,30,274,308,46,0,262,308,0,0,308,308,22,44,242,308
7148489,1700,247588,base+,completed,314.0,6.9,141,173,0,115,199,314,69,0,245,314,34,81,199,314,21,0,293,314,28,0,286,314
7148489,1700,247588,dpv1,completed,279.0,7.15,218,61,52,0,227,279,56,0,223,279,29,0,250,279,26,8,245,279,0,11,268,279
7148489,1700,247588,dpv2,completed,309.0,7.35,96,213,0,144,165,309,7,0,302,309,43,0,266,309,19,9,281,309,61,67,181,309
7148489,1700,247588,new-0.0,completed,255.0,6.9,201,54,35,0,220,255,34,0,221,255,0,0,255,255,54,0,201,255,29,0,226,255
7148489,1700,247588,new-0.5,completed,286.0,7.5,212,74,58,0,228,286,0,0,286,286,42,0,244,286,39,0,247,286,74,0,212,286
7148489,1700,247588,new-1.0,completed,276.0,7.5,171,105,23,0,253,276,2,0,274,276,59,0,217,276,0,0,276,276,47,46,183,276
7148489,1700,203195,base,completed,267.0,7.05,205,62,0,0,267,267,8,0,259,267,23,14,230,267,25,0,242,267,48,0,219,267
7148489,1700,203195,base+,completed,287.0,7.25,189,98,0,15,272,287,16,0,271,287,82,0,205,287,37,0,250,287,46,16,225,287
7148489,1700,203195,dpv1,completed,280.0,7.2,216,64,64,0,216,280,27,0,253,280,19,0,261,280,0,18,262,280,57,0,223,280
7148489,1700,203195,dpv2,completed,327.0,7.4,139,188,0,0,327,327,37,106,184,327,51,28,248,327,38,3,286,327,62,88,177,327
7148489,1700,203195,new-0.0,completed,269.0,7.15,208,61,0,0,269,269,55,1,213,269,33,0,236,269,58,0,211,269,7,2,260,269
7148489,1700,203195,new-0.5,completed,264.0,7.45,204,60,1,0,263,264,31,0,233,264,0,0,264,264,37,0,227,264,60,0,204,264
7148489,1700,203195,new-1.0,completed,291.0,7.45,164,127,68,0,223,291,42,0,249,291,0,0,291,291,3,0,288,291,46,59,186,291
7148489,1700,178029,base,completed,280.0,7.0,172,108,16,58,206,280,50,0,230,280,16,5,259,280,5,42,233,280,0,3,277,280
7148489,1700,178029,base+,completed,333.0,7.2,127,206,23,1,309,333,42,87,204,333,0,43,290,333,78,0,255,333,29,112,192,333
7148489,1700,178029,dpv1,completed,299.0,7.15,211,88,55,0,244,299,71,0,228,299,0,38,261,299,31,0,268,299,88,0,211,299
7148489,1700,178029,dpv2,completed,315.0,7.35,103,212,0,146,169,315,59,0,256,315,45,0,270,315,15,2,298,315,23,68,224,315
7148489,1700,178029,new-0.0,completed,269.0,6.9,221,48,46,0,223,269,0,2,267,269,24,0,245,269,48,0,221,269,24,0,245,269
7148489,1700,178029,new-0.5,completed,282.0,7.55,215,67,41,0,241,282,60,0,222,282,26,0,256,282,0,0,282,282,67,0,215,282
7148489,1700,178029,new-1.0,completed,292.0,7.5,182,110,43,0,249,292,73,0,219,292,24,0,268,292,0,0,292,292,61,37,194,292
7148489,1700,239735,base,completed,288.0,7.05,187,101,59,0,229,288,0,63,225,288,23,0,265,288,56,0,232,288,38,0,250,288
7148489,1700,239735,base+,completed,286.0,6.95,201,85,85,0,201,286,32,0,254,286,29,25,232,286,31,0,255,286,0,15,271,286
7148489,1700,239735,dpv1,completed,264.0,7.0,194,70,49,0,215,264,17,0,247,264,21,1,242,264,0,3,261,264,20,21,223,264
7148489,1700,239735,dpv2,completed,312.0,7.35,100,212,0,139,173,312,47,62,203,312,15,0,297,312,36,0,276,312,36,66,210,312
7148489,1700,239735,new-0.0,completed,261.0,7.0,196,65,0,0,261,261,54,0,207,261,45,3,213,261,0,0,261,261,62,0,199,261
7148489,1700,239735,new-0.5,completed,266.0,7.45,203,63,10,0,256,266,51,0,215,266,0,0,266,266,58,0,208,266,63,0,203,266
7148489,1700,239735,new-1.0,completed,285.0,7.45,162,123,56,0,229,285,68,0,217,285,14,0,271,285,0,2,283,285,34,53,198,285
7148489,1700,675528,base,completed,292.0,6.85,159,133,55,66,171,292,0,0,292,292,12,0,280,292,51,0,241,292,26,65,201,292
7148489,1700,675528,base+,completed,317.0,7.2,191,126,53,0,264,317,0,87,230,317,82,0,235,317,26,0,291,317,87,0,230,317
7148489,1700,675528,dpv1,completed,278.0,7.15,200,78,66,0,212,278,27,29,222,278,21,1,256,278,0,16,262,278,30,0,248,278
7148489,1700,675528,dpv2,completed,331.0,7.3,92,239,0,172,159,331,44,0,287,331,18,0,313,331,50,2,279,331,75,82,174,331
7148489,1700,675528,new-0.0,completed,275.0,6.9,203,72,16,0,259,275,46,0,229,275,0,0,275,275,36,0,239,275,72,0,203,275
7148489,1700,675528,new-0.5,completed,275.0,7.5,216,59,0,5,270,275,59,0,216,275,19,0,256,275,46,0,229,275,34,0,241,275
7148489,1700,675528,new-1.0,completed,273.0,7.55,174,99,39,0,234,273,46,42,185,273,0,19,254,273,14,0,259,273,14,0,259,273
7148489,1700,380692,base,completed,267.0,6.95,209,58,27,0,240,267,47,0,220,267,18,10,239,267,0,10,257,267,23,0,244,267
7148489,1700,380692,base+,completed,341.0,7.2,114,227,0,170,171,341,72,0,269,341,79,81,181,341,17,0,324,341,77,0,264,341
7148489,1700,380692,dpv1,completed,278.0,7.15,207,71,69,0,209,278,20,0,258,278,27,2,249,278,27,0,251,278,0,16,262,278
7148489,1700,380692,dpv2,completed,314.0,7.4,146,168,0,0,314,314,33,113,168,314,41,33,240,314,27,0,287,314,35,96,183,314
7148489,1700,380692,new-0.0,completed,274.0,6.9,202,72,47,0,227,274,37,0,237,274,0,3,271,274,72,0,202,274,33,0,241,274
7148489,1700,380692,new-0.5,completed,285.0,7.5,206,79,44,0,241,285,63,0,222,285,0,13,272,285,79,0,206,285,32,0,253,285
7148489,1700,380692,new-1.0,completed,285.0,7.45,165,120,22,0,263,285,20,0,265,285,0,0,285,285,76,0,209,285,41,44,200,285
4819551,1802,310811,base,completed,303.0,7.15,187,116,46,0,257,303,0,0,303,303,27,10,266,303,8,70,225,303,32,33,238,303
4819551,1802,310811,base+,completed,325.0,7.0,214,111,104,5,216,325,61,2,262,325,79,12,234,325,84,0,241,325,0,0,325,325
4819551,1802,310811,dpv1,completed,299.0,7.25,192,107,53,11,235,299,59,20,220,299,60,0,239,299,0,0,299,299,18,16,265,299
4819551,1802,310811,dpv2,completed,309.0,7.45,198,111,62,3,244,309,46,0,263,309,0,7,302,309,42,44,223,309,64,0,245,309
4819551,1802,310811,new-0.0,completed,298.0,7.45,225,73,63,0,235,298,57,0,241,298,73,0,225,298,0,0,298,298,49,0,249,298
4819551,1802,310811,new-0.5,completed,280.0,7.7,211,69,31,0,249,280,4,0,276,280,69,0,211,280,25,1,254,280,0,0,280,280
4819551,1802,310811,new-1.0,completed,320.0,8.05,148,172,20,57,243,320,0,45,275,320,35,20,265,320,60,0,260,320,33,59,228,320
4819551,1802,208428,base,completed,312.0,7.4,177,135,37,19,256,312,25,51,236,312,0,0,312,312,43,4,265,312,27,24,261,312
4819551,1802,208428,base+,completed,286.0,7.1,186,100,19,0,267,286,67,33,186,286,0,0,286,286,34,0,252,286,26,0,260,286
4819551,1802,208428,dpv1,completed,325.0,7.45,174,151,63,0,262,325,32,58,235,325,75,0,250,325,0,16,309,325,56,20,249,325
4819551,1802,208428,dpv2,completed,337.0,7.6,165,172,89,0,248,337,61,54,222,337,0,0,337,337,76,0,261,337,73,43,221,337
4819551,1802,208428,new-0.0,completed,279.0,7.3,225,54,31,0,248,279,0,0,279,279,17,0,262,279,54,0,225,279,36,0,243,279
4819551,1802,208428,new-0.5,completed,277.0,7.6,212,65,39,0,238,277,65,0,212,277,0,0,277,277,33,1,243,277,0,0,277,277
4819551,1802,208428,new-1.0,completed,299.0,8.0,199,100,28,3,268,299,51,36,212,299,27,2,270,299,61,0,238,299,0,17,282,299
4819551,1802,460300,base,completed,323.0,6.9,120,203,0,73,250,323,42,151,130,323,1,0,322,323,27,5,291,323,18,0,305,323
4819551,1802,460300,base+,completed,295.0,7.2,210,85,43,0,252,295,34,7,254,295,0,11,284,295,14,0,281,295,74,0,221,295
4819551,1802,460300,dpv1,completed,314.0,7.4,174,140,61,0,253,314,34,50,230,314,76,5,233,314,0,0,314,314,54,13,247,314
4819551,1802,460300,dpv2,completed,287.0,7.45,230,57,32,2,253,287,13,0,274,287,38,1,248,287,0,0,287,287,56,0,231,287
4819551,1802,460300,new-0.0,completed,288.0,7.5,230,58,29,0,259,288,54,0,234,288,58,0,230,288,0,0,288,288,52,0,236,288
4819551,1802,460300,new-0.5,completed,312.0,7.75,204,108,54,8,250,312,28,6,278,312,94,0,218,312,0,0,312,312,82,0,230,312
4819551,1802,460300,new-1.0,completed,294.0,7.85,183,111,39,0,255,294,30,58,206,294,53,1,240,294,0,0,294,294,5,4,285,294
4819551,1802,309704,base,completed,320.0,7.55,200,120,0,0,320,320,48,13,259,320,90,0,230,320,74,0,246,320,71,33,216,320
4819551,1802,309704,base+,completed,309.0,7.05,140,169,33,0,276,309,56,56,197,309,18,40,251,309,28,20,261,309,0,19,290,309
4819551,1802,309704,dpv1,completed,312.0,7.3,177,135,53,0,259,312,29,57,226,312,76,6,230,312,48,17,247,312,0,0,312,312
4819551,1802,309704,dpv2,completed,298.0,7.65,200,98,41,0,257,298,21,8,269,298,50,3,245,298,0,0,298,298,70,17,211,298
4819551,1802,309704,new-0.0,completed,278.0,7.6,222,56,37,0,241,278,38,0,240,278,50,0,228,278,0,0,278,278,14,6,258,278
4819551,1802,309704,new-0.5,completed,302.0,7.8,207,95,85,10,207,302,29,0,273,302,76,0,226,302,0,0,302,302,50,0,252,302
4819551,1802,309704,new-1.0,completed,289.0,7.9,191,98,6,0,283,289,20,23,246,289,4,23,262,289,0,28,261,289,31,31,227,289
4819551,1802,247588,base,completed,303.0,6.85,187,116,72,0,231,303,34,0,269,303,17,44,242,303,28,4,271,303,0,0,303,303
4819551,1802,247588,base+,completed,309.0,7.05,139,170,0,35,274,309,11,34,264,309,59,26,224,309,4,0,305,309,20,50,239,309
4819551,1802,247588,dpv1,completed,308.0,7.45,147,161,41,0,267,308,0,73,235,308,53,5,250,308,18,29,261,308,38,21,249,308
4819551,1802,247588,dpv2,completed,302.0,7.45,196,106,46,0,256,302,0,0,302,302,42,6,254,302,20,47,235,302,59,0,243,302
4819551,1802,247588,new-0.0,completed,256.0,7.55,235,21,17,0,239,256,6,0,250,256,8,0,248,256,0,0,256,256,21,0,235,256
4819551,1802,247588,new-0.5,completed,296.0,7.9,200,96,41,0,255,296,0,0,296,296,75,1,220,296,26,0,270,296,79,16,201,296
4819551,1802,247588,new-1.0,completed,315.0,8.15,176,139,48,18,249,315,0,53,262,315,43,5,267,315,58,0,257,315,68,26,221,315
4819551,1802,203195,base,completed,306.0,7.2,220,86,86,0,220,306,46,0,260,306,39,0,267,306,0,0,306,306,50,0,256,306
4819551,1802,203195,base+,completed,317.0,6.9,192,125,0,0,317,317,54,22,241,317,33,40,244,317,62,0,255,317,49,9,259,317
4819551,1802,203195,dpv1,completed,313.0,7.35,207,106,71,0,242,313,52,19,242,313,0,0,313,313,70,0,243,313,65,16,232,313
4819551,1802,203195,dpv2,completed,294.0,7.5,214,80,3,0,291,294,75,5,214,294,0,0,294,294,37,0,257,294,32,32,230,294
4819551,1802,203195,new-0.0,completed,275.0,7.65,210,65,25,0,250,275,0,0,275,275,31,0,244,275,17,0,258,275,65,0,210,275
4819551,1802,203195,new-0.5,completed,300.0,7.7,205,95,44,8,248,300,18,0,282,300,85,0,215,300,0,0,300,300,87,0,213,300
4819551,1802,203195,new-1.0,completed,322.0,7.85,171,151,72,6,244,322,40,68,214,322,43,12,267,322,77,0,245,322,0,5,317,322
4819551,1802,178029,base,completed,348.0,6.95,162,186,67,81,200,348,96,0,252,348,92,9,247,348,105,0,243,348,0,0,348,348
4819551,1802,178029,base+,completed,305.0,6.9,188,117,11,0,294,305,0,0,305,305,76,25,204,305,47,24,234,305,53,0,252,305
4819551,1802,178029,dpv1,completed,317.0,7.25,207,110,62,9,246,317,83,23,211,317,69,0,248,317,0,0,317,317,32,4,281,317
4819551,1802,178029,dpv2,completed,317.0,7.6,183,134,52,15,250,317,0,0,317,317,65,0,252,317,32,53,232,317,48,29,240,317
4819551,1802,178029,new-0.0,completed,256.0,7.55,238,18,8,0,248,256,11,0,245,256,0,0,256,256,7,0,249,256,18,0,238,256
4819551,1802,178029,new-0.5,completed,305.0,7.85,212,93,54,6,245,305,18,0,287,305,76,0,229,305,0,0,305,305,76,11,218,305
4819551,1802,178029,new-1.0,completed,308.0,8.15,179,129,57,0,251,308,0,48,260,308,1,14,293,308,52,0,256,308,33,47,228,308
4819551,1802,239735,base,completed,277.0,7.0,222,55,24,0,253,277,0,0,277,277,3,0,274,277,55,0,222,277,32,0,245,277
4819551,1802,239735,base+,completed,302.0,7.1,193,109,48,6,248,302,43,53,206,302,28,34,240,302,0,0,302,302,33,0,269,302
4819551,1802,239735,dpv1,completed,301.0,7.4,193,108,67,0,234,301,79,0,222,301,34,29,238,301,54,0,247,301,0,0,301,301
4819551,1802,239735,dpv2,completed,289.0,7.45,189,100,45,0,244,289,36,3,250,289,0,13,276,289,19,34,236,289,66,0,223,289
4819551,1802,239735,new-0.0,completed,273.0,7.4,215,58,37,15,221,273,0,0,273,273,25,0,248,273,43,0,230,273,34,0,239,273
4819551,1802,239735,new-0.5,completed,307.0,7.8,192,115,45,5,257,307,36,7,264,307,99,0,208,307,0,4,303,307,94,0,213,307
4819551,1802,239735,new-1.0,completed,324.0,7.9,133,191,73,0,251,324,59,45,220,324,46,0,278,324,0,43,281,324,54,59,211,324
4819551,1802,675528,base,completed,301.0,7.0,188,113,0,0,301,301,71,42,188,301,41,0,260,301,1,0,300,301,37,22,242,301
4819551,1802,675528,base+,completed,296.0,7.0,220,76,59,0,237,296,22,0,274,296,63,0,233,296,30,13,253,296,0,0,296,296
4819551,1802,675528,dpv1,completed,306.0,7.4,195,111,67,0,239,306,40,11,255,306,51,0,255,306,45,36,225,306,0,13,293,306
4819551,1802,675528,dpv2,completed,296.0,7.45,229,67,39,0,257,296,0,0,296,296,15,0,281,296,63,0,233,296,34,28,234,296
4819551,1802,675528,new-0.0,completed,278.0,7.5,234,44,37,0,241,278,44,0,234,278,19,0,259,278,0,0,278,278,34,0,244,278
4819551,1802,675528,new-0.5,completed,304.0,7.85,227,77,46,0,258,304,52,0,252,304,0,3,301,304,58,0,246,304,72,2,230,304
4819551,1802,675528,new-1.0,completed,299.0,8.0,199,100,50,1,248,299,31,48,220,299,0,0,299,299,51,0,248,299,11,0,288,299
4819551,1802,380692,base,completed,397.0,7.2,116,281,43,162,192,397,26,198,173,397,13,176,208,397,0,0,397,397,51,41,305,397
4819551,1802,380692,base+,completed,296.0,6.9,219,77,36,21,239,296,42,0,254,296,73,4,219,296,22,0,274,296,0,0,296,296
4819551,1802,380692,dpv1,completed,320.0,7.3,176,144,71,18,231,320,49,38,233,320,0,0,320,320,74,7,239,320,68,7,245,320
4819551,1802,380692,dpv2,completed,316.0,7.45,216,100,44,0,272,316,100,0,216,316,73,0,243,316,0,0,316,316,66,18,232,316
4819551,1802,380692,new-0.0,completed,296.0,7.45,234,62,62,0,234,296,56,0,240,296,60,0,236,296,0,0,296,296,50,0,246,296
4819551,1802,380692,new-0.5,completed,301.0,7.7,191,110,82,20,199,301,90,0,211,301,23,0,278,301,0,0,301,301,53,0,248,301
4819551,1802,380692,new-1.0,completed,300.0,8.0,174,126,47,18,235,300,38,61,201,300,0,12,288,300,34,0,266,300,7,3,290,300
8685039,1589,310811,base,completed,293.0,7.2,135,158,71,0,222,293,33,80,180,293,25,96,172,293,17,0,276,293,0,0,293,293
8685039,1589,310811,base+,completed,267.0,7.25,162,105,60,0,207,267,35,4,228,267,0,2,265,267,19,42,206,267,61,0,206,267
8685039,1589,310811,dpv1,completed,353.0,7.2,96,257,96,36,221,353,76,43,234,353,77,0,276,353,0,114,239,353,96,72,185,353
8685039,1589,310811,dpv2,completed,310.0,7.4,102,208,83,0,227,310,88,23,199,310,0,0,310,310,78,97,135,310,51,0,259,310
8685039,1589,310811,new-0.0,completed,263.0,7.0,162,101,43,6,214,263,23,0,240,263,45,40,178,263,1,0,262,263,0,10,253,263
8685039,1589,310811,new-0.5,completed,255.0,7.5,199,56,38,0,217,255,15,0,240,255,56,0,199,255,52,0,203,255,0,0,255,255
8685039,1589,310811,new-1.0,completed,285.0,7.65,130,155,69,63,153,285,58,0,227,285,31,0,254,285,64,28,193,285,0,0,285,285
8685039,1589,208428,base,completed,261.0,6.95,167,94,41,2,218,261,29,0,232,261,6,16,239,261,29,51,181,261,0,0,261,261
8685039,1589,208428,base+,completed,289.0,6.9,96,193,23,0,266,289,35,27,227,289,0,15,274,289,10,101,178,289,24,65,200,289
8685039,1589,208428,dpv1,completed,346.0,7.1,88,258,88,31,227,346,89,0,257,346,79,49,218,346,0,123,223,346,79,66,201,346
8685039,1589,208428,dpv2,completed,321.0,7.2,88,233,3,158,160,321,14,207,100,321,0,58,263,321,32,0,289,321,4,0,317,321
8685039,1589,208428,new-0.0,completed,266.0,7.05,148,118,42,17,207,266,0,0,266,266,34,0,232,266,17,29,220,266,39,39,188,266
8685039,1589,208428,new-0.5,completed,255.0,7.5,178,77,21,0,234,255,0,16,239,255,59,0,196,255,32,0,223,255,26,2,227,255
8685039,1589,208428,new-1.0,completed,261.0,7.6,132,129,33,59,169,261,3,6,252,261,32,0,229,261,29,31,201,261,0,0,261,261
8685039,1589,460300,base,completed,271.0,6.95,114,157,0,42,229,271,32,0,239,271,34,63,174,271,1,34,236,271,8,0,263,271
8685039,1589,460300,base+,completed,260.0,6.95,172,88,43,22,195,260,0,0,260,260,6,14,240,260,8,9,243,260,36,0,224,260
8685039,1589,460300,dpv1,completed,354.0,7.15,100,254,92,0,262,354,0,35,319,354,94,23,237,354,92,125,137,354,98,69,187,354
8685039,1589,460300,dpv2,completed,321.0,7.35,95,226,0,147,174,321,34,179,108,321,35,56,230,321,4,0,317,321,17,0,304,321
8685039,1589,460300,new-0.0,completed,250.0,7.0,174,76,29,0,221,250,0,0,250,250,31,31,188,250,10,11,229,250,15,4,231,250
8685039,1589,460300,new-0.5,completed,252.0,7.7,210,42,31,2,219,252,0,0,252,252,10,0,242,252,38,0,214,252,40,0,212,252
8685039,1589,460300,new-1.0,completed,253.0,7.5,169,84,5,3,245,253,0,6,247,253,23,17,213,253,39,25,189,253,22,0,231,253
8685039,1589,309704,base,completed,274.0,6.8,171,103,0,0,274,274,43,0,231,274,32,26,216,274,37,38,199,274,53,0,221,274
8685039,1589,309704,base+,completed,258.0,6.9,187,71,3,11,244,258,0,0,258,258,39,0,219,258,22,9,227,258,39,14,205,258
8685039,1589,309704,dpv1,completed,342.0,7.15,95,247,93,0,249,342,87,45,210,342,96,31,215,342,0,104,238,342,85,51,206,342
8685039,1589,309704,dpv2,completed,267.0,7.45,97,170,0,0,267,267,38,0,229,267,9,32,226,267,6,122,139,267,9,0,258,267
8685039,1589,309704,new-0.0,completed,253.0,6.95,179,74,46,0,207,253,0,0,253,253,19,2,232,253,12,0,241,253,45,26,182,253
8685039,1589,309704,new-0.5,completed,254.0,7.55,180,74,25,14,215,254,37,0,217,254,44,0,210,254,29,16,209,254,0,0,254,254
8685039,1589,309704,new-1.0,completed,281.0,7.65,134,147,59,29,193,281,48,3,230,281,59,0,222,281,0,61,220,281,14,0,267,281
8685039,1589,247588,base,completed,322.0,6.85,114,208,96,0,226,322,0,0,322,322,78,48,196,322,54,35,233,322,51,115,156,322
8685039,1589,247588,base+,completed,295.0,6.9,61,234,3,31,261,295,87,0,208,295,5,78,212,295,0,0,295,295,56,92,147,295
8685039,1589,247588,dpv1,completed,346.0,7.2,78,268,84,34,228,346,91,37,218,346,83,0,263,346,0,118,228,346,94,71,181,346
8685039,1589,247588,dpv2,completed,279.0,7.3,109,170,30,0,249,279,24,30,225,279,27,0,252,279,0,139,140,279,31,0,248,279
8685039,1589,247588,new-0.0,completed,262.0,7.0,178,84,0,7,255,262,60,0,202,262,12,0,250,262,22,4,236,262,59,13,190,262
8685039,1589,247588,new-0.5,completed,258.0,7.2,182,76,0,0,258,258,11,0,247,258,25,0,233,258,54,22,182,258,52,0,206,258
8685039,1589,247588,new-1.0,completed,280.0,7.65,132,148,63,29,188,280,53,0,227,280,24,0,256,280,47,56,177,280,0,0,280,280
8685039,1589,203195,base,completed,350.0,7.0,122,228,94,106,150,350,106,0,244,350,55,157,138,350,56,0,294,350,0,0,350,350
8685039,1589,203195,base+,completed,283.0,6.95,89,194,0,5,278,283,28,0,255,283,36,61,186,283,24,0,259,283,16,110,157,283
8685039,1589,203195,dpv1,completed,337.0,7.3,104,233,91,0,246,337,92,41,204,337,73,0,264,337,0,100,237,337,83,69,185,337
8685039,1589,203195,dpv2,completed,277.0,7.45,109,168,16,0,261,277,43,0,234,277,0,0,277,277,10,120,147,277,21,26,230,277
8685039,1589,203195,new-0.0,completed,263.0,6.8,139,124,0,0,263,263,20,0,243,263,2,33,228,263,47,34,182,263,43,20,200,263
8685039,1589,203195,new-0.5,completed,251.0,7.5,195,56,28,0,223,251,0,0,251,251,49,0,202,251,56,0,195,251,0,0,251,251
8685039,1589,203195,new-1.0,completed,288.0,7.65,122,166,81,58,149,288,0,0,288,288,65,0,223,288,61,28,199,288,36,0,252,288
8685039,1589,178029,base,completed,333.0,7.0,85,248,0,0,333,333,90,158,85,333,88,0,245,333,62,67,204,333,67,0,266,333
8685039,1589,178029,base+,completed,298.0,6.95,77,221,50,24,224,298,0,35,263,298,27,30,241,298,7,0,291,298,13,136,149,298
8685039,1589,178029,dpv1,completed,319.0,7.15,105,214,56,70,193,319,81,0,238,319,82,29,208,319,51,94,174,319,0,0,319,319
8685039,1589,178029,dpv2,completed,278.0,7.25,144,134,0,0,278,278,47,0,231,278,27,43,208,278,38,0,240,278,45,44,189,278
8685039,1589,178029,new-0.0,completed,263.0,6.95,164,99,40,2,221,263,0,0,263,263,44,42,177,263,3,15,245,263,29,0,234,263
8685039,1589,178029,new-0.5,completed,255.0,7.5,194,61,23,0,232,255,58,0,197,255,0,3,252,255,42,0,213,255,5,0,250,255
8685039,1589,178029,new-1.0,completed,259.0,7.4,157,102,49,30,180,259,35,0,224,259,0,35,224,259,0,0,259,259,4,0,255,259
8685039,1589,239735,base,completed,334.0,6.75,92,242,17,0,317,334,0,143,191,334,36,156,142,334,19,136,179,334,27,0,307,334
8685039,1589,239735,base+,completed,266.0,6.75,170,96,6,0,260,266,45,0,221,266,0,0,266,266,80,11,175,266,12,46,208,266
8685039,1589,239735,dpv1,completed,333.0,7.25,99,234,71,75,187,333,86,0,247,333,89,40,204,333,0,94,239,333,73,15,245,333
8685039,1589,239735,dpv2,completed,279.0,7.3,94,185,0,10,269,279,11,0,268,279,22,16,241,279,18,163,98,279,21,0,258,279
8685039,1589,239735,new-0.0,completed,248.0,7.0,165,83,37,0,211,248,27,0,221,248,6,14,228,248,40,36,172,248,0,0,248,248
8685039,1589,239735,new-0.5,completed,250.0,7.5,199,51,32,0,218,250,0,0,250,250,51,0,199,250,39,0,211,250,22,0,228,250
8685039,1589,239735,new-1.0,completed,280.0,7.55,137,143,63,54,163,280,39,0,241,280,62,0,218,280,0,29,251,280,25,0,255,280
8685039,1589,675528,base,completed,305.0,7.2,83,222,56,0,249,305,49,50,206,305,17,89,199,305,6,179,120,305,0,0,305,305
8685039,1589,675528,base+,completed,248.0,7.1,175,73,12,9,227,248,43,0,205,248,8,0,240,248,14,0,234,248,0,31,217,248
8685039,1589,675528,dpv1,completed,354.0,7.25,88,266,85,0,269,354,97,0,257,354,98,51,205,354,0,34,320,354,99,167,88,354
8685039,1589,675528,dpv2,completed,271.0,7.4,97,174,16,0,255,271,36,0,235,271,0,0,271,271,6,122,143,271,1,26,244,271
8685039,1589,675528,new-0.0,completed,266.0,6.9,174,92,58,4,204,266,20,0,246,266,25,0,241,266,0,3,263,266,67,18,181,266
8685039,1589,675528,new-0.5,completed,252.0,7.55,185,67,9,14,229,252,0,0,252,252,24,0,228,252,13,16,223,252,37,0,215,252
8685039,1589,675528,new-1.0,completed,281.0,7.6,129,152,46,30,205,281,42,0,239,281,54,0,227,281,8,73,200,281,0,0,281,281
8685039,1589,380692,base,completed,342.0,6.95,79,263,0,224,118,342,18,0,324,342,3,0,339,342,29,124,189,342,57,155,130,342
8685039,1589,380692,base+,completed,258.0,6.95,161,97,30,0,228,258,23,0,235,258,0,0,258,258,20,23,215,258,60,14,184,258
8685039,1589,380692,dpv1,completed,348.0,7.1,91,257,90,55,203,348,0,33,315,348,60,0,288,348,83,36,229,348,70,171,107,348
8685039,1589,380692,dpv2,completed,322.0,7.35,85,237,19,152,151,322,28,189,105,322,38,52,232,322,0,0,322,322,20,0,302,322
8685039,1589,380692,new-0.0,completed,264.0,7.05,176,88,61,0,203,264,0,0,264,264,21,1,242,264,62,25,177,264,34,0,230,264
8685039,1589,380692,new-0.5,completed,246.0,7.6,172,74,16,14,216,246,26,0,220,246,0,0,246,246,17,16,213,246,44,0,202,246
8685039,1589,380692,new-1.0,completed,265.0,7.65,148,117,51,18,196,265,32,0,233,265,2,0,263,265,45,48,172,265,0,0,265,265
4071087,1651,310811,base,completed,317.0,7.05,136,181,32,66,219,317,83,45,189,317,83,0,234,317,0,44,273,317,51,0,266,317
4071087,1651,310811,base+,completed,305.0,7.05,152,153,0,43,262,305,82,0,223,305,81,12,212,305,69,0,236,305,22,29,254,305
4071087,1651,310811,dpv1,completed,335.0,7.05,131,204,33,22,280,335,0,6,329,335,87,12,236,335,94,65,176,335,94,68,173,335
4071087,1651,310811,dpv2,completed,307.0,7.3,157,150,62,0,245,307,83,48,176,307,12,50,245,307,0,10,297,307,76,27,204,307
4071087,1651,310811,new-0.0,completed,305.0,6.95,162,143,37,11,257,305,92,28,185,305,94,5,206,305,0,20,285,305,92,0,213,305
4071087,1651,310811,new-0.5,completed,318.0,7.1,159,159,86,4,228,318,82,27,209,318,0,27,291,318,27,38,253,318,85,29,204,318
4071087,1651,310811,new-1.0,completed,293.0,7.5,101,192,20,58,215,293,9,22,262,293,0,27,266,293,17,13,263,293,47,64,182,293
4071087,1651,208428,base,completed,317.0,6.95,104,213,0,6,311,317,7,89,221,317,81,62,174,317,46,48,223,317,64,0,253,317
4071087,1651,208428,base+,completed,327.0,7.15,144,183,0,0,327,327,90,40,197,327,81,25,221,327,32,20,275,327,90,55,182,327
4071087,1651,208428,dpv1,completed,297.0,7.25,164,133,75,23,199,297,76,0,221,297,30,26,241,297,61,0,236,297,0,32,265,297
4071087,1651,208428,dpv2,completed,341.0,7.4,134,207,84,81,176,341,91,76,174,341,0,40,301,341,36,16,289,341,90,38,213,341
4071087,1651,208428,new-0.0,completed,289.0,7.05,161,128,86,0,203,289,59,0,230,289,40,18,231,289,0,19,270,289,85,17,187,289
4071087,1651,208428,new-0.5,completed,306.0,7.25,164,142,77,8,221,306,23,32,251,306,74,16,216,306,0,22,284,306,85,23,198,306
4071087,1651,208428,new-1.0,completed,291.0,7.55,113,178,16,68,207,291,0,30,261,291,19,22,250,291,6,20,265,291,34,57,200,291
4071087,1651,460300,base,completed,326.0,6.85,121,205,57,90,179,326,0,11,315,326,54,0,272,326,54,12,260,326,4,151,171,326
4071087,1651,460300,base+,completed,324.0,7.0,152,172,0,20,304,324,94,66,164,324,93,0,231,324,39,18,267,324,88,36,200,324
4071087,1651,460300,dpv1,completed,333.0,7.1,141,192,24,22,287,333,88,22,223,333,79,22,232,333,0,64,269,333,88,56,189,333
4071087,1651,460300,dpv2,completed,321.0,7.55,146,175,76,48,197,321,85,51,185,321,27,24,270,321,86,24,211,321,0,0,321,321
4071087,1651,460300,new-0.0,completed,297.0,6.85,159,138,27,26,244,297,0,20,277,297,82,0,215,297,83,21,193,297,83,0,214,297
4071087,1651,460300,new-0.5,completed,311.0,7.2,177,134,85,2,224,311,23,18,270,311,76,29,206,311,80,31,200,311,0,25,286,311
4071087,1651,460300,new-1.0,completed,304.0,7.5,160,144,56,0,248,304,6,37,261,304,62,0,242,304,0,18,286,304,84,51,169,304
4071087,1651,309704,base,completed,308.0,6.75,128,180,0,12,296,308,67,51,190,308,63,0,245,308,20,117,171,308,50,0,258,308
4071087,1651,309704,base+,completed,284.0,7.25,145,139,54,0,230,284,2,35,247,284,51,20,213,284,72,0,212,284,0,32,252,284
4071087,1651,309704,dpv1,completed,331.0,7.1,121,210,27,29,275,331,96,0,235,331,83,24,224,331,0,67,264,331,93,56,182,331
4071087,1651,309704,dpv2,completed,311.0,7.4,146,165,81,47,183,311,93,36,182,311,0,56,255,311,1,11,299,311,50,0,261,311
4071087,1651,309704,new-0.0,completed,297.0,6.8,168,129,64,0,233,297,87,19,191,297,31,18,248,297,76,0,221,297,0,24,273,297
4071087,1651,309704,new-0.5,completed,289.0,7.45,165,124,0,0,289,289,84,0,205,289,50,19,220,289,38,21,230,289,84,0,205,289
4071087,1651,309704,new-1.0,completed,311.0,7.4,168,143,73,0,238,311,97,21,193,311,43,12,256,311,0,35,276,311,96,2,213,311
4071087,1651,247588,base,completed,298.0,7.05,114,184,0,46,252,298,59,0,239,298,59,0,239,298,7,44,247,298,65,35,198,298
4071087,1651,247588,base+,completed,356.0,6.7,128,228,84,69,203,356,24,25,307,356,79,72,205,356,90,98,168,356,0,52,304,356
4071087,1651,247588,dpv1,completed,323.0,7.05,126,197,24,20,279,323,83,6,234,323,0,51,272,323,85,78,160,323,75,29,219,323
4071087,1651,247588,dpv2,completed,303.0,7.35,158,145,72,54,177,303,51,0,252,303,6,60,237,303,77,50,176,303,0,0,303,303
4071087,1651,247588,new-0.0,completed,288.0,6.9,170,118,90,0,198,288,0,11,277,288,39,25,224,288,72,0,216,288,81,7,200,288
4071087,1651,247588,new-0.5,completed,288.0,7.45,153,135,69,20,199,288,54,0,234,288,14,27,247,288,0,39,249,288,75,0,213,288
4071087,1651,247588,new-1.0,completed,284.0,7.35,137,147,0,3,281,284,36,0,248,284,48,0,236,284,0,36,248,284,48,68,168,284
4071087,1651,203195,base,completed,308.0,6.65,146,162,32,31,245,308,47,0,261,308,1,90,217,308,75,0,233,308,0,77,231,308
4071087,1651,203195,base+,completed,313.0,6.7,165,148,87,48,178,313,67,22,224,313,0,51,262,313,24,45,244,313,47,0,266,313
4071087,1651,203195,dpv1,completed,317.0,7.3,169,148,85,31,201,317,92,1,224,317,92,0,225,317,0,45,272,317,34,17,266,317
4071087,1651,203195,dpv2,completed,311.0,7.35,161,150,85,39,187,311,0,53,258,311,50,15,246,311,91,47,173,311,5,2,304,311
4071087,1651,203195,new-0.0,completed,297.0,7.0,173,124,85,0,212,297,86,12,199,297,32,22,243,297,0,4,293,297,79,0,218,297
4071087,1651,203195,new-0.5,completed,325.0,7.25,146,179,0,23,302,325,33,35,257,325,93,36,196,325,90,31,204,325,83,31,211,325
4071087,1651,203195,new-1.0,completed,271.0,7.6,122,149,1,67,203,271,36,25,210,271,32,16,223,271,3,5,263,271,0,0,271,271
4071087,1651,178029,base,completed,372.0,6.9,125,247,75,0,297,372,0,131,241,372,3,202,167,372,45,98,229,372,56,68,248,372
4071087,1651,178029,base+,completed,319.0,6.9,115,204,16,17,286,319,0,96,223,319,80,12,227,319,71,22,226,319,68,64,187,319
4071087,1651,178029,dpv1,completed,327.0,7.1,130,197,32,21,274,327,85,0,242,327,84,12,231,327,0,62,265,327,88,51,188,327
4071087,1651,178029,dpv2,completed,327.0,7.5,146,181,76,59,192,327,0,61,266,327,33,21,273,327,84,30,213,327,85,14,228,327
4071087,1651,178029,new-0.0,completed,285.0,6.9,177,108,69,0,216,285,0,0,285,285,31,23,231,285,81,4,200,285,68,0,217,285
4071087,1651,178029,new-0.5,completed,309.0,7.15,170,139,25,24,260,309,80,0,229,309,0,33,276,309,78,25,206,309,81,30,198,309
4071087,1651,178029,new-1.0,completed,292.0,7.5,100,192,21,71,200,292,16,29,247,292,0,23,269,292,14,14,264,292,46,45,201,292
4071087,1651,239735,base,completed,306.0,7.2,130,176,82,13,211,306,29,56,221,306,0,38,268,306,84,0,222,306,60,0,246,306
4071087,1651,239735,base+,completed,305.0,6.8,118,187,0,27,278,305,72,35,198,305,61,67,177,305,71,39,195,305,11,30,264,305
4071087,1651,239735,dpv1,completed,283.0,7.35,159,124,66,1,216,283,5,39,239,283,0,32,251,283,53,0,230,283,71,0,212,283
4071087,1651,239735,dpv2,completed,309.0,7.3,143,166,79,42,188,309,0,18,291,309,89,19,201,309,37,27,245,309,89,17,203,309
4071087,1651,239735,new-0.0,completed,270.0,7.0,171,99,0,9,261,270,33,5,232,270,63,0,207,270,81,5,184,270,58,0,212,270
4071087,1651,239735,new-0.5,completed,277.0,7.35,167,110,66,3,208,277,17,44,216,277,0,0,277,277,48,0,229,277,67,0,210,277
4071087,1651,239735,new-1.0,completed,295.0,7.3,155,140,51,0,244,295,0,0,295,295,57,0,238,295,4,38,253,295,76,55,164,295
4071087,1651,675528,base,completed,316.0,7.1,130,186,0,35,281,316,55,14,247,316,1,6,309,316,74,43,199,316,61,112,143,316
4071087,1651,675528,base+,completed,304.0,7.35,151,153,74,6,224,304,63,0,241,304,26,22,256,304,0,4,300,304,84,53,167,304
4071087,1651,675528,dpv1,completed,303.0,7.45,173,130,90,0,213,303,66,0,237,303,90,13,200,303,0,26,277,303,15,38,250,303
4071087,1651,675528,dpv2,completed,342.0,7.5,135,207,85,84,173,342,94,66,182,342,28,14,300,342,90,41,211,342,0,32,310,342
4071087,1651,675528,new-0.0,completed,285.0,6.9,160,125,58,0,227,285,54,0,231,285,39,19,227,285,85,11,189,285,0,21,264,285
4071087,1651,675528,new-0.5,completed,295.0,7.4,157,138,84,6,205,295,80,0,215,295,49,20,226,295,28,34,233,295,0,0,295,295
4071087,1651,675528,new-1.0,completed,292.0,7.45,118,174,4,34,254,292,36,43,213,292,42,24,226,292,0,20,272,292,9,46,237,292
4071087,1651,380692,base,completed,297.0,6.95,132,165,72,0,225,297,0,0,297,297,66,0,231,297,20,0,277,297,18,99,180,297
4071087,1651,380692,base+,completed,311.0,7.1,133,178,0,26,285,311,81,0,230,311,30,51,230,311,75,41,195,311,69,21,221,311
4071087,1651,380692,dpv1,completed,292.0,7.2,177,115,83,2,207,292,2,24,266,292,90,5,197,292,0,35,257,292,54,0,238,292
4071087,1651,380692,dpv2,completed,323.0,7.45,127,196,0,1,322,323,81,65,177,323,28,18,277,323,80,28,215,323,74,81,168,323
4071087,1651,380692,new-0.0,completed,287.0,6.85,175,112,74,0,213,287,70,10,207,287,26,25,236,287,67,0,220,287,0,15,272,287
4071087,1651,380692,new-0.5,completed,297.0,7.15,170,127,70,2,225,297,10,33,254,297,0,25,272,297,63,9,225,297,75,18,204,297
4071087,1651,380692,new-1.0,completed,283.0,7.5,106,177,13,56,214,283,42,0,241,283,0,28,255,283,10,18,255,283,41,43,199,283
1683208,1666,310811,base,completed,398.0,6.85,108,290,30,140,228,398,0,72,326,398,61,156,181,398,46,99,253,398,12,195,191,398
1683208,1666,310811,base+,completed,341.0,6.75,121,220,0,93,248,341,18,16,307,341,63,108,170,341,25,59,257,341,21,122,198,341
1683208,1666,310811,dpv1,completed,366.0,7.0,110,256,0,153,213,366,42,8,316,366,95,114,157,366,61,79,226,366,75,48,243,366
1683208,1666,310811,dpv2,completed,370.0,7.05,107,263,0,137,233,370,59,62,249,370,95,91,184,370,43,51,276,370,82,63,225,370
1683208,1666,310811,new-0.0,completed,290.0,7.0,108,182,7,39,244,290,0,59,231,290,36,77,177,290,0,50,240,290,5,34,251,290
1683208,1666,310811,new-0.5,completed,324.0,7.1,109,215,1,78,245,324,3,59,262,324,6,100,218,324,33,112,179,324,0,73,251,324
1683208,1666,310811,new-1.0,completed,344.0,7.25,103,241,37,84,223,344,43,67,234,344,0,12,332,344,64,105,175,344,34,81,229,344
1683208,1666,208428,base,completed,360.0,6.7,109,251,18,82,260,360,37,165,158,360,3,9,348,360,52,105,203,360,0,148,212,360
1683208,1666,208428,base+,completed,337.0,6.75,114,223,13,151,173,337,0,89,248,337,15,70,252,337,22,48,267,337,51,84,202,337
1683208,1666,208428,dpv1,completed,390.0,7.05,110,280,56,58,276,390,62,78,250,390,93,136,161,390,0,130,260,390,77,65,248,390
1683208,1666,208428,dpv2,completed,373.0,7.2,114,259,0,121,252,373,63,71,239,373,59,37,277,373,103,88,182,373,87,58,228,373
1683208,1666,208428,new-0.0,completed,302.0,7.0,118,184,16,50,236,302,6,54,242,302,40,69,193,302,0,73,229,302,15,29,258,302
1683208,1666,208428,new-0.5,completed,312.0,7.25,119,193,2,69,241,312,9,64,239,312,12,81,219,312,32,91,189,312,0,45,267,312
1683208,1666,208428,new-1.0,completed,349.0,7.4,119,230,51,56,242,349,51,65,233,349,0,26,323,349,78,111,160,349,45,62,242,349
1683208,1666,460300,base,completed,432.0,6.9,74,358,33,0,399,432,64,142,226,432,22,186,224,432,5,277,150,432,0,222,210,432
1683208,1666,460300,base+,completed,416.0,6.8,85,331,0,119,297,416,62,111,243,416,51,184,181,416,86,116,214,416,42,113,261,416
1683208,1666,460300,dpv1,completed,379.0,7.1,127,252,77,46,256,379,0,142,237,379,46,14,319,379,64,137,178,379,88,112,179,379
1683208,1666,460300,dpv2,completed,389.0,7.1,135,254,87,14,288,389,0,147,242,389,95,108,186,389,67,109,213,389,46,74,269,389
1683208,1666,460300,new-0.0,completed,293.0,7.0,134,159,12,13,268,293,48,56,189,293,16,52,225,293,16,56,221,293,0,22,271,293
1683208,1666,460300,new-0.5,completed,324.0,7.25,109,215,13,73,238,324,0,81,243,324,3,79,242,324,43,83,198,324,17,53,254,324
1683208,1666,460300,new-1.0,completed,343.0,7.25,117,226,58,63,222,343,47,48,248,343,0,18,325,343,79,87,177,343,53,64,226,343
1683208,1666,309704,base,completed,363.0,6.9,101,262,54,84,225,363,35,0,328,363,0,148,215,363,3,118,242,363,16,197,150,363
1683208,1666,309704,base+,completed,382.0,6.9,94,288,63,142,177,382,0,82,300,382,23,95,264,382,25,50,307,382,26,206,150,382
1683208,1666,309704,dpv1,completed,390.0,7.0,109,281,0,158,232,390,50,16,324,390,110,128,152,390,73,69,248,390,85,63,242,390
1683208,1666,309704,dpv2,completed,372.0,7.1,130,242,82,16,274,372,0,119,253,372,107,89,176,372,72,88,212,372,51,52,269,372
1683208,1666,309704,new-0.0,completed,319.0,7.1,134,185,78,72,169,319,38,49,232,319,0,26,293,319,56,59,204,319,33,16,270,319
1683208,1666,309704,new-0.5,completed,322.0,7.1,96,226,4,49,269,322,37,94,191,322,1,83,238,322,23,61,238,322,0,83,239,322
1683208,1666,309704,new-1.0,completed,344.0,7.25,109,235,48,81,215,344,29,72,243,344,0,32,312,344,69,111,164,344,29,77,238,344
1683208,1666,247588,base,completed,419.0,6.75,94,325,61,179,179,419,0,115,304,419,2,298,119,419,13,222,184,419,36,0,383,419
1683208,1666,247588,base+,completed,405.0,6.85,113,292,59,184,162,405,26,209,170,405,28,131,246,405,17,104,284,405,0,96,309,405
1683208,1666,247588,dpv1,completed,356.0,7.0,113,243,43,53,260,356,47,72,237,356,83,117,156,356,0,120,236,356,64,58,234,356
1683208,1666,247588,dpv2,completed,356.0,7.15,104,252,0,123,233,356,83,69,204,356,40,27,289,356,55,107,194,356,55,66,235,356
1683208,1666,247588,new-0.0,completed,281.0,7.05,120,161,11,18,252,281,9,48,224,281,35,62,184,281,0,50,231,281,5,30,246,281
1683208,1666,247588,new-0.5,completed,302.0,7.25,103,199,6,68,228,302,0,57,245,302,6,59,237,302,35,89,178,302,6,52,244,302
1683208,1666,247588,new-1.0,completed,329.0,7.3,120,209,47,66,216,329,42,44,243,329,0,6,323,329,74,101,154,329,39,65,225,329
1683208,1666,203195,base,completed,425.0,6.65,118,307,46,222,157,425,0,121,304,425,62,183,180,425,35,206,184,425,32,12,381,425
1683208,1666,203195,base+,completed,348.0,7.0,76,272,16,96,236,348,22,0,326,348,57,83,208,348,0,145,203,348,19,117,212,348
1683208,1666,203195,dpv1,completed,387.0,7.15,128,259,77,55,255,387,0,125,262,387,46,35,306,387,62,143,182,387,86,114,187,387
1683208,1666,203195,dpv2,completed,377.0,7.05,106,271,0,134,243,377,63,67,247,377,94,96,187,377,53,52,272,377,78,65,234,377
1683208,1666,203195,new-0.0,completed,289.0,7.05,112,177,12,29,248,289,0,62,227,289,30,77,182,289,0,55,234,289,0,27,262,289
1683208,1666,203195,new-0.5,completed,317.0,7.25,110,207,5,69,243,317,1,72,244,317,0,79,238,317,35,88,194,317,10,51,256,317
1683208,1666,203195,new-1.0,completed,360.0,7.3,126,234,63,67,230,360,46,56,258,360,0,28,332,360,75,120,165,360,45,88,227,360
1683208,1666,178029,base,completed,411.0,6.85,79,332,52,191,168,411,0,200,211,411,46,48,317,411,82,83,246,411,69,106,236,411
1683208,1666,178029,base+,completed,308.0,7.0,128,180,20,6,282,308,52,63,193,308,14,88,206,308,0,102,206,308,15,39,254,308
1683208,1666,178029,dpv1,completed,368.0,7.15,124,244,62,43,263,368,0,113,255,368,47,28,293,368,41,140,187,368,79,107,182,368
1683208,1666,178029,dpv2,completed,380.0,7.05,114,266,96,65,219,380,64,69,247,380,0,154,226,380,59,47,274,380,78,65,237,380
1683208,1666,178029,new-0.0,completed,283.0,7.15,140,143,41,58,184,283,9,59,215,283,0,19,264,283,18,56,209,283,5,0,278,283
1683208,1666,178029,new-0.5,completed,327.0,7.25,119,208,9,89,229,327,0,77,250,327,2,85,240,327,39,97,191,327,15,49,263,327
1683208,1666,178029,new-1.0,completed,352.0,7.35,126,226,50,65,237,352,51,42,259,352,0,46,306,352,82,106,164,352,51,62,239,352
1683208,1666,239735,base,completed,399.0,6.8,107,292,34,232,133,399,59,171,169,399,0,185,214,399,31,64,304,399,29,15,355,399
1683208,1666,239735,base+,completed,353.0,7.0,109,244,0,110,243,353,33,126,194,353,34,1,318,353,71,91,191,353,34,82,237,353
1683208,1666,239735,dpv1,completed,403.0,7.05,113,290,58,96,249,403,0,103,300,403,44,113,246,403,57,179,167,403,75,162,166,403
1683208,1666,239735,dpv2,completed,371.0,7.15,108,263,0,129,242,371,92,80,199,371,42,43,286,371,64,116,191,371,70,69,232,371
1683208,1666,239735,new-0.0,completed,294.0,7.0,110,184,29,42,223,294,13,48,233,294,43,66,185,294,15,32,247,294,0,44,250,294
1683208,1666,239735,new-0.5,completed,300.0,7.25,107,193,3,72,225,300,5,55,240,300,8,62,230,300,34,84,182,300,0,45,255,300
1683208,1666,239735,new-1.0,completed,332.0,7.25,106,226,21,78,233,332,33,68,231,332,0,4,328,332,58,123,151,332,22,83,227,332
1683208,1666,675528,base,completed,380.0,7.1,92,288,0,115,265,380,72,135,173,380,48,29,303,380,69,172,139,380,92,0,288,380
1683208,1666,675528,base+,completed,372.0,7.1,101,271,48,121,203,372,14,171,187,372,10,8,354,372,0,158,214,372,9,120,243,372
1683208,1666,675528,dpv1,completed,400.0,6.85,113,287,98,114,188,400,0,155,245,400,53,149,198,400,43,0,357,400,74,89,237,400
1683208,1666,675528,dpv2,completed,382.0,7.05,107,275,0,129,253,382,57,83,242,382,87,94,201,382,45,55,282,382,70,84,228,382
1683208,1666,675528,new-0.0,completed,299.0,7.05,121,178,25,21,253,299,0,56,243,299,41,65,193,299,6,61,232,299,16,24,259,299
1683208,1666,675528,new-0.5,completed,310.0,7.3,113,197,3,52,255,310,3,60,247,310,7,72,231,310,37,80,193,310,0,62,248,310
1683208,1666,675528,new-1.0,completed,361.0,7.25,126,235,63,74,224,361,47,60,254,361,0,30,331,361,83,123,155,361,44,77,240,361
1683208,1666,380692,base,completed,405.0,7.15,92,313,25,14,366,405,45,181,179,405,57,216,132,405,26,215,164,405,0,112,293,405
1683208,1666,380692,base+,completed,367.0,6.75,103,264,20,182,165,367,61,58,248,367,26,64,277,367,0,108,259,367,34,90,243,367
1683208,1666,380692,dpv1,completed,354.0,7.05,124,230,69,22,263,354,38,14,302,354,56,123,175,354,0,126,228,354,86,95,173,354
1683208,1666,380692,dpv2,completed,374.0,7.1,129,245,78,15,281,374,0,119,255,374,83,107,184,374,56,117,201,374,48,69,257,374
1683208,1666,380692,new-0.0,completed,290.0,7.15,134,156,39,70,181,290,0,70,220,290,6,15,269,290,8,60,222,290,13,0,277,290
1683208,1666,380692,new-0.5,completed,313.0,7.25,108,205,4,79,230,313,0,73,240,313,4,71,238,313,42,79,192,313,12,48,253,313
1683208,1666,380692,new-1.0,completed,334.0,7.25,110,224,28,65,241,334,69,116,149,334,0,25,309,334,46,66,222,334,36,60,238,334
9178491,1880,310811,base,completed,312.0,6.7,193,119,26,0,286,312,9,0,303,312,52,63,197,312,56,0,256,312,0,0,312,312
9178491,1880,310811,base+,completed,301.0,6.95,227,74,38,0,263,301,54,19,228,301,0,0,301,301,47,0,254,301,3,1,297,301
9178491,1880,310811,dpv1,completed,308.0,7.45,187,121,0,0,308,308,37,72,199,308,6,0,302,308,52,0,256,308,21,1,286,308
9178491,1880,310811,dpv2,completed,293.0,7.3,237,56,16,0,277,293,10,0,283,293,27,0,266,293,0,0,293,293,56,0,237,293
9178491,1880,310811,new-0.0,completed,300.0,7.15,238,62,0,0,300,300,62,0,238,300,22,0,278,300,53,0,247,300,27,0,273,300
9178491,1880,310811,new-0.5,completed,300.0,7.5,239,61,0,0,300,300,61,0,239,300,33,0,267,300,5,0,295,300,45,0,255,300
9178491,1880,310811,new-1.0,completed,306.0,7.7,242,64,61,0,245,306,28,0,278,306,0,3,303,306,25,0,281,306,52,0,254,306
9178491,1880,208428,base,completed,312.0,7.0,234,78,27,0,285,312,29,0,283,312,0,19,293,312,50,12,250,312,42,0,270,312
9178491,1880,208428,base+,completed,316.0,6.8,244,72,52,0,264,316,69,0,247,316,72,0,244,316,0,0,316,316,4,0,312,316
9178491,1880,208428,dpv1,completed,342.0,7.3,170,172,19,0,323,342,72,0,270,342,66,0,276,342,0,46,296,342,57,100,185,342
9178491,1880,208428,dpv2,completed,313.0,7.55,238,75,67,0,246,313,67,0,246,313,39,8,266,313,36,0,277,313,0,0,313,313
9178491,1880,208428,new-0.0,completed,297.0,6.95,234,63,58,0,239,297,63,0,234,297,36,0,261,297,0,0,297,297,21,0,276,297
9178491,1880,208428,new-0.5,completed,305.0,7.4,239,66,21,0,284,305,0,0,305,305,66,0,239,305,49,0,256,305,52,0,253,305
9178491,1880,208428,new-1.0,completed,330.0,7.5,200,130,0,0,330,330,64,13,253,330,61,0,269,330,51,0,279,330,32,53,245,330
9178491,1880,460300,base,completed,314.0,6.7,244,70,6,0,308,314,34,0,280,314,70,0,244,314,48,0,266,314,0,0,314,314
9178491,1880,460300,base+,completed,337.0,6.7,242,95,69,0,268,337,52,26,259,337,66,0,271,337,52,0,285,337,0,20,317,337
9178491,1880,460300,dpv1,completed,335.0,7.45,182,153,46,0,289,335,45,0,290,335,45,0,290,335,0,51,284,335,44,107,184,335
9178491,1880,460300,dpv2,completed,330.0,7.5,212,118,61,0,269,330,23,0,307,330,74,0,256,330,0,41,289,330,77,0,253,330
9178491,1880,460300,new-0.0,completed,300.0,6.8,242,58,29,0,271,300,58,0,242,300,32,0,268,300,58,0,242,300,0,0,300,300
9178491,1880,460300,new-0.5,completed,303.0,7.5,230,73,73,0,230,303,0,0,303,303,0,0,303,303,48,0,255,303,42,0,261,303
9178491,1880,460300,new-1.0,completed,306.0,7.55,243,63,28,0,278,306,17,0,289,306,63,0,243,306,0,0,306,306,45,0,261,306
9178491,1880,309704,base,completed,322.0,7.0,187,135,0,0,322,322,21,0,301,322,54,0,268,322,51,22,249,322,22,81,219,322
9178491,1880,309704,base+,completed,301.0,6.95,211,90,35,55,211,301,20,0,281,301,28,0,273,301,0,0,301,301,15,0,286,301
9178491,1880,309704,dpv1,completed,320.0,7.2,200,120,26,0,294,320,63,0,257,320,49,0,271,320,70,50,200,320,0,0,320,320
9178491,1880,309704,dpv2,completed,302.0,7.7,199,103,1,0,301,302,0,0,302,302,56,0,246,302,51,47,204,302,23,0,279,302
9178491,1880,309704,new-0.0,completed,291.0,7.15,236,55,0,0,291,291,55,0,236,291,8,0,283,291,47,0,244,291,26,0,265,291
9178491,1880,309704,new-0.5,completed,306.0,7.45,234,72,72,0,234,306,29,0,277,306,43,0,263,306,0,0,306,306,59,0,247,306
9178491,1880,309704,new-1.0,completed,306.0,7.55,204,102,0,0,306,306,22,25,259,306,47,0,259,306,31,0,275,306,6,30,270,306
9178491,1880,247588,base,completed,315.0,6.75,206,109,36,0,279,315,43,0,272,315,53,0,262,315,0,31,284,315,78,0,237,315
9178491,1880,247588,base+,completed,332.0,6.8,192,140,40,0,292,332,75,0,257,332,0,0,332,332,40,0,292,332,57,73,202,332
9178491,1880,247588,dpv1,completed,304.0,7.3,186,118,0,0,304,304,41,53,210,304,16,0,288,304,41,0,263,304,23,24,257,304
9178491,1880,247588,dpv2,completed,319.0,7.65,205,114,57,0,262,319,77,37,205,319,36,0,283,319,0,0,319,319,30,0,289,319
9178491,1880,247588,new-0.0,completed,276.0,6.8,227,49,5,0,271,276,26,0,250,276,20,0,256,276,0,0,276,276,49,0,227,276
9178491,1880,247588,new-0.5,completed,306.0,7.55,239,67,59,0,247,306,26,0,280,306,0,0,306,306,67,0,239,306,61,0,245,306
9178491,1880,247588,new-1.0,completed,304.0,7.4,227,77,23,6,275,304,0,0,304,304,43,0,261,304,77,0,227,304,39,0,265,304
9178491,1880,203195,base,completed,356.0,7.0,162,194,24,18,314,356,22,73,261,356,29,62,265,356,7,27,322,356,0,155,201,356
9178491,1880,203195,base+,completed,318.0,7.15,222,96,71,0,247,318,0,0,318,318,51,11,256,318,22,0,296,318,39,14,265,318
9178491,1880,203195,dpv1,completed,314.0,7.3,172,142,1,0,313,314,31,0,283,314,42,84,188,314,0,0,314,314,33,16,265,314
9178491,1880,203195,dpv2,completed,301.0,7.45,237,64,58,0,243,301,6,1,294,301,63,0,238,301,20,0,281,301,0,0,301,301
9178491,1880,203195,new-0.0,completed,298.0,6.8,243,55,25,0,273,298,43,0,255,298,16,0,282,298,55,0,243,298,0,0,298,298
9178491,1880,203195,new-0.5,completed,306.0,7.6,229,77,0,0,306,306,22,0,284,306,44,0,262,306,77,0,229,306,40,0,266,306
9178491,1880,203195,new-1.0,completed,314.0,7.7,230,84,25,0,289,314,73,0,241,314,0,11,303,314,33,0,281,314,69,0,245,314
9178491,1880,178029,base,completed,307.0,6.95,234,73,58,0,249,307,0,13,294,307,42,0,265,307,27,0,280,307,60,0,247,307
9178491,1880,178029,base+,completed,320.0,6.85,168,152,28,0,292,320,12,0,308,320,49,94,177,320,58,0,262,320,0,0,320,320
9178491,1880,178029,dpv1,completed,311.0,7.3,202,109,14,0,297,311,38,0,273,311,57,52,202,311,31,0,280,311,0,0,311,311
9178491,1880,178029,dpv2,completed,332.0,7.5,203,129,34,0,298,332,57,0,275,332,65,0,267,332,73,56,203,332,0,0,332,332
9178491,1880,178029,new-0.0,completed,290.0,6.95,239,51,47,0,243,290,51,0,239,290,29,0,261,290,1,0,289,290,0,0,290,290
9178491,1880,178029,new-0.5,completed,323.0,7.6,244,79,78,0,245,323,44,0,279,323,77,1,245,323,0,0,323,323,69,0,254,323
9178491,1880,178029,new-1.0,completed,315.0,7.55,240,75,25,10,280,315,65,0,250,315,40,0,275,315,0,0,315,315,58,0,257,315
9178491,1880,239735,base,completed,283.0,6.95,219,64,9,0,274,283,0,0,283,283,35,0,248,283,8,0,275,283,5,29,249,283
9178491,1880,239735,base+,completed,331.0,6.85,162,169,57,0,274,331,37,75,219,331,0,0,331,331,15,102,214,331,18,0,313,331
9178491,1880,239735,dpv1,completed,313.0,7.25,180,133,54,55,204,313,64,0,249,313,0,0,313,313,24,0,289,313,24,14,275,313
9178491,1880,239735,dpv2,completed,301.0,7.7,223,78,5,0,296,301,51,0,250,301,32,0,269,301,0,27,274,301,49,0,252,301
9178491,1880,239735,new-0.0,completed,280.0,6.9,234,46,22,0,258,280,35,0,245,280,17,0,263,280,0,0,280,280,46,0,234,280
9178491,1880,239735,new-0.5,completed,311.0,7.6,229,82,81,0,230,311,40,0,271,311,52,0,259,311,0,0,311,311,62,1,248,311
9178491,1880,239735,new-1.0,completed,296.0,7.55,196,100,0,21,275,296,17,3,276,296,32,0,264,296,36,0,260,296,16,40,240,296
9178491,1880,675528,base,completed,306.0,6.95,240,66,0,0,306,306,63,0,243,306,66,0,240,306,44,0,262,306,27,0,279,306
9178491,1880,675528,base+,completed,300.0,7.2,239,61,13,0,287,300,45,0,255,300,14,0,286,300,61,0,239,300,0,0,300,300
9178491,1880,675528,dpv1,completed,321.0,7.5,180,141,37,0,284,321,42,90,189,321,35,9,277,321,0,0,321,321,14,0,307,321
9178491,1880,675528,dpv2,completed,293.0,7.35,239,54,10,0,283,293,10,0,283,293,36,0,257,293,54,0,239,293,0,0,293,293
9178491,1880,675528,new-0.0,completed,311.0,7.05,235,76,0,0,311,311,76,0,235,311,59,0,252,311,22,0,289,311,66,0,245,311
9178491,1880,675528,new-0.5,completed,313.0,7.55,247,66,66,0,247,313,10,0,303,313,0,0,313,313,60,0,253,313,65,0,248,313
9178491,1880,675528,new-1.0,completed,311.0,7.55,237,74,16,2,293,311,72,0,239,311,36,0,275,311,0,0,311,311,45,0,266,311
9178491,1880,380692,base,completed,313.0,6.8,235,78,78,0,235,313,37,0,276,313,0,0,313,313,38,0,275,313,43,0,270,313
9178491,1880,380692,base+,completed,307.0,6.9,201,106,0,0,307,307,70,28,209,307,78,0,229,307,27,0,280,307,21,0,286,307
9178491,1880,380692,dpv1,completed,301.0,7.25,169,132,68,0,233,301,0,0,301,301,39,60,202,301,5,0,296,301,15,21,265,301
9178491,1880,380692,dpv2,completed,310.0,7.65,228,82,82,0,228,310,24,0,286,310,59,0,251,310,0,0,310,310,29,0,281,310
9178491,1880,380692,new-0.0,completed,281.0,7.05,237,44,33,0,248,281,27,0,254,281,8,0,273,281,0,0,281,281,44,0,237,281
9178491,1880,380692,new-0.5,completed,308.0,7.55,233,75,63,0,245,308,15,0,293,308,0,0,308,308,75,0,233,308,58,0,250,308
9178491,1880,380692,new-1.0,completed,303.0,7.6,247,56,14,0,289,303,47,0,256,303,56,0,247,303,15,0,288,303,0,0,303,303
3394644,1550,310811,base,completed,262.0,6.85,131,131,6,0,256,262,0,0,262,262,15,47,200,262,23,2,237,262,6,104,152,262
3394644,1550,310811,base+,completed,307.0,6.75,110,197,59,1,247,307,44,52,211,307,57,41,209,307,68,65,174,307,0,27,280,307
3394644,1550,310811,dpv1,completed,297.0,7.05,111,186,0,115,182,297,64,23,210,297,39,37,221,297,65,0,232,297,47,0,250,297
3394644,1550,310811,dpv2,completed,317.0,7.25,82,235,5,164,148,317,62,25,230,317,34,77,206,317,0,54,263,317,18,37,262,317
3394644,1550,310811,new-0.0,completed,255.0,6.9,143,112,0,15,240,255,18,29,208,255,7,20,228,255,5,15,235,255,29,31,195,255
3394644,1550,310811,new-0.5,completed,263.0,7.15,149,114,0,28,235,263,5,27,231,263,4,23,236,263,25,35,203,263,26,33,204,263
3394644,1550,310811,new-1.0,completed,275.0,7.5,157,118,0,0,275,275,50,47,178,275,10,48,217,275,18,0,257,275,43,50,182,275
3394644,1550,208428,base,completed,344.0,6.95,106,238,5,172,167,344,66,0,278,344,15,0,329,344,0,105,239,344,25,189,130,344
3394644,1550,208428,base+,completed,370.0,6.75,95,275,0,161,209,370,69,29,272,370,14,73,283,370,12,90,268,370,24,211,135,370
3394644,1550,208428,dpv1,completed,297.0,7.05,110,187,62,123,112,297,0,24,273,297,32,32,233,297,55,0,242,297,52,0,245,297
3394644,1550,208428,dpv2,completed,294.0,7.25,126,168,30,116,148,294,0,1,293,294,51,22,221,294,34,40,220,294,45,4,245,294
3394644,1550,208428,new-0.0,completed,248.0,7.0,175,73,9,16,223,248,35,10,203,248,14,16,218,248,12,0,236,248,0,1,247,248
3394644,1550,208428,new-0.5,completed,255.0,7.2,154,101,8,17,230,255,0,18,237,255,32,6,217,255,8,23,224,255,19,29,207,255
3394644,1550,208428,new-1.0,completed,277.0,7.45,151,126,8,4,265,277,31,57,189,277,39,48,190,277,3,0,274,277,0,63,214,277
3394644,1550,460300,base,completed,399.0,6.8,77,322,11,0,388,399,0,265,134,399,25,278,96,399,11,140,248,399,10,113,276,399
3394644,1550,460300,base+,completed,310.0,6.95,102,208,65,35,210,310,49,70,191,310,0,8,302,310,76,77,157,310,61,17,232,310
3394644,1550,460300,dpv1,completed,287.0,7.1,110,177,23,125,139,287,46,41,200,287,22,30,235,287,42,0,245,287,0,0,287,287
3394644,1550,460300,dpv2,completed,309.0,7.3,108,201,69,21,219,309,38,50,221,309,18,115,176,309,0,25,284,309,45,37,227,309
3394644,1550,460300,new-0.0,completed,258.0,6.8,146,112,5,20,233,258,1,7,250,258,28,30,200,258,29,29,200,258,0,34,224,258
3394644,1550,460300,new-0.5,completed,266.0,7.2,155,111,11,30,225,266,3,36,227,266,32,29,205,266,0,22,244,266,24,27,215,266
3394644,1550,460300,new-1.0,completed,282.0,7.45,152,130,57,0,225,282,46,52,184,282,16,53,213,282,18,0,264,282,0,58,224,282
3394644,1550,309704,base,completed,272.0,6.8,155,117,50,63,159,272,49,46,177,272,27,0,245,272,23,0,249,272,0,0,272,272
3394644,1550,309704,base+,completed,355.0,6.85,101,254,81,6,268,355,44,41,270,355,0,69,286,355,16,148,191,355,53,153,149,355
3394644,1550,309704,dpv1,completed,338.0,7.2,94,244,37,194,107,338,22,34,282,338,1,135,202,338,0,46,292,338,55,32,251,338
3394644,1550,309704,dpv2,completed,323.0,7.25,89,234,17,147,159,323,69,0,254,323,52,56,215,323,0,80,243,323,40,41,242,323
3394644,1550,309704,new-0.0,completed,266.0,6.95,171,95,37,21,208,266,25,15,226,266,0,11,255,266,39,0,227,266,35,30,201,266
3394644,1550,309704,new-0.5,completed,251.0,7.2,168,83,13,10,228,251,8,19,224,251,20,20,211,251,0,17,234,251,31,25,195,251
3394644,1550,309704,new-1.0,completed,294.0,7.3,127,167,39,10,245,294,12,61,221,294,25,54,215,294,37,49,208,294,0,52,242,294
3394644,1550,247588,base,completed,334.0,6.85,122,212,21,161,152,334,22,166,146,334,39,0,295,334,24,122,188,334,0,0,334,334
3394644,1550,247588,base+,completed,419.0,6.95,67,352,0,160,259,419,42,179,198,419,13,274,132,419,63,0,356,419,51,222,146,419
3394644,1550,247588,dpv1,completed,297.0,7.0,120,177,48,50,199,297,0,124,173,297,30,21,246,297,53,0,244,297,45,10,242,297
3394644,1550,247588,dpv2,completed,292.0,7.3,128,164,67,19,206,292,46,26,220,292,46,91,155,292,68,5,219,292,0,26,266,292
3394644,1550,247588,new-0.0,completed,246.0,6.8,170,76,11,23,212,246,34,17,195,246,0,18,228,246,34,0,212,246,9,10,227,246
3394644,1550,247588,new-0.5,completed,259.0,7.25,163,96,5,16,238,259,0,18,241,259,28,27,204,259,19,36,204,259,36,5,218,259
3394644,1550,247588,new-1.0,completed,293.0,7.3,130,163,14,0,279,293,0,73,220,293,25,58,210,293,27,62,204,293,38,66,189,293
3394644,1550,203195,base,completed,314.0,6.95,137,177,34,0,280,314,55,0,259,314,55,86,173,314,0,31,283,314,19,122,173,314
3394644,1550,203195,base+,completed,365.0,7.0,93,272,80,0,285,365,21,118,226,365,18,0,347,365,0,190,175,365,32,225,108,365
3394644,1550,203195,dpv1,completed,299.0,6.95,95,204,0,51,248,299,31,163,105,299,1,63,235,299,63,0,236,299,17,3,279,299
3394644,1550,203195,dpv2,completed,321.0,7.25,107,214,41,36,244,321,49,42,230,321,33,116,172,321,65,14,242,321,0,101,220,321
3394644,1550,203195,new-0.0,completed,249.0,6.8,164,85,9,7,233,249,16,0,233,249,0,28,221,249,27,25,197,249,11,21,217,249
3394644,1550,203195,new-0.5,completed,253.0,7.2,172,81,19,12,222,253,0,18,235,253,21,12,220,253,2,10,241,253,26,33,194,253
3394644,1550,203195,new-1.0,completed,288.0,7.25,141,147,23,0,265,288,0,94,194,288,4,18,266,288,30,65,193,288,35,55,198,288
3394644,1550,178029,base,completed,248.0,6.8,165,83,17,4,227,248,15,57,176,248,2,0,246,248,15,4,229,248,0,13,235,248
3394644,1550,178029,base+,completed,318.0,7.15,107,211,0,43,275,318,41,0,277,318,40,72,206,318,19,147,152,318,30,69,219,318
3394644,1550,178029,dpv1,completed,304.0,6.95,97,207,10,54,240,304,40,159,105,304,0,63,241,304,65,0,239,304,22,11,271,304
3394644,1550,178029,dpv2,completed,312.0,7.25,87,225,16,150,146,312,68,14,230,312,42,62,208,312,0,55,257,312,31,28,253,312
3394644,1550,178029,new-0.0,completed,249.0,7.0,171,78,17,23,209,249,33,7,209,249,0,14,235,249,23,3,223,249,14,7,228,249
3394644,1550,178029,new-0.5,completed,263.0,7.05,173,90,13,21,229,263,5,27,231,263,0,22,241,263,11,31,221,263,18,28,217,263
3394644,1550,178029,new-1.0,completed,250.0,7.1,174,76,0,0,250,250,3,16,231,250,29,10,211,250,9,18,223,250,30,13,207,250
3394644,1550,239735,base,completed,330.0,6.85,102,228,33,134,163,330,54,102,174,330,44,23,263,330,0,45,285,330,65,25,240,330
3394644,1550,239735,base+,completed,312.0,6.9,94,218,15,100,197,312,26,51,235,312,0,44,268,312,61,0,251,312,37,97,178,312
3394644,1550,239735,dpv1,completed,269.0,7.05,108,161,12,70,187,269,0,122,147,269,39,0,230,269,34,0,235,269,5,6,258,269
3394644,1550,239735,dpv2,completed,318.0,7.25,86,232,15,152,151,318,60,21,237,318,52,52,214,318,0,66,252,318,37,35,246,318
3394644,1550,239735,new-0.0,completed,250.0,6.85,162,88,20,20,210,250,22,0,228,250,30,17,203,250,0,15,235,250,27,26,197,250
3394644,1550,239735,new-0.5,completed,260.0,7.15,142,118,9,26,225,260,0,37,223,260,3,21,236,260,20,37,203,260,28,36,196,260
3394644,1550,239735,new-1.0,completed,264.0,7.45,151,113,4,0,260,264,37,49,178,264,43,42,179,264,0,0,264,264,7,57,200,264
3394644,1550,675528,base,completed,295.0,6.7,121,174,23,98,174,295,17,72,206,295,21,0,274,295,0,26,269,295,0,134,161,295
3394644,1550,675528,base+,completed,329.0,6.9,105,224,15,128,186,329,43,155,131,329,66,38,225,329,0,17,312,329,31,5,293,329
3394644,1550,675528,dpv1,completed,334.0,7.05,93,241,45,181,108,334,65,41,228,334,11,116,207,334,43,0,291,334,0,39,295,334
3394644,1550,675528,dpv2,completed,288.0,7.2,136,152,49,0,239,288,37,0,251,288,18,102,168,288,36,68,184,288,0,45,243,288
3394644,1550,675528,new-0.0,completed,268.0,6.95,160,108,39,23,206,268,0,19,249,268,31,13,224,268,41,8,219,268,32,33,203,268
3394644,1550,675528,new-0.5,completed,259.0,7.2,148,111,0,20,239,259,9,21,229,259,35,17,207,259,6,26,227,259,25,30,204,259
3394644,1550,675528,new-1.0,completed,300.0,7.3,126,174,0,11,289,300,9,58,233,300,38,67,195,300,39,61,200,300,34,52,214,300
3394644,1550,380692,base,completed,388.0,6.85,87,301,24,20,344,388,12,228,148,388,0,117,271,388,10,179,199,388,20,208,160,388
3394644,1550,380692,base+,completed,331.0,6.85,101,230,52,33,246,331,57,50,224,331,0,0,331,331,61,93,177,331,32,149,150,331
3394644,1550,380692,dpv1,completed,298.0,7.05,110,188,0,127,171,298,58,12,228,298,33,49,216,298,61,0,237,298,50,2,246,298
3394644,1550,380692,dpv2,completed,320.0,7.25,88,232,8,162,150,320,60,19,241,320,36,65,219,320,0,50,270,320,25,37,258,320
3394644,1550,380692,new-0.0,completed,255.0,7.0,166,89,0,23,232,255,3,21,231,255,1,29,225,255,23,0,232,255,19,25,211,255
3394644,1550,380692,new-0.5,completed,243.0,7.2,170,73,2,6,235,243,0,11,232,243,9,25,209,243,0,23,220,243,17,13,213,243
3394644,1550,380692,new-1.0,completed,293.0,7.1,129,164,60,17,216,293,58,42,193,293,0,17,276,293,53,31,209,293,28,17,248,293
8744595,1672,310811,base,completed,378.0,6.95,128,250,0,0,378,378,9,150,219,378,3,169,206,378,52,140,186,378,45,160,173,378
8744595,1672,310811,base+,completed,328.0,7.1,146,182,17,20,291,328,36,38,254,328,97,35,196,328,0,119,209,328,69,28,231,328
8744595,1672,310811,dpv1,completed,330.0,7.3,138,192,0,55,275,330,93,67,170,330,20,88,222,330,67,21,242,330,33,47,250,330
8744595,1672,310811,dpv2,completed,285.0,7.55,183,102,48,0,237,285,0,47,238,285,25,0,260,285,63,0,222,285,16,24,245,285
8744595,1672,310811,new-0.0,completed,279.0,7.55,207,72,62,0,217,279,56,8,215,279,0,40,239,279,49,0,230,279,21,2,256,279
8744595,1672,310811,new-0.5,completed,302.0,7.45,161,141,79,0,223,302,79,14,209,302,16,12,274,302,0,88,214,302,36,32,234,302
8744595,1672,310811,new-1.0,completed,289.0,7.5,175,114,65,0,224,289,53,27,209,289,0,54,235,289,27,0,262,289,21,12,256,289
8744595,1672,208428,base,completed,287.0,7.15,175,112,75,27,185,287,0,42,245,287,20,10,257,287,53,0,234,287,14,0,273,287
8744595,1672,208428,base+,completed,302.0,7.2,174,128,84,2,216,302,0,49,253,302,34,0,268,302,68,18,216,302,23,36,243,302
8744595,1672,208428,dpv1,completed,348.0,7.35,147,201,65,47,236,348,16,77,255,348,0,157,191,348,45,56,247,348,95,0,253,348
8744595,1672,208428,dpv2,completed,313.0,7.4,162,151,84,0,229,313,0,96,217,313,33,5,275,313,24,45,244,313,78,1,234,313
8744595,1672,208428,new-0.0,completed,257.0,7.6,204,53,44,0,213,257,19,9,229,257,0,21,236,257,17,0,240,257,35,0,222,257
8744595,1672,208428,new-0.5,completed,298.0,7.6,148,150,80,5,213,298,39,37,222,298,50,0,248,298,0,98,200,298,20,0,278,298
8744595,1672,208428,new-1.0,completed,283.0,7.65,190,93,40,0,243,283,46,32,205,283,43,0,240,283,0,22,261,283,17,15,251,283
8744595,1672,460300,base,completed,417.0,6.65,127,290,36,239,142,417,19,191,207,417,38,133,246,417,0,157,260,417,42,0,375,417
8744595,1672,460300,base+,completed,293.0,7.1,167,126,0,6,287,293,55,33,205,293,56,34,203,293,40,9,244,293,19,19,255,293
8744595,1672,460300,dpv1,completed,358.0,7.4,146,212,78,34,246,358,0,147,211,358,21,93,244,358,109,1,248,358,46,50,262,358
8744595,1672,460300,dpv2,completed,320.0,7.45,165,155,0,91,229,320,19,34,267,320,46,27,247,320,100,0,220,320,65,0,255,320
8744595,1672,460300,new-0.0,completed,277.0,7.35,203,74,49,0,228,277,0,32,245,277,30,0,247,277,43,19,215,277,23,0,254,277
8744595,1672,460300,new-0.5,completed,314.0,7.55,154,160,87,0,227,314,0,100,214,314,44,17,253,314,82,7,225,314,19,24,271,314
8744595,1672,460300,new-1.0,completed,297.0,7.65,200,97,39,0,258,297,62,26,209,297,58,0,239,297,0,44,253,297,20,7,270,297
8744595,1672,309704,base,completed,314.0,7.0,137,177,59,69,186,314,52,6,256,314,74,0,240,314,19,0,295,314,0,83,231,314
8744595,1672,309704,base+,completed,310.0,7.3,135,175,66,0,244,310,23,97,190,310,17,4,289,310,0,82,228,310,56,0,254,310
8744595,1672,309704,dpv1,completed,352.0,7.15,154,198,111,0,241,352,19,78,255,352,86,51,215,352,0,127,225,352,51,42,259,352
8744595,1672,309704,dpv2,completed,318.0,7.45,127,191,69,17,232,318,0,50,268,318,32,90,196,318,80,11,227,318,18,39,261,318
8744595,1672,309704,new-0.0,completed,265.0,7.3,208,57,52,0,213,265,57,0,208,265,41,0,224,265,20,0,245,265,0,24,241,265
8744595,1672,309704,new-0.5,completed,318.0,7.5,148,170,102,0,216,318,0,99,219,318,22,15,281,318,92,10,216,318,50,35,233,318
8744595,1672,309704,new-1.0,completed,293.0,7.5,197,96,0,0,293,293,60,25,208,293,29,21,243,293,48,0,245,293,70,1,222,293
8744595,1672,247588,base,completed,324.0,7.15,130,194,45,4,275,324,16,0,308,324,74,7,243,324,96,98,130,324,0,104,220,324
8744595,1672,247588,base+,completed,306.0,7.0,128,178,46,80,180,306,28,26,252,306,0,20,286,306,49,0,257,306,42,17,247,306
8744595,1672,247588,dpv1,completed,326.0,7.2,149,177,38,0,288,326,86,83,157,326,52,48,226,326,16,52,258,326,0,100,226,326
8744595,1672,247588,dpv2,completed,288.0,7.45,163,125,0,66,222,288,19,31,238,288,19,1,268,288,76,0,212,288,62,3,223,288
8744595,1672,247588,new-0.0,completed,267.0,7.4,202,65,0,31,236,267,35,13,219,267,18,0,249,267,39,0,228,267,52,0,215,267
8744595,1672,247588,new-0.5,completed,285.0,7.5,144,141,22,51,212,285,56,0,229,285,0,20,265,285,20,67,198,285,19,1,265,285
8744595,1672,247588,new-1.0,completed,280.0,7.65,198,82,54,0,226,280,55,26,199,280,56,0,224,280,0,31,249,280,18,0,262,280
8744595,1672,203195,base,completed,332.0,6.9,142,190,91,23,218,332,20,0,312,332,32,61,239,332,0,142,190,332,74,0,258,332
8744595,1672,203195,base+,completed,309.0,6.85,164,145,0,62,247,309,0,95,214,309,9,59,241,309,41,43,225,309,25,0,284,309
8744595,1672,203195,dpv1,completed,342.0,7.35,149,193,60,50,232,342,0,122,220,342,28,88,226,342,18,48,276,342,93,0,249,342
8744595,1672,203195,dpv2,completed,311.0,7.5,156,155,78,0,233,311,0,87,224,311,18,25,268,311,93,0,218,311,37,31,243,311
8744595,1672,203195,new-0.0,completed,279.0,7.3,204,75,56,0,223,279,0,42,237,279,59,0,220,279,17,16,246,279,34,0,245,279
8744595,1672,203195,new-0.5,completed,302.0,7.5,161,141,35,3,264,302,0,88,214,302,82,0,220,302,73,20,209,302,19,23,260,302
8744595,1672,203195,new-1.0,completed,280.0,7.55,170,110,43,0,237,280,18,35,227,280,0,55,225,280,9,2,269,280,45,0,235,280
8744595,1672,178029,base,completed,343.0,6.9,139,204,0,135,208,343,15,107,221,343,7,0,336,343,35,88,220,343,13,103,227,343
8744595,1672,178029,base+,completed,311.0,7.05,161,150,76,11,224,311,0,44,267,311,18,17,276,311,84,35,192,311,51,8,252,311
8744595,1672,178029,dpv1,completed,343.0,7.35,142,201,60,43,240,343,94,74,175,343,0,147,196,343,31,66,246,343,20,0,323,343
8744595,1672,178029,dpv2,completed,289.0,7.5,132,157,8,12,269,289,19,37,233,289,0,95,194,289,47,15,227,289,26,0,263,289
8744595,1672,178029,new-0.0,completed,299.0,7.5,176,123,18,25,256,299,66,0,233,299,35,0,264,299,89,0,210,299,0,67,232,299
8744595,1672,178029,new-0.5,completed,312.0,7.5,174,138,50,1,261,312,87,3,222,312,94,0,218,312,21,32,259,312,0,77,235,312
8744595,1672,178029,new-1.0,completed,275.0,7.7,174,101,40,0,235,275,24,40,211,275,38,0,237,275,0,0,275,275,4,37,234,275
8744595,1672,239735,base,completed,296.0,6.7,174,122,0,17,279,296,42,0,254,296,54,43,199,296,41,12,243,296,58,0,238,296
8744595,1672,239735,base+,completed,347.0,6.7,122,225,19,76,252,347,68,59,220,347,0,155,192,347,38,1,308,347,95,46,206,347
8744595,1672,239735,dpv1,completed,337.0,7.15,148,189,0,71,266,337,18,85,234,337,74,58,205,337,95,55,187,337,46,48,243,337
8744595,1672,239735,dpv2,completed,307.0,7.5,103,204,37,38,232,307,0,50,257,307,24,107,176,307,35,57,215,307,41,21,245,307
8744595,1672,239735,new-0.0,completed,254.0,7.45,205,49,32,0,222,254,30,0,224,254,16,0,238,254,49,0,205,254,0,12,242,254
8744595,1672,239735,new-0.5,completed,272.0,7.45,208,64,55,0,217,272,55,0,217,272,0,45,227,272,19,0,253,272,33,0,239,272
8744595,1672,239735,new-1.0,completed,266.0,7.5,172,94,55,0,211,266,32,26,208,266,0,37,229,266,8,0,258,266,16,13,237,266
8744595,1672,675528,base,completed,304.0,7.0,138,166,58,53,193,304,0,0,304,304,37,71,196,304,22,64,218,304,8,7,289,304
8744595,1672,675528,base+,completed,295.0,6.8,190,105,20,11,264,295,70,0,225,295,69,0,226,295,0,74,221,295,49,0,246,295
8744595,1672,675528,dpv1,completed,350.0,7.5,145,205,67,43,240,350,35,75,240,350,20,102,228,350,94,0,256,350,0,118,232,350
8744595,1672,675528,dpv2,completed,322.0,7.5,161,161,79,6,237,322,21,34,267,322,0,98,224,322,99,0,223,322,40,32,250,322
8744595,1672,675528,new-0.0,completed,297.0,7.5,191,106,80,0,217,297,63,0,234,297,57,2,238,297,0,83,214,297,20,0,277,297
8744595,1672,675528,new-0.5,completed,324.0,7.65,151,173,22,45,257,324,71,15,238,324,45,8,271,324,104,0,220,324,0,96,228,324
8744595,1672,675528,new-1.0,completed,285.0,7.65,195,90,41,0,244,285,46,31,208,285,40,0,245,285,0,30,255,285,17,12,256,285
8744595,1672,380692,base,completed,340.0,6.85,140,200,0,0,340,340,43,12,285,340,64,101,175,340,18,166,156,340,34,95,211,340
8744595,1672,380692,base+,completed,285.0,6.95,153,132,56,0,229,285,23,23,239,285,7,53,225,285,23,21,241,285,0,38,247,285
8744595,1672,380692,dpv1,completed,345.0,7.4,138,207,72,27,246,345,17,84,244,345,0,159,186,345,95,0,250,345,32,55,258,345
8744595,1672,380692,dpv2,completed,339.0,7.6,132,207,82,28,229,339,32,3,304,339,19,100,220,339,96,8,235,339,0,110,229,339
8744595,1672,380692,new-0.0,completed,293.0,7.35,197,96,46,16,231,293,0,47,246,293,80,0,213,293,69,0,224,293,20,0,273,293
8744595,1672,380692,new-0.5,completed,302.0,7.5,158,144,32,9,261,302,0,87,215,302,77,0,225,302,76,13,213,302,18,24,260,302
8744595,1672,380692,new-1.0,completed,302.0,7.7,181,121,61,0,241,302,60,32,210,302,71,0,231,302,0,42,260,302,19,18,265,302
7974760,1538,310811,base,completed,286.0,7.15,131,155,73,5,208,286,3,69,214,286,31,0,255,286,0,104,182,286,17,35,234,286
7974760,1538,310811,base+,completed,275.0,7.1,170,105,0,0,275,275,25,38,212,275,42,13,220,275,46,45,184,275,50,20,205,275
7974760,1538,310811,dpv1,completed,279.0,7.25,129,150,57,34,188,279,0,0,279,279,26,57,196,279,58,56,165,279,23,0,256,279
7974760,1538,310811,dpv2,completed,276.0,7.55,162,114,55,22,199,276,39,34,203,276,0,0,276,276,28,9,239,276,54,58,164,276
7974760,1538,310811,new-0.0,completed,238.0,7.2,195,43,17,11,210,238,0,0,238,238,6,4,228,238,28,6,204,238,21,0,217,238
7974760,1538,310811,new-0.5,completed,242.0,7.85,189,53,16,0,226,242,26,0,216,242,16,17,209,242,36,0,206,242,0,0,242,242
7974760,1538,310811,new-1.0,completed,247.0,7.75,166,81,37,0,210,247,34,15,198,247,12,0,235,247,33,18,196,247,0,12,235,247
7974760,1538,208428,base,completed,253.0,6.9,197,56,26,0,227,253,11,19,223,253,37,0,216,253,0,17,236,253,32,0,221,253
7974760,1538,208428,base+,completed,282.0,7.0,153,129,60,6,216,282,0,0,282,282,28,37,217,282,42,19,221,282,53,63,166,282
7974760,1538,208428,dpv1,completed,286.0,7.35,177,109,56,43,187,286,46,13,227,286,19,46,221,286,65,5,216,286,0,0,286,286
7974760,1538,208428,dpv2,completed,275.0,7.4,163,112,28,28,219,275,0,0,275,275,49,15,211,275,20,42,213,275,50,41,184,275
7974760,1538,208428,new-0.0,completed,238.0,7.35,191,47,31,9,198,238,0,0,238,238,19,5,214,238,23,5,210,238,18,0,220,238
7974760,1538,208428,new-0.5,completed,239.0,7.7,180,59,42,0,197,239,0,0,239,239,14,0,225,239,11,9,219,239,25,17,197,239
7974760,1538,208428,new-1.0,completed,250.0,7.75,162,88,29,0,221,250,36,14,200,250,1,0,249,250,26,31,193,250,0,12,238,250
7974760,1538,460300,base,completed,286.0,7.15,116,170,18,0,268,286,37,0,249,286,18,31,237,286,0,93,193,286,23,100,163,286
7974760,1538,460300,base+,completed,298.0,7.1,141,157,54,69,175,298,24,56,218,298,43,41,214,298,56,27,215,298,0,0,298,298
7974760,1538,460300,dpv1,completed,272.0,7.25,156,116,51,24,197,272,44,39,189,272,21,41,210,272,27,0,245,272,0,8,264,272
7974760,1538,460300,dpv2,completed,285.0,7.35,159,126,48,21,216,285,50,58,177,285,0,0,285,285,25,38,222,285,40,43,202,285
7974760,1538,460300,new-0.0,completed,249.0,7.3,181,68,27,12,210,249,26,2,221,249,20,18,211,249,0,0,249,249,37,13,199,249
7974760,1538,460300,new-0.5,completed,255.0,7.55,191,64,0,0,255,255,21,17,217,255,46,18,191,255,16,0,239,255,45,0,210,255
7974760,1538,460300,new-1.0,completed,252.0,7.75,177,75,40,22,190,252,36,0,216,252,23,12,217,252,4,6,242,252,0,12,240,252
7974760,1538,309704,base,completed,278.0,7.35,156,122,52,61,165,278,36,35,207,278,54,0,224,278,0,0,278,278,32,0,246,278
7974760,1538,309704,base+,completed,289.0,7.0,169,120,0,0,289,289,52,8,229,289,63,25,201,289,32,36,221,289,61,37,191,289
7974760,1538,309704,dpv1,completed,283.0,7.3,138,145,48,15,220,283,0,0,283,283,57,49,177,283,56,65,162,283,25,6,252,283
7974760,1538,309704,dpv2,completed,271.0,7.4,160,111,0,0,271,271,34,21,216,271,26,46,199,271,54,4,213,271,48,50,173,271
7974760,1538,309704,new-0.0,completed,231.0,7.15,190,41,33,0,198,231,22,0,209,231,14,0,217,231,0,8,223,231,0,0,231,231
7974760,1538,309704,new-0.5,completed,241.0,7.95,191,50,15,5,221,241,0,0,241,241,45,0,196,241,33,1,207,241,8,0,233,241
7974760,1538,309704,new-1.0,completed,240.0,7.7,190,50,15,0,225,240,31,3,206,240,22,0,218,240,0,17,223,240,22,2,216,240
7974760,1538,247588,base,completed,245.0,6.8,166,79,20,6,219,245,5,0,240,245,51,11,183,245,0,0,245,245,1,17,227,245
7974760,1538,247588,base+,completed,299.0,7.2,122,177,26,95,178,299,37,40,222,299,60,33,206,299,0,0,299,299,51,41,207,299
7974760,1538,247588,dpv1,completed,270.0,7.05,140,130,0,0,270,270,39,36,195,270,19,42,209,270,44,49,177,270,8,0,262,270
7974760,1538,247588,dpv2,completed,262.0,7.55,169,93,29,18,215,262,37,32,193,262,19,29,214,262,41,13,208,262,0,0,262,262
7974760,1538,247588,new-0.0,completed,231.0,7.25,198,33,0,0,231,231,20,2,209,231,16,1,214,231,23,0,208,231,11,7,213,231
7974760,1538,247588,new-0.5,completed,251.0,7.65,181,70,50,0,201,251,16,20,215,251,29,19,203,251,20,0,231,251,0,0,251,251
7974760,1538,247588,new-1.0,completed,228.0,7.8,198,30,0,1,227,228,9,0,219,228,12,0,216,228,21,8,199,228,0,0,228,228
7974760,1538,203195,base,completed,381.0,6.8,93,288,20,187,174,381,41,10,330,381,0,147,234,381,25,137,219,381,43,196,142,381
7974760,1538,203195,base+,completed,281.0,7.2,157,124,52,37,192,281,47,27,207,281,65,21,195,281,20,54,207,281,0,0,281,281
7974760,1538,203195,dpv1,completed,280.0,6.95,142,138,64,17,199,280,55,71,154,280,20,0,260,280,0,0,280,280,24,44,212,280
7974760,1538,203195,dpv2,completed,283.0,7.5,153,130,50,31,202,283,0,10,273,283,58,36,189,283,61,17,205,283,25,29,229,283
7974760,1538,203195,new-0.0,completed,240.0,7.2,171,69,43,0,197,240,8,20,212,240,36,6,198,240,0,0,240,240,14,0,226,240
7974760,1538,203195,new-0.5,completed,232.0,7.7,198,34,3,0,229,232,0,0,232,232,26,8,198,232,24,0,208,232,13,0,219,232
7974760,1538,203195,new-1.0,completed,250.0,7.7,183,67,27,0,223,250,8,0,242,250,45,9,196,250,45,3,202,250,0,10,240,250
7974760,1538,178029,base,completed,302.0,7.1,145,157,0,110,192,302,37,0,265,302,12,71,219,302,24,107,171,302,53,0,249,302
7974760,1538,178029,base+,completed,307.0,7.05,146,161,0,0,307,307,46,52,209,307,51,70,186,307,32,38,237,307,57,68,182,307
7974760,1538,178029,dpv1,completed,295.0,7.1,144,151,0,0,295,295,51,54,190,295,55,23,217,295,22,51,222,295,44,61,190,295
7974760,1538,178029,dpv2,completed,314.0,7.2,161,153,29,57,228,314,63,73,178,314,79,40,195,314,0,0,314,314,61,46,207,314
7974760,1538,178029,new-0.0,completed,244.0,7.1,192,52,0,0,244,244,24,6,214,244,1,14,229,244,5,6,233,244,32,0,212,244
7974760,1538,178029,new-0.5,completed,244.0,7.95,190,54,20,9,215,244,0,7,237,244,14,0,230,244,28,12,204,244,35,0,209,244
7974760,1538,178029,new-1.0,completed,245.0,7.5,175,70,0,0,245,245,20,29,196,245,21,8,216,245,1,0,244,245,8,12,225,245
7974760,1538,239735,base,completed,268.0,6.9,145,123,25,0,243,268,0,55,213,268,37,0,231,268,33,0,235,268,14,43,211,268
7974760,1538,239735,base+,completed,279.0,7.15,156,123,0,0,279,279,26,41,212,279,60,11,208,279,47,14,218,279,48,63,168,279
7974760,1538,239735,dpv1,completed,272.0,7.1,136,136,0,0,272,272,49,34,189,272,55,0,217,272,39,51,182,272,27,43,202,272
7974760,1538,239735,dpv2,completed,282.0,7.4,152,130,49,26,207,282,43,71,168,282,0,0,282,282,25,32,225,282,40,46,196,282
7974760,1538,239735,new-0.0,completed,241.0,7.15,172,69,26,7,208,241,28,0,213,241,16,26,199,241,0,0,241,241,13,15,213,241
7974760,1538,239735,new-0.5,completed,242.0,7.65,179,63,25,13,204,242,46,0,196,242,16,17,209,242,15,0,227,242,0,0,242,242
7974760,1538,239735,new-1.0,completed,243.0,7.7,175,68,33,25,185,243,43,3,197,243,21,0,222,243,20,0,223,243,0,0,243,243
7974760,1538,675528,base,completed,249.0,6.8,161,88,44,0,205,249,0,0,249,249,7,31,211,249,5,0,244,249,17,44,188,249
7974760,1538,675528,base+,completed,270.0,6.85,185,85,0,0,270,270,23,27,220,270,42,7,221,270,50,29,191,270,46,3,221,270
7974760,1538,675528,dpv1,completed,287.0,7.35,149,138,51,17,219,287,25,32,230,287,0,0,287,287,52,25,210,287,53,75,159,287
7974760,1538,675528,dpv2,completed,278.0,7.5,156,122,0,0,278,278,39,77,162,278,19,19,240,278,42,25,211,278,31,38,209,278
7974760,1538,675528,new-0.0,completed,237.0,7.45,192,45,24,0,213,237,15,17,205,237,9,0,228,237,21,4,212,237,0,0,237,237
7974760,1538,675528,new-0.5,completed,247.0,7.7,181,66,11,18,218,247,7,0,240,247,30,20,197,247,0,0,247,247,46,0,201,247
7974760,1538,675528,new-1.0,completed,239.0,7.8,204,35,13,0,226,239,6,0,233,239,16,6,217,239,29,5,205,239,0,0,239,239
7974760,1538,380692,base,completed,233.0,6.8,187,46,5,0,228,233,0,9,224,233,14,0,219,233,33,4,196,233,3,0,230,233
7974760,1538,380692,base+,completed,283.0,7.05,167,116,0,0,283,283,49,45,189,283,59,23,201,283,29,61,193,283,48,27,208,283
7974760,1538,380692,dpv1,completed,279.0,7.3,170,109,59,18,202,279,49,42,188,279,21,45,213,279,43,9,227,279,0,0,279,279
7974760,1538,380692,dpv2,completed,292.0,7.35,152,140,28,39,225,292,0,0,292,292,59,40,193,292,62,20,210,292,52,41,199,292
7974760,1538,380692,new-0.0,completed,246.0,7.4,169,77,0,13,233,246,21,7,218,246,50,0,196,246,40,14,192,246,12,0,234,246
7974760,1538,380692,new-0.5,completed,252.0,7.85,178,74,54,0,198,252,15,20,217,252,23,0,229,252,28,19,205,252,0,0,252,252
7974760,1538,380692,new-1.0,completed,251.0,7.9,165,86,30,34,187,251,16,18,217,251,0,0,251,251,40,0,211,251,7,0,244,251
4372389,1855,310811,base,completed,339.0,7.0,159,180,20,34,285,339,9,34,296,339,0,0,339,339,81,0,258,339,31,120,188,339
4372389,1855,310811,base+,completed,296.0,7.3,225,71,20,0,276,296,0,0,296,296,34,0,262,296,4,0,292,296,71,0,225,296
4372389,1855,310811,dpv1,completed,310.0,7.45,139,171,53,0,257,310,11,12,287,310,0,36,274,310,8,81,221,310,26,0,284,310
4372389,1855,310811,dpv2,completed,312.0,7.6,228,84,61,10,241,312,68,0,244,312,42,0,270,312,24,6,282,312,0,0,312,312
4372389,1855,310811,new-0.0,completed,292.0,7.35,197,95,3,0,289,292,0,0,292,292,31,0,261,292,38,0,254,292,22,57,213,292
4372389,1855,310811,new-0.5,completed,283.0,7.95,227,56,42,2,239,283,19,0,264,283,53,0,230,283,0,1,282,283,10,0,273,283
4372389,1855,310811,new-1.0,completed,303.0,8.05,208,95,0,1,302,303,30,1,272,303,45,1,257,303,7,34,262,303,58,0,245,303
4372389,1855,208428,base,completed,335.0,7.3,143,192,0,58,277,335,36,45,254,335,5,0,330,335,2,0,333,335,88,83,164,335
4372389,1855,208428,base+,completed,304.0,6.7,216,88,52,0,252,304,24,0,280,304,0,35,269,304,27,0,277,304,25,1,278,304
4372389,1855,208428,dpv1,completed,314.0,7.45,150,164,14,0,300,314,0,19,295,314,2,27,285,314,54,69,191,314,25,12,277,314
4372389,1855,208428,dpv2,completed,299.0,7.5,225,74,26,0,273,299,32,20,247,299,54,0,245,299,31,0,268,299,0,0,299,299
4372389,1855,208428,new-0.0,completed,294.0,7.55,237,57,23,0,271,294,56,0,238,294,42,0,252,294,27,2,265,294,0,0,294,294
4372389,1855,208428,new-0.5,completed,284.0,8.0,230,54,0,1,283,284,46,0,238,284,49,4,231,284,0,0,284,284,8,0,276,284
4372389,1855,208428,new-1.0,completed,321.0,7.9,198,123,0,0,321,321,37,0,284,321,58,5,258,321,70,53,198,321,25,0,296,321
4372389,1855,460300,base,completed,344.0,7.1,87,257,0,0,344,344,54,0,290,344,15,179,150,344,12,89,243,344,23,0,321,344
4372389,1855,460300,base+,completed,315.0,6.85,189,126,0,9,306,315,16,0,299,315,20,48,247,315,26,0,289,315,45,31,239,315
4372389,1855,460300,dpv1,completed,354.0,7.15,106,248,0,0,354,354,20,33,301,354,60,32,262,354,66,62,226,354,35,107,212,354
4372389,1855,460300,dpv2,completed,303.0,7.65,234,69,26,7,270,303,53,0,250,303,37,0,266,303,42,9,252,303,0,0,303,303
4372389,1855,460300,new-0.0,completed,279.0,7.15,250,29,22,0,257,279,18,0,261,279,29,0,250,279,4,0,275,279,0,0,279,279
4372389,1855,460300,new-0.5,completed,289.0,8.0,223,66,13,0,276,289,0,0,289,289,14,0,275,289,24,15,250,289,51,0,238,289
4372389,1855,460300,new-1.0,completed,309.0,7.9,193,116,34,0,275,309,21,0,288,309,0,13,296,309,8,54,247,309,59,0,250,309
4372389,1855,309704,base,completed,333.0,7.0,191,142,45,65,223,333,45,12,276,333,21,0,312,333,0,59,274,333,18,77,238,333
4372389,1855,309704,base+,completed,341.0,7.25,198,143,67,53,221,341,44,3,294,341,47,0,294,341,0,37,304,341,90,0,251,341
4372389,1855,309704,dpv1,completed,333.0,7.15,152,181,70,0,263,333,25,18,290,333,62,50,221,333,0,61,272,333,37,0,296,333
4372389,1855,309704,dpv2,completed,308.0,7.45,214,94,38,0,270,308,62,0,246,308,0,0,308,308,11,13,284,308,72,9,227,308
4372389,1855,309704,new-0.0,completed,290.0,7.25,231,59,24,3,263,290,56,0,234,290,34,0,256,290,0,0,290,290,17,0,273,290
4372389,1855,309704,new-0.5,completed,292.0,8.1,226,66,13,0,279,292,17,0,275,292,65,1,226,292,0,0,292,292,54,0,238,292
4372389,1855,309704,new-1.0,completed,308.0,8.2,216,92,0,0,308,308,46,0,262,308,21,0,287,308,51,12,245,308,80,0,228,308
4372389,1855,247588,base,completed,443.0,6.85,83,360,23,97,323,443,50,200,193,443,0,292,151,443,15,189,239,443,3,0,440,443
4372389,1855,247588,base+,completed,332.0,7.05,117,215,69,0,263,332,42,146,144,332,0,0,332,332,20,0,312,332,35,1,296,332
4372389,1855,247588,dpv1,completed,322.0,7.45,143,179,25,0,297,322,45,23,254,322,22,41,259,322,67,71,184,322,0,0,322,322
4372389,1855,247588,dpv2,completed,296.0,7.45,215,81,41,0,255,296,29,22,245,296,51,0,245,296,0,0,296,296,59,0,237,296
4372389,1855,247588,new-0.0,completed,285.0,7.4,194,91,16,0,269,285,0,0,285,285,29,0,256,285,6,47,232,285,44,0,241,285
4372389,1855,247588,new-0.5,completed,283.0,7.8,225,58,1,0,282,283,0,0,283,283,15,0,268,283,32,7,244,283,51,0,232,283
4372389,1855,247588,new-1.0,completed,301.0,7.9,193,108,0,7,294,301,19,0,282,301,30,19,252,301,10,53,238,301,48,0,253,301
4372389,1855,203195,base,completed,331.0,6.85,165,166,0,39,292,331,69,0,262,331,36,0,295,331,21,0,310,331,45,86,200,331
4372389,1855,203195,base+,completed,341.0,7.35,191,150,66,14,261,341,41,0,300,341,90,0,251,341,75,46,220,341,0,0,341,341
4372389,1855,203195,dpv1,completed,339.0,7.3,135,204,58,0,281,339,34,49,256,339,27,35,277,339,0,66,273,339,64,0,275,339
4372389,1855,203195,dpv2,completed,284.0,7.55,231,53,13,0,271,284,43,0,241,284,16,10,258,284,27,0,257,284,0,0,284,284
4372389,1855,203195,new-0.0,completed,285.0,7.25,244,41,24,0,261,285,34,0,251,285,5,0,280,285,0,3,282,285,38,0,247,285
4372389,1855,203195,new-0.5,completed,293.0,8.0,226,67,12,0,281,293,0,0,293,293,29,0,264,293,35,11,247,293,56,0,237,293
4372389,1855,203195,new-1.0,completed,322.0,7.9,189,133,0,12,310,322,36,0,286,322,46,0,276,322,35,50,237,322,79,0,243,322
4372389,1855,178029,base,completed,347.0,7.2,106,241,66,0,281,347,26,0,321,347,59,111,177,347,0,0,347,347,38,104,205,347
4372389,1855,178029,base+,completed,347.0,7.1,105,242,22,0,325,347,52,141,154,347,80,0,267,347,48,39,260,347,0,0,347,347
4372389,1855,178029,dpv1,completed,328.0,7.25,150,178,57,0,271,328,63,1,264,328,34,50,244,328,0,64,264,328,32,0,296,328
4372389,1855,178029,dpv2,completed,288.0,7.4,238,50,19,0,269,288,34,0,254,288,15,9,264,288,23,7,258,288,0,0,288,288
4372389,1855,178029,new-0.0,completed,312.0,7.5,225,87,61,0,251,312,64,0,248,312,76,0,236,312,28,11,273,312,0,0,312,312
4372389,1855,178029,new-0.5,completed,279.0,8.0,237,42,2,0,277,279,41,0,238,279,0,0,279,279,2,0,277,279,42,0,237,279
4372389,1855,178029,new-1.0,completed,318.0,7.9,197,121,30,0,288,318,33,0,285,318,0,36,282,318,27,46,245,318,63,0,255,318
4372389,1855,239735,base,completed,369.0,7.25,166,203,49,0,320,369,10,79,280,369,0,90,279,369,25,151,193,369,26,61,282,369
4372389,1855,239735,base+,completed,301.0,7.1,204,97,22,20,259,301,77,0,224,301,50,3,248,301,0,0,301,301,25,0,276,301
4372389,1855,239735,dpv1,completed,334.0,7.15,122,212,47,22,265,334,66,62,206,334,68,0,266,334,0,66,268,334,41,4,289,334
4372389,1855,239735,dpv2,completed,299.0,7.55,211,88,0,4,295,299,21,0,278,299,20,34,245,299,28,12,259,299,43,0,256,299
4372389,1855,239735,new-0.0,completed,290.0,7.15,230,60,38,2,250,290,57,0,233,290,54,1,235,290,0,0,290,290,29,0,261,290
4372389,1855,239735,new-0.5,completed,291.0,8.0,229,62,0,0,291,291,27,0,264,291,62,0,229,291,46,0,245,291,12,0,279,291
4372389,1855,239735,new-1.0,completed,302.0,7.9,182,120,0,9,293,302,34,0,268,302,35,0,267,302,23,49,230,302,62,0,240,302
4372389,1855,675528,base,completed,328.0,7.05,161,167,31,42,255,328,28,0,300,328,82,62,184,328,0,0,328,328,55,4,269,328
4372389,1855,675528,base+,completed,330.0,7.05,195,135,52,6,272,330,55,30,245,330,13,32,285,330,0,0,330,330,45,15,270,330
4372389,1855,675528,dpv1,completed,342.0,7.35,117,225,1,0,341,342,51,28,263,342,16,118,208,342,0,66,276,342,41,23,278,342
4372389,1855,675528,dpv2,completed,291.0,7.4,224,67,0,22,269,291,7,0,284,291,54,0,237,291,17,0,274,291,20,7,264,291
4372389,1855,675528,new-0.0,completed,281.0,7.55,241,40,15,0,266,281,40,0,241,281,36,0,245,281,23,0,258,281,0,0,281,281
4372389,1855,675528,new-0.5,completed,281.0,8.0,233,48,9,0,272,281,48,0,233,281,5,0,276,281,0,0,281,281,44,0,237,281
4372389,1855,675528,new-1.0,completed,303.0,8.2,211,92,0,0,303,303,35,4,264,303,1,7,295,303,44,19,240,303,64,0,239,303
4372389,1855,380692,base,completed,395.0,6.95,126,269,80,0,315,395,53,163,179,395,43,189,163,395,0,0,395,395,26,97,272,395
4372389,1855,380692,base+,completed,327.0,7.15,152,175,8,34,285,327,55,16,256,327,4,0,323,327,0,21,306,327,27,116,184,327
4372389,1855,380692,dpv1,completed,334.0,7.2,106,228,5,0,329,334,53,92,189,334,29,25,280,334,0,58,276,334,1,61,272,334
4372389,1855,380692,dpv2,completed,296.0,7.65,235,61,0,6,290,296,55,0,241,296,25,0,271,296,16,6,274,296,51,0,245,296
4372389,1855,380692,new-0.0,completed,295.0,7.15,238,57,0,0,295,295,51,0,244,295,57,0,238,295,37,0,258,295,38,0,257,295
4372389,1855,380692,new-0.5,completed,289.0,8.0,213,76,0,0,289,289,10,0,279,289,23,0,266,289,36,14,239,289,62,0,227,289
4372389,1855,380692,new-1.0,completed,314.0,8.2,210,104,0,0,314,314,42,0,272,314,19,1,294,314,57,28,229,314,75,0,239,314
1390799,1872,310811,base,completed,337.0,6.7,134,203,63,0,274,337,44,0,293,337,33,31,273,337,0,130,207,337,15,6,316,337
1390799,1872,310811,base+,completed,313.0,6.65,172,141,37,0,276,313,48,80,185,313,0,13,300,313,30,0,283,313,18,0,295,313
1390799,1872,310811,dpv1,completed,341.0,6.95,183,158,41,0,300,341,74,74,193,341,21,61,259,341,0,2,339,341,62,0,279,341
1390799,1872,310811,dpv2,completed,349.0,7.4,145,204,25,134,190,349,46,29,274,349,34,0,315,349,0,0,349,349,26,141,182,349
1390799,1872,310811,new-0.0,completed,286.0,6.8,262,24,0,0,286,286,20,0,266,286,17,0,269,286,23,0,263,286,24,0,262,286
1390799,1872,310811,new-0.5,completed,293.0,7.35,232,61,61,0,232,293,0,0,293,293,34,0,259,293,23,0,270,293,4,0,289,293
1390799,1872,310811,new-1.0,completed,325.0,7.7,199,126,0,0,325,325,85,0,240,325,75,0,250,325,29,0,296,325,49,41,235,325
1390799,1872,208428,base,completed,352.0,6.75,169,183,23,81,248,352,0,138,214,352,66,0,286,352,16,62,274,352,20,0,332,352
1390799,1872,208428,base+,completed,349.0,6.75,165,184,10,0,339,349,3,149,197,349,0,0,349,349,23,117,209,349,35,50,264,349
1390799,1872,208428,dpv1,completed,325.0,6.95,188,137,51,81,193,325,56,0,269,325,0,27,298,325,37,0,288,325,22,0,303,325
1390799,1872,208428,dpv2,completed,417.0,7.4,158,259,80,136,201,417,0,204,213,417,20,131,266,417,88,0,329,417,63,0,354,417
1390799,1872,208428,new-0.0,completed,290.0,6.9,249,41,41,0,249,290,13,0,277,290,23,0,267,290,20,0,270,290,0,7,283,290
1390799,1872,208428,new-0.5,completed,301.0,7.3,253,48,37,0,264,301,20,0,281,301,48,0,253,301,33,0,268,301,0,0,301,301
1390799,1872,208428,new-1.0,completed,330.0,7.7,201,129,0,0,330,330,83,0,247,330,82,0,248,330,24,0,306,330,48,46,236,330
1390799,1872,460300,base,completed,391.0,7.0,134,257,19,0,372,391,32,86,273,391,57,2,332,391,9,151,231,391,0,236,155,391
1390799,1872,460300,base+,completed,332.0,6.95,196,136,0,0,332,332,26,0,306,332,66,65,201,332,67,0,265,332,44,4,284,332
1390799,1872,460300,dpv1,completed,328.0,7.2,196,132,52,0,276,328,30,0,298,328,20,37,271,328,55,0,273,328,0,74,254,328
1390799,1872,460300,dpv2,completed,355.0,7.35,165,190,37,6,312,355,24,115,216,355,20,0,335,355,28,0,327,355,0,165,190,355
1390799,1872,460300,new-0.0,completed,280.0,6.8,249,31,31,0,249,280,3,0,277,280,22,0,258,280,0,0,280,280,25,0,255,280
1390799,1872,460300,new-0.5,completed,294.0,7.2,245,49,0,0,294,294,27,0,267,294,49,0,245,294,4,0,290,294,19,0,275,294
1390799,1872,460300,new-1.0,completed,302.0,7.65,208,94,34,0,268,302,0,0,302,302,47,0,255,302,2,0,300,302,16,47,239,302
1390799,1872,309704,base,completed,330.0,7.05,189,141,9,27,294,330,42,48,240,330,53,0,277,330,0,0,330,330,30,52,248,330
1390799,1872,309704,base+,completed,350.0,6.9,167,183,45,0,305,350,55,0,295,350,44,128,178,350,0,24,326,350,30,36,284,350
1390799,1872,309704,dpv1,completed,349.0,7.15,175,174,0,0,349,349,25,0,324,349,15,128,206,349,32,118,199,349,46,24,279,349
1390799,1872,309704,dpv2,completed,418.0,7.25,156,262,21,55,342,418,0,215,203,418,4,0,414,418,9,194,215,418,1,219,198,418
1390799,1872,309704,new-0.0,completed,288.0,6.8,250,38,38,0,250,288,0,0,288,288,17,0,271,288,18,0,270,288,35,0,253,288
1390799,1872,309704,new-0.5,completed,295.0,7.15,246,49,0,0,295,295,4,0,291,295,49,0,246,295,33,0,262,295,12,3,280,295
1390799,1872,309704,new-1.0,completed,311.0,7.65,210,101,31,0,280,311,0,0,311,311,62,0,249,311,25,0,286,311,25,39,247,311
1390799,1872,247588,base,completed,341.0,7.1,150,191,43,98,200,341,10,0,331,341,22,110,209,341,62,6,273,341,0,0,341,341
1390799,1872,247588,base+,completed,383.0,7.1,144,239,28,199,156,383,29,43,311,383,40,180,163,383,37,0,346,383,0,37,346,383
1390799,1872,247588,dpv1,completed,303.0,7.15,200,103,0,0,303,303,7,0,296,303,22,0,281,303,48,0,255,303,54,49,200,303
1390799,1872,247588,dpv2,completed,332.0,7.4,173,159,55,0,277,332,0,117,215,332,10,54,268,332,4,0,328,332,24,49,259,332
1390799,1872,247588,new-0.0,completed,289.0,6.8,239,50,50,0,239,289,17,0,272,289,20,0,269,289,0,0,289,289,30,0,259,289
1390799,1872,247588,new-0.5,completed,287.0,7.45,235,52,52,0,235,287,31,0,256,287,0,0,287,287,2,0,285,287,16,0,271,287
1390799,1872,247588,new-1.0,completed,302.0,7.65,191,111,22,48,232,302,0,0,302,302,63,0,239,302,9,0,293,302,50,0,252,302
1390799,1872,203195,base,completed,361.0,6.8,180,181,25,0,336,361,0,116,245,361,57,0,304,361,59,103,199,361,65,23,273,361
1390799,1872,203195,base+,completed,321.0,6.9,207,114,24,0,297,321,58,0,263,321,63,0,258,321,44,0,277,321,0,51,270,321
1390799,1872,203195,dpv1,completed,361.0,7.15,171,190,0,0,361,361,30,69,262,361,11,160,190,361,10,135,216,361,14,0,347,361
1390799,1872,203195,dpv2,completed,345.0,7.55,183,162,69,87,189,345,50,0,295,345,63,0,282,345,19,7,319,345,0,75,270,345
1390799,1872,203195,new-0.0,completed,286.0,6.9,238,48,46,2,238,286,0,0,286,286,26,0,260,286,6,3,277,286,16,0,270,286
1390799,1872,203195,new-0.5,completed,291.0,7.35,232,59,0,0,291,291,59,0,232,291,22,0,269,291,3,0,288,291,1,0,290,291
1390799,1872,203195,new-1.0,completed,325.0,7.65,215,110,84,0,241,325,0,0,325,325,80,0,245,325,34,0,291,325,55,26,244,325
1390799,1872,178029,base,completed,365.0,6.85,101,264,25,0,340,365,30,160,175,365,49,174,142,365,0,0,365,365,16,52,297,365
1390799,1872,178029,base+,completed,395.0,6.85,88,307,60,177,158,395,51,44,300,395,48,49,298,395,28,157,210,395,0,15,380,395
1390799,1872,178029,dpv1,completed,336.0,7.05,175,161,57,0,279,336,19,71,246,336,72,0,264,336,52,0,284,336,0,66,270,336
1390799,1872,178029,dpv2,completed,360.0,7.45,168,192,24,127,209,360,46,50,264,360,0,0,360,360,20,0,340,360,24,139,197,360
1390799,1872,178029,new-0.0,completed,297.0,6.7,244,53,28,0,269,297,31,0,266,297,33,0,264,297,0,0,297,297,53,0,244,297
1390799,1872,178029,new-0.5,completed,310.0,7.3,249,61,45,2,263,310,0,0,310,310,59,0,251,310,48,0,262,310,28,0,282,310
1390799,1872,178029,new-1.0,completed,315.0,7.65,226,89,62,27,226,315,0,0,315,315,58,0,257,315,36,0,279,315,49,0,266,315
1390799,1872,239735,base,completed,293.0,7.0,234,59,0,0,293,293,18,0,275,293,49,0,244,293,14,0,279,293,59,0,234,293
1390799,1872,239735,base+,completed,335.0,7.0,162,173,0,73,262,335,15,112,208,335,36,41,258,335,53,0,282,335,9,0,326,335
1390799,1872,239735,dpv1,completed,315.0,6.95,178,137,40,0,275,315,3,75,237,315,0,0,315,315,53,0,262,315,50,29,236,315
1390799,1872,239735,dpv2,completed,354.0,7.35,164,190,25,122,207,354,43,42,269,354,34,0,320,354,0,0,354,354,24,137,193,354
1390799,1872,239735,new-0.0,completed,291.0,6.85,230,61,53,0,238,291,21,8,262,291,30,0,261,291,0,0,291,291,27,0,264,291
1390799,1872,239735,new-0.5,completed,296.0,7.35,240,56,10,3,283,296,30,0,266,296,56,0,240,296,53,0,243,296,0,0,296,296
1390799,1872,239735,new-1.0,completed,308.0,7.5,193,115,57,40,211,308,0,0,308,308,33,0,275,308,28,0,280,308,75,0,233,308
1390799,1872,675528,base,completed,343.0,6.95,126,217,20,112,211,343,0,112,231,343,9,0,334,343,0,62,281,343,55,0,288,343
1390799,1872,675528,base+,completed,307.0,7.0,160,147,32,0,275,307,10,0,297,307,59,0,248,307,0,88,219,307,9,0,298,307
1390799,1872,675528,dpv1,completed,315.0,6.95,200,115,43,17,255,315,28,0,287,315,7,0,308,315,0,48,267,315,61,0,254,315
1390799,1872,675528,dpv2,completed,362.0,7.4,156,206,18,141,203,362,40,50,272,362,24,0,338,362,0,0,362,362,18,150,194,362
1390799,1872,675528,new-0.0,completed,294.0,6.9,234,60,60,0,234,294,16,0,278,294,0,0,294,294,11,0,283,294,34,0,260,294
1390799,1872,675528,new-0.5,completed,285.0,7.35,237,48,48,0,237,285,5,0,280,285,22,0,263,285,3,0,282,285,0,1,284,285
1390799,1872,675528,new-1.0,completed,314.0,7.5,202,112,57,0,257,314,17,0,297,314,0,1,313,314,63,0,251,314,25,48,241,314
1390799,1872,380692,base,completed,345.0,6.95,101,244,48,143,154,345,63,0,282,345,21,0,324,345,29,54,262,345,0,23,322,345
1390799,1872,380692,base+,completed,340.0,7.05,189,151,50,93,197,340,0,35,305,340,35,0,305,340,58,42,240,340,50,0,290,340
1390799,1872,380692,dpv1,completed,322.0,6.85,178,144,7,0,315,322,61,64,197,322,0,0,322,322,46,0,276,322,38,36,248,322
1390799,1872,380692,dpv2,completed,351.0,7.25,152,199,37,0,314,351,0,152,199,351,4,0,347,351,12,43,296,351,16,143,192,351
1390799,1872,380692,new-0.0,completed,291.0,6.85,238,53,0,4,287,291,13,0,278,291,20,0,271,291,21,0,270,291,53,0,238,291
1390799,1872,380692,new-0.5,completed,307.0,7.15,242,65,19,8,280,307,40,0,267,307,65,0,242,307,0,0,307,307,65,0,242,307
1390799,1872,380692,new-1.0,completed,326.0,7.7,214,112,0,0,326,326,78,0,248,326,79,0,247,326,36,0,290,326,47,33,246,326
9989256,1589,310811,base,completed,298.0,6.8,166,132,0,15,283,298,35,68,195,298,25,0,273,298,53,13,232,298,68,0,230,298
9989256,1589,310811,base+,completed,276.0,7.2,201,75,20,0,256,276,23,0,253,276,0,25,251,276,63,0,213,276,75,0,201,276
9989256,1589,310811,dpv1,completed,287.0,7.1,170,117,0,52,235,287,48,0,239,287,66,0,221,287,37,38,212,287,39,21,227,287
9989256,1589,310811,dpv2,completed,256.0,7.25,194,62,0,11,245,256,14,0,242,256,55,0,201,256,57,5,194,256,16,0,240,256
9989256,1589,310811,new-0.0,completed,250.0,7.2,191,59,16,0,234,250,4,0,246,250,46,0,204,250,47,0,203,250,0,18,232,250
9989256,1589,310811,new-0.5,completed,248.0,7.55,197,51,23,0,225,248,38,0,210,248,0,0,248,248,0,13,235,248,29,0,219,248
9989256,1589,310811,new-1.0,completed,264.0,7.45,152,112,32,0,232,264,24,11,229,264,43,32,189,264,2,0,262,264,0,26,238,264
9989256,1589,208428,base,completed,265.0,7.0,188,77,12,0,253,265,20,13,232,265,0,29,236,265,32,0,233,265,35,0,230,265
9989256,1589,208428,base+,completed,247.0,7.0,205,42,0,0,247,247,20,0,227,247,42,0,205,247,6,0,241,247,26,0,221,247
9989256,1589,208428,dpv1,completed,266.0,7.1,180,86,0,24,242,266,48,0,218,266,35,0,231,266,29,19,218,266,21,0,245,266
9989256,1589,208428,dpv2,completed,264.0,7.15,201,63,58,0,206,264,45,0,219,264,8,0,256,264,22,15,227,264,0,14,250,264
9989256,1589,208428,new-0.0,completed,241.0,7.05,202,39,18,0,223,241,2,0,239,241,0,0,241,241,26,0,215,241,39,0,202,241
9989256,1589,208428,new-0.5,completed,255.0,7.55,199,56,25,0,230,255,48,0,207,255,11,0,244,255,0,9,246,255,41,0,214,255
9989256,1589,208428,new-1.0,completed,277.0,7.5,162,115,31,20,226,277,0,0,277,277,10,0,267,277,52,33,192,277,63,0,214,277
9989256,1589,460300,base,completed,268.0,7.0,192,76,28,0,240,268,51,0,217,268,0,0,268,268,43,0,225,268,19,28,221,268
9989256,1589,460300,base+,completed,298.0,7.0,161,137,32,62,204,298,51,0,247,298,0,35,263,298,47,0,251,298,26,21,251,298
9989256,1589,460300,dpv1,completed,268.0,7.1,168,100,25,31,212,268,40,0,228,268,43,0,225,268,40,26,202,268,0,0,268,268
9989256,1589,460300,dpv2,completed,285.0,7.4,166,119,23,0,262,285,63,0,222,285,56,36,193,285,34,23,228,285,0,15,270,285
9989256,1589,460300,new-0.0,completed,249.0,7.2,184,65,17,0,232,249,0,18,231,249,50,0,199,249,34,0,215,249,15,0,234,249
9989256,1589,460300,new-0.5,completed,253.0,7.55,202,51,13,0,240,253,0,0,253,253,0,8,245,253,51,0,202,253,36,0,217,253
9989256,1589,460300,new-1.0,completed,275.0,7.55,132,143,0,19,256,275,21,14,240,275,0,31,244,275,29,43,203,275,37,0,238,275
9989256,1589,309704,base,completed,284.0,6.95,163,121,57,0,227,284,24,0,260,284,0,71,213,284,22,0,262,284,62,0,222,284
9989256,1589,309704,base+,completed,283.0,6.95,181,102,0,30,253,283,79,0,204,283,50,26,207,283,45,0,238,283,23,0,260,283
9989256,1589,309704,dpv1,completed,265.0,7.05,179,86,17,0,248,265,61,0,204,265,43,0,222,265,43,14,208,265,0,30,235,265
9989256,1589,309704,dpv2,completed,252.0,7.2,191,61,8,0,244,252,24,0,228,252,61,0,191,252,13,0,239,252,0,16,236,252
9989256,1589,309704,new-0.0,completed,255.0,7.15,194,61,21,0,234,255,0,14,241,255,50,0,205,255,51,0,204,255,9,0,246,255
9989256,1589,309704,new-0.5,completed,262.0,7.5,187,75,0,0,262,262,35,0,227,262,24,9,229,262,67,0,195,262,23,0,239,262
9989256,1589,309704,new-1.0,completed,271.0,7.5,162,109,33,33,205,271,3,1,267,271,0,0,271,271,43,29,199,271,47,0,224,271
9989256,1589,247588,base,completed,316.0,6.8,139,177,58,70,188,316,74,0,242,316,22,67,227,316,73,0,243,316,0,72,244,316
9989256,1589,247588,base+,completed,267.0,7.0,148,119,63,13,191,267,24,0,243,267,35,6,226,267,0,45,222,267,19,12,236,267
9989256,1589,247588,dpv1,completed,248.0,7.0,197,51,9,0,239,248,7,0,241,248,22,0,226,248,37,0,211,248,0,14,234,248
9989256,1589,247588,dpv2,completed,281.0,7.3,178,103,72,0,209,281,37,34,210,281,0,23,258,281,64,2,215,281,22,0,259,281
9989256,1589,247588,new-0.0,completed,246.0,7.15,190,56,19,0,227,246,0,19,227,246,32,0,214,246,37,0,209,246,22,0,224,246
9989256,1589,247588,new-0.5,completed,249.0,7.55,196,53,0,0,249,249,25,0,224,249,53,0,196,249,8,0,241,249,44,0,205,249
9989256,1589,247588,new-1.0,completed,272.0,7.5,189,83,51,10,211,272,0,0,272,272,28,0,244,272,60,10,202,272,63,0,209,272
9989256,1589,203195,base,completed,300.0,7.05,136,164,73,0,227,300,21,0,279,300,35,1,264,300,0,48,252,300,65,74,161,300
9989256,1589,203195,base+,completed,271.0,7.2,189,82,27,0,244,271,0,20,251,271,15,0,256,271,41,14,216,271,59,0,212,271
9989256,1589,203195,dpv1,completed,257.0,7.1,178,79,15,28,214,257,19,0,238,257,16,0,241,257,35,16,206,257,0,0,257,257
9989256,1589,203195,dpv2,completed,247.0,7.35,197,50,1,0,246,247,20,0,227,247,47,0,200,247,0,3,244,247,34,0,213,247
9989256,1589,203195,new-0.0,completed,240.0,7.1,200,40,21,0,219,240,0,0,240,240,28,0,212,240,3,0,237,240,40,0,200,240
9989256,1589,203195,new-0.5,completed,256.0,7.45,188,68,20,9,227,256,44,0,212,256,8,0,248,256,55,0,201,256,0,4,252,256
9989256,1589,203195,new-1.0,completed,246.0,7.4,188,58,13,27,206,246,0,0,246,246,11,0,235,246,16,0,230,246,31,0,215,246
9989256,1589,178029,base,completed,273.0,6.85,156,117,62,0,211,273,43,0,230,273,16,0,257,273,0,78,195,273,33,0,240,273
9989256,1589,178029,base+,completed,276.0,6.95,195,81,60,0,216,276,53,0,223,276,28,0,248,276,0,32,244,276,15,8,253,276
9989256,1589,178029,dpv1,completed,272.0,7.1,170,102,0,27,245,272,46,0,226,272,44,6,222,272,27,26,219,272,21,0,251,272
9989256,1589,178029,dpv2,completed,262.0,7.35,164,98,30,38,194,262,48,0,214,262,8,0,254,262,16,15,231,262,0,5,257,262
9989256,1589,178029,new-0.0,completed,249.0,7.05,197,52,28,0,221,249,0,4,245,249,48,0,201,249,18,0,231,249,2,0,247,249
9989256,1589,178029,new-0.5,completed,262.0,7.5,198,64,20,7,235,262,57,0,205,262,30,0,232,262,36,0,226,262,0,0,262,262
9989256,1589,178029,new-1.0,completed,287.0,7.45,133,154,18,53,216,287,51,16,220,287,0,30,257,287,41,38,208,287,31,0,256,287
9989256,1589,239735,base,completed,270.0,7.25,187,83,48,0,222,270,56,0,214,270,41,0,229,270,0,41,229,270,8,0,262,270
9989256,1589,239735,base+,completed,287.0,6.9,178,109,22,0,265,287,72,0,215,287,71,1,215,287,0,63,224,287,59,0,228,287
9989256,1589,239735,dpv1,completed,265.0,7.05,170,95,33,0,232,265,47,0,218,265,56,1,208,265,0,30,235,265,40,17,208,265
9989256,1589,239735,dpv2,completed,269.0,7.4,169,100,14,0,255,269,54,0,215,269,57,31,181,269,39,6,224,269,0,23,246,269
9989256,1589,239735,new-0.0,completed,245.0,7.15,182,63,21,0,224,245,0,25,220,245,36,0,209,245,38,0,207,245,13,0,232,245
9989256,1589,239735,new-0.5,completed,260.0,7.6,203,57,32,0,228,260,0,0,260,260,39,0,221,260,57,0,203,260,51,0,209,260
9989256,1589,239735,new-1.0,completed,266.0,7.5,150,116,42,16,208,266,13,0,253,266,62,0,204,266,49,28,189,266,0,10,256,266
9989256,1589,675528,base,completed,261.0,6.95,199,62,15,0,246,261,0,15,246,261,62,0,199,261,20,0,241,261,41,0,220,261
9989256,1589,675528,base+,completed,274.0,6.8,189,85,63,2,209,274,0,25,249,274,61,0,213,274,38,19,217,274,14,0,260,274
9989256,1589,675528,dpv1,completed,258.0,7.1,180,78,10,28,220,258,26,0,232,258,33,17,208,258,26,0,232,258,0,0,258,258
9989256,1589,675528,dpv2,completed,273.0,7.2,204,69,67,0,206,273,55,0,218,273,0,23,250,273,23,0,250,273,20,0,253,273
9989256,1589,675528,new-0.0,completed,250.0,7.15,187,63,25,0,225,250,0,18,232,250,31,0,219,250,45,0,205,250,12,0,238,250
9989256,1589,675528,new-0.5,completed,263.0,7.55,175,88,0,0,263,263,15,25,223,263,31,0,232,263,63,0,200,263,37,0,226,263
9989256,1589,675528,new-1.0,completed,256.0,7.45,197,59,28,20,208,256,0,0,256,256,9,0,247,256,30,0,226,256,39,0,217,256
9989256,1589,380692,base,completed,257.0,6.9,190,67,19,0,238,257,34,0,223,257,62,0,195,257,23,0,234,257,0,28,229,257
9989256,1589,380692,base+,completed,263.0,6.8,213,50,38,0,225,263,19,3,241,263,49,0,214,263,14,0,249,263,0,4,259,263
9989256,1589,380692,dpv1,completed,261.0,7.1,164,97,8,40,213,261,15,0,246,261,30,0,231,261,24,28,209,261,0,0,261,261
9989256,1589,380692,dpv2,completed,261.0,7.25,193,68,61,0,200,261,49,0,212,261,24,0,237,261,0,25,236,261,23,0,238,261
9989256,1589,380692,new-0.0,completed,240.0,7.1,194,46,12,3,225,240,0,0,240,240,26,0,214,240,4,0,236,240,43,0,197,240
9989256,1589,380692,new-0.5,completed,251.0,7.55,200,51,32,0,219,251,0,0,251,251,51,0,200,251,8,0,243,251,35,0,216,251
9989256,1589,380692,new-1.0,completed,262.0,7.55,138,124,23,0,239,262,23,8,231,262,0,14,248,262,44,31,187,262,5,27,230,262
8860037,1659,310811,base,completed,288.0,7.1,183,105,52,0,236,288,8,0,280,288,0,46,242,288,75,0,213,288,30,0,258,288
8860037,1659,310811,base+,completed,273.0,7.1,208,65,0,23,250,273,57,0,216,273,12,0,261,273,63,0,210,273,27,0,246,273
8860037,1659,310811,dpv1,completed,267.0,7.1,181,86,0,21,246,267,6,0,261,267,57,0,210,267,8,0,259,267,29,29,209,267
8860037,1659,310811,dpv2,completed,275.0,7.35,172,103,42,55,178,275,0,0,275,275,48,0,227,275,24,0,251,275,36,0,239,275
8860037,1659,310811,new-0.0,completed,260.0,6.9,209,51,10,0,250,260,29,0,231,260,33,0,227,260,0,1,259,260,51,0,209,260
8860037,1659,310811,new-0.5,completed,266.0,7.45,212,54,52,2,212,266,23,0,243,266,25,0,241,266,16,0,250,266,0,26,240,266
8860037,1659,310811,new-1.0,completed,283.0,7.55,153,130,27,5,251,283,5,59,219,283,63,20,200,283,24,0,259,283,0,28,255,283
8860037,1659,208428,base,completed,293.0,7.3,161,132,3,0,290,293,58,18,217,293,28,0,265,293,50,0,243,293,0,86,207,293
8860037,1659,208428,base+,completed,280.0,6.8,186,94,59,0,221,280,28,35,217,280,17,0,263,280,0,18,262,280,57,0,223,280
8860037,1659,208428,dpv1,completed,283.0,6.95,195,88,0,29,254,283,30,0,253,283,68,0,215,283,24,20,239,283,20,0,263,283
8860037,1659,208428,dpv2,completed,270.0,7.4,186,84,45,39,186,270,0,0,270,270,32,0,238,270,17,0,253,270,36,0,234,270
8860037,1659,208428,new-0.0,completed,261.0,7.1,215,46,46,0,215,261,0,7,254,261,34,0,227,261,10,0,251,261,32,0,229,261
8860037,1659,208428,new-0.5,completed,260.0,7.45,208,52,0,0,260,260,3,11,246,260,35,0,225,260,6,0,254,260,52,0,208,260
8860037,1659,208428,new-1.0,completed,296.0,7.35,164,132,61,0,235,296,5,28,263,296,0,13,283,296,69,0,227,296,34,59,203,296
8860037,1659,460300,base,completed,335.0,7.1,100,235,40,0,295,335,30,52,253,335,17,107,211,335,48,161,126,335,0,0,335,335
8860037,1659,460300,base+,completed,287.0,7.05,218,69,0,18,269,287,34,0,253,287,64,0,223,287,69,0,218,287,28,0,259,287
8860037,1659,460300,dpv1,completed,287.0,6.95,213,74,30,0,257,287,45,0,242,287,41,0,246,287,0,44,243,287,56,0,231,287
8860037,1659,460300,dpv2,completed,287.0,7.4,192,95,58,37,192,287,0,0,287,287,50,0,237,287,39,0,248,287,40,0,247,287
8860037,1659,460300,new-0.0,completed,257.0,7.0,220,37,33,0,224,257,15,0,242,257,28,0,229,257,0,9,248,257,25,0,232,257
8860037,1659,460300,new-0.5,completed,282.0,7.45,201,81,0,20,262,282,40,0,242,282,30,0,252,282,37,0,245,282,81,0,201,282
8860037,1659,460300,new-1.0,completed,306.0,7.25,161,145,74,0,232,306,28,43,235,306,74,0,232,306,0,24,282,306,8,62,236,306
8860037,1659,309704,base,completed,308.0,7.0,206,102,0,66,242,308,83,0,225,308,83,0,225,308,30,6,272,308,37,0,271,308
8860037,1659,309704,base+,completed,280.0,7.2,225,55,0,0,280,280,53,0,227,280,38,0,242,280,45,0,235,280,55,0,225,280
8860037,1659,309704,dpv1,completed,275.0,7.05,189,86,4,25,246,275,36,0,239,275,21,0,254,275,86,0,189,275,0,0,275,275
8860037,1659,309704,dpv2,completed,295.0,7.15,150,145,0,0,295,295,64,0,231,295,20,0,275,295,58,36,201,295,55,45,195,295
8860037,1659,309704,new-0.0,completed,270.0,7.05,201,69,32,0,238,270,69,0,201,270,45,0,225,270,8,0,262,270,0,12,258,270
8860037,1659,309704,new-0.5,completed,270.0,7.4,206,64,64,0,206,270,26,0,244,270,35,0,235,270,17,0,253,270,0,9,261,270
8860037,1659,309704,new-1.0,completed,308.0,7.4,153,155,0,32,276,308,88,31,189,308,33,0,275,308,41,0,267,308,58,62,188,308
8860037,1659,247588,base,completed,289.0,7.05,165,124,58,0,231,289,10,0,279,289,0,31,258,289,81,43,165,289,34,0,255,289
8860037,1659,247588,base+,completed,251.0,7.05,216,35,0,3,248,251,32,0,219,251,20,0,231,251,4,0,247,251,22,0,229,251
8860037,1659,247588,dpv1,completed,275.0,7.05,169,106,27,0,248,275,11,0,264,275,46,0,229,275,0,29,246,275,25,52,198,275
8860037,1659,247588,dpv2,completed,281.0,7.35,161,120,0,0,281,281,44,29,208,281,54,35,192,281,56,0,225,281,13,0,268,281
8860037,1659,247588,new-0.0,completed,267.0,7.05,205,62,31,0,236,267,0,12,255,267,41,0,226,267,15,0,252,267,62,0,205,267
8860037,1659,247588,new-0.5,completed,268.0,7.55,198,70,63,0,205,268,34,7,227,268,0,24,244,268,36,0,232,268,32,0,236,268
8860037,1659,247588,new-1.0,completed,284.0,7.3,170,114,1,6,277,284,0,36,248,284,25,1,258,284,45,0,239,284,49,60,175,284
8860037,1659,203195,base,completed,257.0,7.05,223,34,23,0,234,257,0,0,257,257,34,0,223,257,0,1,256,257,28,0,229,257
8860037,1659,203195,base+,completed,292.0,7.1,120,172,1,109,182,292,30,46,216,292,15,25,252,292,0,0,292,292,39,0,253,292
8860037,1659,203195,dpv1,completed,261.0,7.05,196,65,0,0,261,261,4,0,257,261,3,4,254,261,65,0,196,261,33,0,228,261
8860037,1659,203195,dpv2,completed,262.0,7.35,212,50,30,0,232,262,27,0,235,262,50,0,212,262,16,0,246,262,0,0,262,262
8860037,1659,203195,new-0.0,completed,269.0,7.15,215,54,42,0,227,269,54,0,215,269,30,0,239,269,31,0,238,269,0,19,250,269
8860037,1659,203195,new-0.5,completed,266.0,7.45,215,51,49,0,217,266,0,19,247,266,32,0,234,266,26,0,240,266,21,0,245,266
8860037,1659,203195,new-1.0,completed,293.0,7.2,165,128,0,0,293,293,29,20,244,293,63,0,230,293,1,28,264,293,78,43,172,293
8860037,1659,178029,base,completed,266.0,6.95,199,67,45,0,221,266,34,22,210,266,0,1,265,266,29,0,237,266,15,0,251,266
8860037,1659,178029,base+,completed,285.0,7.15,213,72,65,0,220,285,0,42,243,285,30,0,255,285,72,0,213,285,29,0,256,285
8860037,1659,178029,dpv1,completed,278.0,6.95,216,62,0,0,278,278,55,0,223,278,22,7,249,278,30,0,248,278,49,0,229,278
8860037,1659,178029,dpv2,completed,276.0,7.25,204,72,35,32,209,276,0,0,276,276,18,0,258,276,40,0,236,276,32,0,244,276
8860037,1659,178029,new-0.0,completed,259.0,7.0,210,49,42,0,217,259,7,0,252,259,28,0,231,259,0,21,238,259,34,0,225,259
8860037,1659,178029,new-0.5,completed,278.0,7.45,186,92,30,0,248,278,70,0,208,278,52,22,204,278,16,0,262,278,0,18,260,278
8860037,1659,178029,new-1.0,completed,292.0,7.65,154,138,0,0,292,292,15,88,189,292,68,10,214,292,34,0,258,292,46,0,246,292
8860037,1659,239735,base,completed,284.0,7.0,208,76,76,0,208,284,0,26,258,284,31,0,253,284,6,0,278,284,64,0,220,284
8860037,1659,239735,base+,completed,277.0,7.1,148,129,55,34,188,277,45,0,232,277,49,0,228,277,5,1,271,277,0,40,237,277
8860037,1659,239735,dpv1,completed,261.0,7.0,176,85,10,33,218,261,40,0,221,261,0,0,261,261,52,0,209,261,17,0,244,261
8860037,1659,239735,dpv2,completed,267.0,7.4,171,96,24,26,217,267,36,0,231,267,0,32,235,267,46,0,221,267,28,0,239,267
8860037,1659,239735,new-0.0,completed,260.0,7.05,208,52,0,22,238,260,25,0,235,260,29,0,231,260,45,0,215,260,52,0,208,260
8860037,1659,239735,new-0.5,completed,269.0,7.4,176,93,17,0,252,269,2,13,254,269,25,0,244,269,0,33,236,269,80,0,189,269
8860037,1659,239735,new-1.0,completed,283.0,7.3,155,128,0,13,270,283,16,26,241,283,26,0,257,283,61,0,222,283,47,61,175,283
8860037,1659,675528,base,completed,295.0,6.95,197,98,27,0,268,295,84,0,211,295,56,0,239,295,41,0,254,295,0,71,224,295
8860037,1659,675528,base+,completed,265.0,7.05,211,54,34,0,231,265,29,0,236,265,0,6,259,265,54,0,211,265,2,0,263,265
8860037,1659,675528,dpv1,completed,277.0,7.0,176,101,5,30,242,277,30,0,247,277,83,0,194,277,35,0,242,277,0,18,259,277
8860037,1659,675528,dpv2,completed,268.0,7.5,187,81,0,0,268,268,23,0,245,268,40,33,195,268,10,0,258,268,24,24,220,268
8860037,1659,675528,new-0.0,completed,259.0,7.0,218,41,41,0,218,259,14,0,245,259,24,0,235,259,0,8,251,259,37,0,222,259
8860037,1659,675528,new-0.5,completed,270.0,7.4,203,67,0,7,263,270,8,0,262,270,50,17,203,270,33,0,237,270,45,0,225,270
8860037,1659,675528,new-1.0,completed,294.0,7.5,155,139,34,0,260,294,1,88,205,294,75,7,212,294,52,0,242,294,0,0,294,294
8860037,1659,380692,base,completed,291.0,7.1,172,119,68,0,223,291,38,0,253,291,81,38,172,291,29,0,262,291,0,27,264,291
8860037,1659,380692,base+,completed,274.0,7.05,155,119,32,80,162,274,0,0,274,274,34,0,240,274,12,36,226,274,12,0,262,274
8860037,1659,380692,dpv1,completed,291.0,7.15,164,127,0,81,210,291,72,0,219,291,33,0,258,291,33,0,258,291,29,45,217,291
8860037,1659,380692,dpv2,completed,283.0,7.15,180,103,0,0,283,283,11,0,272,283,58,0,225,283,59,0,224,283,54,44,185,283
8860037,1659,380692,new-0.0,completed,267.0,7.05,207,60,31,0,236,267,0,20,247,267,45,0,222,267,17,0,250,267,60,0,207,267
8860037,1659,380692,new-0.5,completed,265.0,7.5,191,74,0,13,252,265,8,4,253,265,70,0,195,265,30,0,235,265,14,0,251,265
8860037,1659,380692,new-1.0,completed,301.0,7.65,154,147,0,0,301,301,18,83,200,301,88,11,202,301,66,0,235,301,52,3,246,301
4660121,1662,310811,base,completed,413.0,6.6,56,357,49,167,197,413,68,0,345,413,76,136,201,413,58,135,220,413,0,143,270,413
4660121,1662,310811,base+,completed,321.0,6.7,83,238,47,74,200,321,36,10,275,321,0,31,290,321,44,64,213,321,24,54,243,321
4660121,1662,310811,dpv1,completed,320.0,6.7,141,179,0,55,265,320,38,34,248,320,26,33,261,320,69,27,224,320,72,38,210,320
4660121,1662,310811,dpv2,completed,350.0,7.1,88,262,53,50,247,350,72,0,278,350,0,78,272,350,64,62,224,350,83,95,172,350
4660121,1662,310811,new-0.0,completed,287.0,6.65,195,92,0,0,287,287,66,0,221,287,74,1,212,287,60,7,220,287,20,10,257,287
4660121,1662,310811,new-0.5,completed,289.0,6.85,212,77,65,0,224,289,61,0,228,289,60,0,229,289,0,3,286,289,38,9,242,289
4660121,1662,310811,new-1.0,completed,274.0,7.0,212,62,0,0,274,274,53,0,221,274,2,0,272,274,54,0,220,274,59,3,212,274
4660121,1662,208428,base,completed,356.0,6.6,54,302,0,132,224,356,37,21,298,356,19,94,243,356,8,0,348,356,59,220,77,356
4660121,1662,208428,base+,completed,299.0,6.8,173,126,62,12,225,299,59,0,240,299,75,0,224,299,40,51,208,299,0,0,299,299
4660121,1662,208428,dpv1,completed,311.0,6.7,138,173,28,0,283,311,20,37,254,311,0,110,201,311,63,14,234,311,51,34,226,311
4660121,1662,208428,dpv2,completed,349.0,6.9,42,307,79,87,183,349,24,30,295,349,66,58,225,349,67,88,194,349,0,76,273,349
4660121,1662,208428,new-0.0,completed,286.0,6.65,199,87,0,0,286,286,19,0,267,286,74,0,212,286,58,0,228,286,61,13,212,286
4660121,1662,208428,new-0.5,completed,266.0,6.75,201,65,48,0,218,266,0,0,266,266,17,0,249,266,50,0,216,266,8,15,243,266
4660121,1662,208428,new-1.0,completed,274.0,7.0,181,93,56,0,218,274,0,0,274,274,58,0,216,274,5,28,241,274,14,7,253,274
4660121,1662,460300,base,completed,331.0,6.45,70,261,77,0,254,331,0,0,331,331,6,41,284,331,46,107,178,331,27,119,185,331
4660121,1662,460300,base+,completed,324.0,6.9,136,188,19,16,289,324,61,0,263,324,66,69,189,324,80,0,244,324,0,73,251,324
4660121,1662,460300,dpv1,completed,306.0,6.8,137,169,8,0,298,306,0,39,267,306,13,93,200,306,32,29,245,306,57,50,199,306
4660121,1662,460300,dpv2,completed,356.0,7.0,74,282,61,24,271,356,82,34,240,356,63,116,177,356,0,25,331,356,85,77,194,356
4660121,1662,460300,new-0.0,completed,265.0,6.65,206,59,18,0,247,265,0,0,265,265,45,0,220,265,12,0,253,265,53,6,206,265
4660121,1662,460300,new-0.5,completed,277.0,7.0,196,81,0,0,277,277,70,0,207,277,41,0,236,277,21,0,256,277,25,11,241,277
4660121,1662,460300,new-1.0,completed,283.0,6.95,213,70,59,0,224,283,56,0,227,283,19,0,264,283,60,0,223,283,0,10,273,283
4660121,1662,309704,base,completed,311.0,6.7,114,197,0,39,272,311,9,91,211,311,35,74,202,311,14,0,297,311,1,104,206,311
4660121,1662,309704,base+,completed,321.0,6.95,90,231,41,0,280,321,20,41,260,321,52,112,157,321,71,46,204,321,0,6,315,321
4660121,1662,309704,dpv1,completed,312.0,6.85,133,179,29,0,283,312,0,31,281,312,33,112,167,312,67,12,233,312,64,0,248,312
4660121,1662,309704,dpv2,completed,331.0,6.95,93,238,69,0,262,331,72,25,234,331,54,95,182,331,0,22,309,331,37,80,214,331
4660121,1662,309704,new-0.0,completed,297.0,6.65,193,104,89,0,208,297,78,0,219,297,0,5,292,297,89,0,208,297,29,10,258,297
4660121,1662,309704,new-0.5,completed,302.0,6.8,209,93,79,0,223,302,0,0,302,302,78,0,224,302,53,0,249,302,91,2,209,302
4660121,1662,309704,new-1.0,completed,273.0,6.9,189,84,46,0,227,273,14,14,245,273,0,0,273,273,58,6,209,273,3,6,264,273
4660121,1662,247588,base,completed,353.0,7.0,6,347,0,0,353,353,12,174,167,353,8,141,204,353,43,0,310,353,16,147,190,353
4660121,1662,247588,base+,completed,304.0,6.85,134,170,51,2,251,304,0,57,247,304,40,0,264,304,50,51,203,304,32,48,224,304
4660121,1662,247588,dpv1,completed,317.0,6.75,117,200,35,57,225,317,42,0,275,317,0,131,186,317,69,30,218,317,13,31,273,317
4660121,1662,247588,dpv2,completed,325.0,6.85,86,239,0,60,265,325,14,4,307,325,76,0,249,325,58,66,201,325,81,90,154,325
4660121,1662,247588,new-0.0,completed,280.0,6.7,195,85,71,0,209,280,74,0,206,280,39,2,239,280,0,1,279,280,34,8,238,280
4660121,1662,247588,new-0.5,completed,259.0,6.85,197,62,5,5,249,259,40,0,219,259,37,2,220,259,0,2,257,259,53,0,206,259
4660121,1662,247588,new-1.0,completed,264.0,6.95,198,66,0,0,264,264,14,12,238,264,40,0,224,264,6,0,258,264,45,9,210,264
4660121,1662,203195,base,completed,495.0,6.8,14,481,39,291,165,495,66,180,249,495,79,208,208,495,37,0,458,495,0,338,157,495
4660121,1662,203195,base+,completed,308.0,6.55,124,184,69,0,239,308,39,0,269,308,49,0,259,308,0,78,230,308,38,59,211,308
4660121,1662,203195,dpv1,completed,331.0,6.75,99,232,0,0,331,331,46,42,243,331,5,110,216,331,74,23,234,331,60,90,181,331
4660121,1662,203195,dpv2,completed,314.0,6.9,109,205,0,47,267,314,14,0,300,314,57,70,187,314,73,0,241,314,65,77,172,314
4660121,1662,203195,new-0.0,completed,280.0,6.65,203,77,30,7,243,280,59,0,221,280,37,2,241,280,0,0,280,280,51,9,220,280
4660121,1662,203195,new-0.5,completed,292.0,7.05,187,105,71,11,210,292,72,0,220,292,81,0,211,292,25,4,263,292,0,9,283,292
4660121,1662,203195,new-1.0,completed,260.0,6.9,208,52,37,0,223,260,21,5,234,260,10,0,250,260,0,0,260,260,45,2,213,260
4660121,1662,178029,base,completed,340.0,6.85,35,305,46,48,246,340,0,0,340,340,5,33,302,340,66,120,154,340,32,180,128,340
4660121,1662,178029,base+,completed,331.0,6.85,110,221,65,0,266,331,0,21,310,331,87,66,178,331,14,24,293,331,74,87,170,331
4660121,1662,178029,dpv1,completed,334.0,6.75,98,236,0,0,334,334,37,44,253,334,16,116,202,334,84,21,229,334,50,98,186,334
4660121,1662,178029,dpv2,completed,361.0,6.95,72,289,16,33,312,361,0,56,305,361,53,130,178,361,89,37,235,361,80,93,188,361
4660121,1662,178029,new-0.0,completed,301.0,6.85,192,109,0,2,299,301,39,17,245,301,85,0,216,301,83,0,218,301,78,5,218,301
4660121,1662,178029,new-0.5,completed,286.0,6.85,206,80,75,0,211,286,0,0,286,286,28,0,258,286,69,0,217,286,68,5,213,286
4660121,1662,178029,new-1.0,completed,271.0,6.9,205,66,55,0,216,271,16,1,254,271,0,1,270,271,8,0,263,271,58,7,206,271
4660121,1662,239735,base,completed,356.0,6.85,61,295,53,71,232,356,15,67,274,356,19,0,337,356,0,148,208,356,53,178,125,356
4660121,1662,239735,base+,completed,312.0,6.7,136,176,51,33,228,312,24,23,265,312,85,46,181,312,0,53,259,312,71,3,238,312
4660121,1662,239735,dpv1,completed,320.0,6.75,100,220,0,0,320,320,44,44,232,320,19,108,193,320,71,13,236,320,58,76,186,320
4660121,1662,239735,dpv2,completed,325.0,6.85,82,243,0,56,269,325,15,17,293,325,76,0,249,325,62,69,194,325,74,94,157,325
4660121,1662,239735,new-0.0,completed,283.0,6.65,207,76,65,0,218,283,64,3,216,283,62,0,221,283,37,0,246,283,0,8,275,283
4660121,1662,239735,new-0.5,completed,290.0,6.85,196,94,72,0,218,290,81,9,200,290,42,0,248,290,0,0,290,290,76,4,210,290
4660121,1662,239735,new-1.0,completed,276.0,6.85,169,107,56,0,220,276,0,0,276,276,3,0,273,276,52,35,189,276,53,16,207,276
4660121,1662,675528,base,completed,438.0,6.7,86,352,0,192,246,438,35,110,293,438,53,0,385,438,41,253,144,438,28,279,131,438
4660121,1662,675528,base+,completed,280.0,6.7,164,116,22,0,258,280,34,62,184,280,11,22,247,280,55,0,225,280,0,8,272,280
4660121,1662,675528,dpv1,completed,315.0,6.7,149,166,25,51,239,315,0,43,272,315,50,36,229,315,26,31,258,315,57,36,222,315
4660121,1662,675528,dpv2,completed,333.0,6.9,85,248,0,65,268,333,23,7,303,333,63,74,196,333,83,0,250,333,84,91,158,333
4660121,1662,675528,new-0.0,completed,253.0,6.6,205,48,2,0,251,253,0,0,253,253,45,0,208,253,32,0,221,253,9,3,241,253
4660121,1662,675528,new-0.5,completed,297.0,6.95,178,119,72,1,224,297,49,0,248,297,0,0,297,297,45,2,250,297,60,46,191,297
4660121,1662,675528,new-1.0,completed,274.0,6.95,216,58,7,0,267,274,51,1,222,274,53,0,221,274,45,0,229,274,0,4,270,274
4660121,1662,380692,base,completed,478.0,6.85,48,430,0,315,163,478,44,219,215,478,92,217,169,478,43,0,435,478,71,169,238,478
4660121,1662,380692,base+,completed,324.0,6.7,117,207,59,17,248,324,55,0,269,324,75,47,202,324,11,93,220,324,0,64,260,324
4660121,1662,380692,dpv1,completed,313.0,6.85,139,174,70,0,243,313,0,36,277,313,40,104,169,313,67,25,221,313,24,16,273,313
4660121,1662,380692,dpv2,completed,319.0,7.0,63,256,20,73,226,319,53,21,245,319,67,0,252,319,56,82,181,319,0,72,247,319
4660121,1662,380692,new-0.0,completed,291.0,6.75,179,112,84,0,207,291,86,0,205,291,43,6,242,291,59,4,228,291,0,16,275,291
4660121,1662,380692,new-0.5,completed,281.0,7.1,203,78,0,0,281,281,68,1,212,281,68,0,213,281,59,0,222,281,29,10,242,281
4660121,1662,380692,new-1.0,completed,273.0,6.85,212,61,41,0,232,273,24,12,237,273,39,1,233,273,13,1,259,273,0,6,267,273
3955844,1797,310811,base,completed,470.0,6.75,28,442,0,124,346,470,53,0,417,470,71,123,276,470,63,275,132,470,69,263,138,470
3955844,1797,310811,base+,completed,630.0,6.75,0,630,20,0,610,630,46,309,275,630,55,444,131,630,20,541,69,630,0,416,214,630
3955844,1797,310811,dpv1,completed,375.0,6.95,100,275,78,89,208,375,0,76,299,375,9,115,251,375,63,0,312,375,0,143,232,375
3955844,1797,310811,dpv2,completed,385.0,7.0,113,272,0,27,358,385,52,116,217,385,41,119,225,385,30,189,166,385,21,12,352,385
3955844,1797,310811,new-0.0,completed,318.0,7.0,158,160,32,18,268,318,0,8,310,318,39,52,227,318,1,56,261,318,52,13,253,318
3955844,1797,310811,new-0.5,completed,312.0,6.95,148,164,16,8,288,312,5,12,295,312,37,55,220,312,0,51,261,312,54,2,256,312
3955844,1797,310811,new-1.0,completed,317.0,7.0,149,168,25,8,284,317,17,1,299,317,48,34,235,317,62,78,177,317,0,24,293,317
3955844,1797,208428,base,completed,519.0,6.65,46,473,38,34,447,519,0,0,519,519,9,363,147,519,79,278,162,519,46,393,80,519
3955844,1797,208428,base+,completed,501.0,6.75,83,418,73,0,428,501,35,243,223,501,32,87,382,501,31,318,152,501,0,345,156,501
3955844,1797,208428,dpv1,completed,402.0,6.85,53,349,20,0,382,402,53,121,228,402,0,207,195,402,59,102,241,402,18,148,236,402
3955844,1797,208428,dpv2,completed,406.0,7.0,114,292,0,48,358,406,58,146,202,406,53,141,212,406,25,210,171,406,26,8,372,406
3955844,1797,208428,new-0.0,completed,306.0,6.9,170,136,55,12,239,306,18,7,281,306,13,25,268,306,0,51,255,306,55,11,240,306
3955844,1797,208428,new-0.5,completed,305.0,6.95,177,128,29,17,259,305,10,9,286,305,32,21,252,305,49,51,205,305,0,11,294,305
3955844,1797,208428,new-1.0,completed,335.0,6.95,149,186,41,17,277,335,36,18,281,335,70,21,244,335,0,66,269,335,70,31,234,335
3955844,1797,460300,base,completed,589.0,6.7,11,578,2,279,308,589,36,0,553,589,0,315,274,589,22,446,121,589,56,464,69,589
3955844,1797,460300,base+,completed,466.0,6.75,37,429,32,11,423,466,49,203,214,466,0,200,266,466,5,240,221,466,56,216,194,466
3955844,1797,460300,dpv1,completed,424.0,6.9,39,385,93,0,331,424,0,103,321,424,29,206,189,424,85,94,245,424,42,157,225,424
3955844,1797,460300,dpv2,completed,393.0,6.95,105,288,0,38,355,393,60,134,199,393,44,119,230,393,22,202,169,393,8,30,355,393
3955844,1797,460300,new-0.0,completed,305.0,6.95,154,151,35,8,262,305,3,15,287,305,16,62,227,305,0,57,248,305,35,18,252,305
3955844,1797,460300,new-0.5,completed,317.0,7.0,150,167,11,15,291,317,23,10,284,317,44,42,231,317,68,57,192,317,0,7,310,317
3955844,1797,460300,new-1.0,completed,332.0,7.05,146,186,0,15,317,332,15,5,312,332,40,42,250,332,50,90,192,332,47,37,248,332
3955844,1797,309704,base,completed,530.0,6.7,10,520,0,355,175,530,29,68,433,530,44,350,136,530,12,110,408,530,57,320,153,530
3955844,1797,309704,base+,completed,456.0,6.75,12,444,71,160,225,456,45,0,411,456,4,233,219,456,0,156,300,456,55,258,143,456
3955844,1797,309704,dpv1,completed,416.0,6.9,36,380,0,124,292,416,55,67,294,416,15,214,187,416,63,58,295,416,7,188,221,416
3955844,1797,309704,dpv2,completed,392.0,7.0,118,274,15,44,333,392,37,133,222,392,52,120,220,392,32,204,156,392,0,19,373,392
3955844,1797,309704,new-0.0,completed,324.0,7.0,165,159,51,14,259,324,20,8,296,324,52,55,217,324,0,49,275,324,55,11,258,324
3955844,1797,309704,new-0.5,completed,326.0,6.9,157,169,38,15,273,326,0,11,315,326,53,57,216,326,29,49,248,326,60,11,255,326
3955844,1797,309704,new-1.0,completed,341.0,6.95,124,217,46,15,280,341,0,16,325,341,72,38,231,341,7,84,250,341,67,40,234,341
3955844,1797,247588,base,completed,535.0,6.65,76,459,30,230,275,535,73,28,434,535,84,191,260,535,64,347,124,535,0,282,253,535
3955844,1797,247588,base+,completed,613.0,6.65,15,598,61,369,183,613,60,0,553,613,7,529,77,613,19,457,137,613,0,279,334,613
3955844,1797,247588,dpv1,completed,381.0,6.8,63,318,0,0,381,381,51,97,233,381,1,182,198,381,46,79,256,381,22,132,227,381
3955844,1797,247588,dpv2,completed,377.0,6.95,124,253,11,45,321,377,32,141,204,377,48,107,222,377,22,197,158,377,0,0,377,377
3955844,1797,247588,new-0.0,completed,301.0,6.95,163,138,27,8,266,301,18,4,279,301,27,56,218,301,0,51,250,301,37,0,264,301
3955844,1797,247588,new-0.5,completed,300.0,6.95,163,137,37,7,256,300,16,0,284,300,41,51,208,300,0,51,249,300,45,0,255,300
3955844,1797,247588,new-1.0,completed,345.0,6.95,127,218,61,7,277,345,50,3,292,345,80,43,222,345,0,93,252,345,72,32,241,345
3955844,1797,203195,base,completed,518.0,6.7,19,499,0,162,356,518,22,0,496,518,1,437,80,518,60,353,105,518,13,235,270,518
3955844,1797,203195,base+,completed,396.0,6.75,67,329,55,0,341,396,5,100,291,396,0,179,217,396,26,25,345,396,46,201,149,396
3955844,1797,203195,dpv1,completed,479.0,6.8,55,424,32,0,447,479,0,134,345,479,36,265,178,479,84,195,200,479,83,251,145,479
3955844,1797,203195,dpv2,completed,401.0,6.95,106,295,63,43,295,401,0,141,260,401,41,125,235,401,31,207,163,401,13,40,348,401
3955844,1797,203195,new-0.0,completed,323.0,6.95,163,160,33,11,279,323,27,15,281,323,55,31,237,323,63,59,201,323,0,8,315,323
3955844,1797,203195,new-0.5,completed,317.0,6.95,158,159,70,0,247,317,31,10,276,317,38,42,237,317,0,53,264,317,47,11,259,317
3955844,1797,203195,new-1.0,completed,358.0,6.9,164,194,0,24,334,358,47,7,304,358,87,45,226,358,87,65,206,358,90,11,257,358
3955844,1797,178029,base,completed,482.0,6.65,28,454,0,160,322,482,50,0,432,482,55,349,78,482,46,258,178,482,6,213,263,482
3955844,1797,178029,base+,completed,497.0,7.0,80,417,0,0,497,497,58,235,204,497,78,339,80,497,17,100,380,497,34,314,149,497
3955844,1797,178029,dpv1,completed,432.0,6.9,40,392,0,0,432,432,82,110,240,432,17,231,184,432,77,109,246,432,33,180,219,432
3955844,1797,178029,dpv2,completed,415.0,6.95,109,306,0,45,370,415,68,148,199,415,61,129,225,415,40,215,160,415,12,35,368,415
3955844,1797,178029,new-0.0,completed,322.0,7.0,154,168,29,8,285,322,28,3,291,322,47,68,207,322,0,53,269,322,66,11,245,322
3955844,1797,178029,new-0.5,completed,325.0,7.0,147,178,26,11,288,325,0,24,301,325,63,41,221,325,77,53,195,325,27,5,293,325
3955844,1797,178029,new-1.0,completed,347.0,6.95,129,218,58,11,278,347,25,20,302,347,71,41,235,347,0,83,264,347,71,41,235,347
3955844,1797,239735,base,completed,398.0,6.6,102,296,30,0,368,398,51,11,336,398,35,163,200,398,0,126,272,398,65,206,127,398
3955844,1797,239735,base+,completed,501.0,6.95,24,477,17,121,363,501,15,94,392,501,0,291,210,501,11,422,68,501,12,237,252,501
3955844,1797,239735,dpv1,completed,385.0,7.1,135,250,0,81,304,385,76,114,195,385,35,98,252,385,10,0,375,385,74,174,137,385
3955844,1797,239735,dpv2,completed,370.0,7.0,114,256,0,32,338,370,39,125,206,370,32,124,214,370,26,189,155,370,7,16,347,370
3955844,1797,239735,new-0.0,completed,309.0,6.9,167,142,52,3,254,309,3,12,294,309,29,27,253,309,0,62,247,309,44,22,243,309
3955844,1797,239735,new-0.5,completed,327.0,6.95,165,162,72,3,252,327,36,12,279,327,41,27,259,327,0,62,265,327,55,22,250,327
3955844,1797,239735,new-1.0,completed,328.0,7.0,133,195,44,23,261,328,1,9,318,328,68,27,233,328,63,91,174,328,0,22,306,328
3955844,1797,675528,base,completed,566.0,6.8,31,535,66,312,188,566,48,159,359,566,63,120,383,566,0,352,214,566,60,363,143,566
3955844,1797,675528,base+,completed,385.0,7.0,134,251,21,165,199,385,47,0,338,385,8,12,365,385,0,164,221,385,34,199,152,385
3955844,1797,675528,dpv1,completed,432.0,6.95,42,390,9,138,285,432,47,75,310,432,0,248,184,432,54,61,317,432,52,142,238,432
3955844,1797,675528,dpv2,completed,398.0,7.0,116,282,0,43,355,398,44,141,213,398,31,140,227,398,43,213,142,398,3,18,377,398
3955844,1797,675528,new-0.0,completed,326.0,6.95,164,162,61,14,251,326,20,1,305,326,26,40,260,326,0,65,261,326,45,28,253,326
3955844,1797,675528,new-0.5,completed,333.0,7.0,166,167,67,13,253,333,22,1,310,333,42,40,251,333,0,65,268,333,57,28,248,333
3955844,1797,675528,new-1.0,completed,338.0,7.0,151,187,71,28,239,338,14,6,318,338,64,40,234,338,73,76,189,338,0,28,310,338
3955844,1797,380692,base,completed,602.0,6.6,0,602,2,64,536,602,9,317,276,602,0,376,226,602,19,449,134,602,56,396,150,602
3955844,1797,380692,base+,completed,378.0,6.8,118,260,78,36,264,378,70,0,308,378,0,138,240,378,16,151,211,378,36,87,255,378
3955844,1797,380692,dpv1,completed,398.0,6.8,51,347,0,0,398,398,61,113,224,398,6,204,188,398,62,79,257,398,29,145,224,398
3955844,1797,380692,dpv2,completed,381.0,7.0,121,260,14,46,321,381,31,131,219,381,45,115,221,381,16,203,162,381,0,18,363,381
3955844,1797,380692,new-0.0,completed,332.0,7.0,160,172,63,14,255,332,35,0,297,332,55,61,216,332,0,60,272,332,69,16,247,332
3955844,1797,380692,new-0.5,completed,332.0,7.0,160,172,63,14,255,332,35,0,297,332,55,61,216,332,0,60,272,332,69,16,247,332
3955844,1797,380692,new-1.0,completed,347.0,6.9,138,209,69,31,247,347,29,4,314,347,0,41,306,347,86,86,175,347,85,16,246,347
2826295,1693,310811,base,completed,340.0,7.0,135,205,105,0,235,340,29,99,212,340,84,41,215,340,50,0,290,340,0,94,246,340
2826295,1693,310811,base+,completed,311.0,6.9,135,176,0,77,234,311,61,0,250,311,70,0,241,311,3,38,270,311,68,0,243,311
2826295,1693,310811,dpv1,completed,315.0,7.3,92,223,53,58,204,315,0,24,291,315,0,92,223,315,64,0,251,315,73,0,242,315
2826295,1693,310811,dpv2,completed,292.0,7.4,156,136,24,7,261,292,0,0,292,292,44,0,248,292,55,56,181,292,42,44,206,292
2826295,1693,310811,new-0.0,completed,301.0,7.05,188,113,52,14,235,301,72,18,211,301,0,0,301,301,59,9,233,301,66,0,235,301
2826295,1693,310811,new-0.5,completed,287.0,7.6,192,95,0,1,286,287,76,0,211,287,73,18,196,287,57,0,230,287,6,2,279,287
2826295,1693,310811,new-1.0,completed,293.0,7.6,151,142,50,0,243,293,43,0,250,293,26,66,201,293,72,0,221,293,0,15,278,293
2826295,1693,208428,base,completed,350.0,6.9,121,229,0,19,331,350,81,0,269,350,11,7,332,350,80,104,166,350,66,142,142,350
2826295,1693,208428,base+,completed,311.0,6.95,156,155,0,22,289,311,62,45,204,311,45,0,266,311,71,0,240,311,55,33,223,311
2826295,1693,208428,dpv1,completed,305.0,7.1,147,158,79,0,226,305,72,7,226,305,69,0,236,305,0,0,305,305,10,72,223,305
2826295,1693,208428,dpv2,completed,304.0,7.3,159,145,39,3,262,304,54,16,234,304,0,14,290,304,68,61,175,304,56,0,248,304
2826295,1693,208428,new-0.0,completed,307.0,7.1,189,118,68,0,239,307,86,13,208,307,0,14,293,307,70,0,237,307,51,26,230,307
2826295,1693,208428,new-0.5,completed,286.0,7.65,200,86,3,9,274,286,0,0,286,286,59,0,227,286,61,12,213,286,65,0,221,286
2826295,1693,208428,new-1.0,completed,322.0,7.6,143,179,87,0,235,322,83,7,232,322,0,18,304,322,56,12,254,322,41,73,208,322
2826295,1693,460300,base,completed,327.0,7.0,120,207,77,0,250,327,13,33,281,327,57,0,270,327,0,159,168,327,48,0,279,327
2826295,1693,460300,base+,completed,326.0,7.2,119,207,56,42,228,326,0,15,311,326,77,85,164,326,26,19,281,326,50,30,246,326
2826295,1693,460300,dpv1,completed,314.0,7.05,126,188,84,10,220,314,0,14,300,314,11,103,200,314,65,0,249,314,75,0,239,314
2826295,1693,460300,dpv2,completed,315.0,7.4,163,152,72,0,243,315,0,14,301,315,47,0,268,315,68,64,183,315,50,38,227,315
2826295,1693,460300,new-0.0,completed,314.0,7.0,194,120,72,0,242,314,106,14,194,314,0,19,295,314,66,0,248,314,56,22,236,314
2826295,1693,460300,new-0.5,completed,288.0,7.7,203,85,9,5,274,288,0,0,288,288,71,0,217,288,56,0,232,288,63,9,216,288
2826295,1693,460300,new-1.0,completed,308.0,7.6,173,135,64,0,244,308,54,2,252,308,0,14,294,308,77,0,231,308,26,56,226,308
2826295,1693,309704,base,completed,334.0,7.1,117,217,46,90,198,334,46,0,288,334,0,171,163,334,53,0,281,334,32,41,261,334
2826295,1693,309704,base+,completed,327.0,7.1,110,217,56,34,237,327,0,62,265,327,10,62,255,327,70,55,202,327,75,0,252,327
2826295,1693,309704,dpv1,completed,315.0,7.2,170,145,0,10,305,315,59,27,229,315,55,27,233,315,95,5,215,315,76,0,239,315
2826295,1693,309704,dpv2,completed,316.0,7.45,160,156,0,0,316,316,61,43,212,316,68,0,248,316,75,51,190,316,38,19,259,316
2826295,1693,309704,new-0.0,completed,305.0,7.1,197,108,59,0,246,305,0,16,289,305,84,0,221,305,71,0,234,305,46,33,226,305
2826295,1693,309704,new-0.5,completed,290.0,7.6,184,106,8,11,271,290,81,0,209,290,68,0,222,290,71,14,205,290,0,0,290,290
2826295,1693,309704,new-1.0,completed,308.0,7.6,118,190,76,0,232,308,6,102,200,308,0,0,308,308,25,12,271,308,71,0,237,308
2826295,1693,247588,base,completed,356.0,7.0,126,230,0,34,322,356,49,21,286,356,52,72,232,356,63,113,180,356,52,116,188,356
2826295,1693,247588,base+,completed,297.0,6.95,143,154,0,54,243,297,73,0,224,297,4,2,291,297,52,0,245,297,67,26,204,297
2826295,1693,247588,dpv1,completed,318.0,7.1,127,191,0,18,300,318,90,9,219,318,39,92,187,318,47,1,270,318,89,0,229,318
2826295,1693,247588,dpv2,completed,290.0,7.3,173,117,60,34,196,290,49,17,224,290,33,2,255,290,0,15,275,290,48,0,242,290
2826295,1693,247588,new-0.0,completed,301.0,6.85,194,107,64,0,237,301,52,12,237,301,95,0,206,301,47,15,239,301,0,28,273,301
2826295,1693,247588,new-0.5,completed,291.0,7.65,191,100,0,19,272,291,76,0,215,291,5,6,280,291,56,0,235,291,79,0,212,291
2826295,1693,247588,new-1.0,completed,288.0,7.6,121,167,2,64,222,288,58,32,198,288,42,0,246,288,18,13,257,288,0,2,286,288
2826295,1693,203195,base,completed,363.0,6.95,119,244,0,113,250,363,5,126,232,363,97,59,207,363,89,0,274,363,75,28,260,363
2826295,1693,203195,base+,completed,327.0,7.1,147,180,53,0,274,327,32,36,259,327,78,0,249,327,0,87,240,327,73,43,211,327
2826295,1693,203195,dpv1,completed,342.0,6.95,112,230,0,70,272,342,74,69,199,342,55,3,284,342,5,71,266,342,114,41,187,342
2826295,1693,203195,dpv2,completed,304.0,7.4,146,158,0,46,258,304,59,0,245,304,53,11,240,304,49,21,234,304,80,0,224,304
2826295,1693,203195,new-0.0,completed,304.0,7.0,184,120,68,0,236,304,86,19,199,304,0,0,304,304,68,0,236,304,55,23,226,304
2826295,1693,203195,new-0.5,completed,293.0,7.65,184,109,68,12,213,293,0,0,293,293,70,0,223,293,13,18,262,293,79,0,214,293
2826295,1693,203195,new-1.0,completed,290.0,7.65,132,158,26,8,256,290,0,88,202,290,62,0,228,290,59,0,231,290,0,0,290,290
2826295,1693,178029,base,completed,328.0,6.95,127,201,2,89,237,328,66,0,262,328,47,42,239,328,61,0,267,328,0,158,170,328
2826295,1693,178029,base+,completed,298.0,7.05,172,126,34,26,238,298,48,0,250,298,47,0,251,298,0,45,253,298,59,13,226,298
2826295,1693,178029,dpv1,completed,314.0,6.95,136,178,70,0,244,314,3,108,203,314,45,7,262,314,0,4,310,314,67,37,210,314
2826295,1693,178029,dpv2,completed,318.0,7.35,145,173,71,0,247,318,59,0,259,318,53,61,204,318,0,55,263,318,59,16,243,318
2826295,1693,178029,new-0.0,completed,309.0,6.95,189,120,68,0,241,309,88,18,203,309,0,15,294,309,52,15,242,309,51,9,249,309
2826295,1693,178029,new-0.5,completed,293.0,7.65,190,103,6,17,270,293,0,0,293,293,75,7,211,293,70,0,223,293,79,0,214,293
2826295,1693,178029,new-1.0,completed,283.0,7.7,152,131,16,10,257,283,0,0,283,283,57,5,221,283,40,0,243,283,19,64,200,283
2826295,1693,239735,base,completed,313.0,7.15,103,210,67,0,246,313,0,54,259,313,72,26,215,313,8,99,206,313,15,0,298,313
2826295,1693,239735,base+,completed,319.0,7.1,84,235,42,0,277,319,0,18,301,319,22,94,203,319,46,53,220,319,71,107,141,319
2826295,1693,239735,dpv1,completed,305.0,7.0,146,159,64,0,241,305,79,50,176,305,7,30,268,305,0,29,276,305,79,5,221,305
2826295,1693,239735,dpv2,completed,310.0,7.35,159,151,46,0,264,310,0,73,237,310,43,0,267,310,70,64,176,310,71,0,239,310
2826295,1693,239735,new-0.0,completed,299.0,7.0,196,103,69,0,230,299,0,17,282,299,84,0,215,299,53,0,246,299,52,14,233,299
2826295,1693,239735,new-0.5,completed,303.0,7.65,144,159,54,2,247,303,0,12,291,303,67,0,236,303,85,0,218,303,29,72,202,303
2826295,1693,239735,new-1.0,completed,297.0,7.55,150,147,46,8,243,297,67,0,230,297,0,9,288,297,67,0,230,297,17,72,208,297
2826295,1693,675528,base,completed,349.0,6.9,124,225,0,94,255,349,7,109,233,349,68,0,281,349,59,0,290,349,81,105,163,349
2826295,1693,675528,base+,completed,322.0,6.8,129,193,0,59,263,322,38,71,213,322,80,0,242,322,46,0,276,322,92,0,230,322
2826295,1693,675528,dpv1,completed,318.0,6.9,126,192,70,40,208,318,5,111,202,318,43,0,275,318,0,12,306,318,80,0,238,318
2826295,1693,675528,dpv2,completed,317.0,7.2,162,155,42,25,250,317,0,14,303,317,36,72,209,317,56,73,188,317,51,0,266,317
2826295,1693,675528,new-0.0,completed,307.0,7.1,180,127,51,16,240,307,0,14,293,307,89,20,198,307,44,13,250,307,67,0,240,307
2826295,1693,675528,new-0.5,completed,289.0,7.7,187,102,0,12,277,289,3,7,279,289,61,0,228,289,69,0,220,289,78,12,199,289
2826295,1693,675528,new-1.0,completed,291.0,7.6,162,129,39,0,252,291,45,4,242,291,0,2,289,291,60,0,231,291,8,65,218,291
2826295,1693,380692,base,completed,331.0,6.9,95,236,0,60,271,331,48,0,283,331,6,164,161,331,72,0,259,331,47,65,219,331
2826295,1693,380692,base+,completed,318.0,7.15,131,187,67,91,160,318,47,0,271,318,51,17,250,318,0,18,300,318,48,40,230,318
2826295,1693,380692,dpv1,completed,326.0,7.25,108,218,49,57,220,326,83,21,222,326,37,82,207,326,69,0,257,326,0,22,304,326
2826295,1693,380692,dpv2,completed,304.0,7.45,155,149,50,40,214,304,0,5,299,304,61,0,243,304,69,56,179,304,34,6,264,304
2826295,1693,380692,new-0.0,completed,297.0,7.0,185,112,0,0,297,297,74,15,208,297,79,0,218,297,56,0,241,297,38,18,241,297
2826295,1693,380692,new-0.5,completed,283.0,7.6,188,95,73,11,199,283,4,0,279,283,57,11,215,283,49,0,234,283,0,3,280,283
2826295,1693,380692,new-1.0,completed,296.0,7.7,139,157,21,65,210,296,0,24,272,296,28,11,257,296,63,0,233,296,51,9,236,296
5230743,1630,310811,base,completed,295.0,6.7,143,152,5,78,212,295,12,35,248,295,32,0,263,295,0,92,203,295,29,14,252,295
5230743,1630,310811,base+,completed,328.0,6.85,125,203,5,83,240,328,32,2,294,328,0,59,269,328,66,0,262,328,62,137,129,328
5230743,1630,310811,dpv1,completed,308.0,6.9,128,180,29,31,248,308,42,0,266,308,8,17,283,308,0,140,168,308,22,78,208,308
5230743,1630,310811,dpv2,completed,351.0,6.7,98,253,66,81,204,351,62,49,240,351,82,12,257,351,30,42,279,351,0,130,221,351
5230743,1630,310811,new-0.0,completed,288.0,6.75,162,126,22,12,254,288,85,0,203,288,0,61,227,288,32,0,256,288,34,14,240,288
5230743,1630,310811,new-0.5,completed,279.0,7.25,176,103,31,16,232,279,53,0,226,279,7,27,245,279,0,12,267,279,36,16,227,279
5230743,1630,310811,new-1.0,completed,273.0,7.35,190,83,23,0,250,273,0,31,242,273,53,0,220,273,15,1,257,273,65,5,203,273
5230743,1630,208428,base,completed,341.0,6.55,120,221,62,0,279,341,68,85,188,341,34,97,210,341,0,119,222,341,36,0,305,341
5230743,1630,208428,base+,completed,311.0,6.9,116,195,9,3,299,311,38,9,264,311,0,0,311,311,70,125,116,311,46,47,218,311
5230743,1630,208428,dpv1,completed,326.0,7.2,151,175,0,0,326,326,43,15,268,326,41,71,214,326,14,129,183,326,46,73,207,326
5230743,1630,208428,dpv2,completed,307.0,7.0,147,160,0,54,253,307,49,0,258,307,48,0,259,307,73,0,234,307,53,85,169,307
5230743,1630,208428,new-0.0,completed,296.0,6.75,182,114,0,25,271,296,41,0,255,296,80,34,182,296,27,5,264,296,67,0,229,296
5230743,1630,208428,new-0.5,completed,265.0,7.1,189,76,23,8,234,265,0,4,261,265,1,13,251,265,33,10,222,265,54,0,211,265
5230743,1630,208428,new-1.0,completed,300.0,7.5,183,117,0,0,300,300,87,29,184,300,61,1,238,300,32,23,245,300,61,4,235,300
5230743,1630,460300,base,completed,380.0,6.9,85,295,52,194,134,380,0,141,239,380,40,85,255,380,28,0,352,380,59,98,223,380
5230743,1630,460300,base+,completed,329.0,6.9,129,200,0,48,281,329,45,74,210,329,61,36,232,329,51,19,259,329,28,54,247,329
5230743,1630,460300,dpv1,completed,327.0,7.0,139,188,4,4,319,327,49,0,278,327,31,48,248,327,0,141,186,327,57,77,193,327
5230743,1630,460300,dpv2,completed,330.0,6.85,108,222,67,77,186,330,37,54,239,330,0,11,319,330,4,35,291,330,58,132,140,330
5230743,1630,460300,new-0.0,completed,270.0,7.15,178,92,65,12,193,270,0,7,263,270,16,0,254,270,31,4,235,270,25,15,230,270
5230743,1630,460300,new-0.5,completed,267.0,7.3,188,79,36,8,223,267,0,0,267,267,32,0,235,267,12,4,251,267,57,14,196,267
5230743,1630,460300,new-1.0,completed,277.0,7.45,194,83,20,14,243,277,50,0,227,277,55,12,210,277,0,14,263,277,35,2,240,277
5230743,1630,309704,base,completed,340.0,6.75,100,240,0,126,214,340,55,157,128,340,61,0,279,340,24,76,240,340,31,0,309,340
5230743,1630,309704,base+,completed,316.0,6.8,148,168,0,22,294,316,26,58,232,316,33,71,212,316,25,43,248,316,39,73,204,316
5230743,1630,309704,dpv1,completed,312.0,7.15,120,192,31,75,206,312,22,33,257,312,9,2,301,312,0,100,212,312,40,58,214,312
5230743,1630,309704,dpv2,completed,332.0,7.15,107,225,48,0,284,332,79,66,187,332,30,85,217,332,9,116,207,332,0,45,287,332
5230743,1630,309704,new-0.0,completed,279.0,7.0,175,104,39,2,238,279,0,38,241,279,34,0,245,279,65,0,214,279,23,17,239,279
5230743,1630,309704,new-0.5,completed,279.0,7.2,179,100,40,2,237,279,32,18,229,279,33,0,246,279,65,0,214,279,0,39,240,279
5230743,1630,309704,new-1.0,completed,295.0,7.35,177,118,91,0,204,295,31,25,239,295,55,6,234,295,39,6,250,295,0,48,247,295
5230743,1630,247588,base,completed,424.0,6.8,84,340,0,153,271,424,38,185,201,424,74,139,211,424,94,125,205,424,92,0,332,424
5230743,1630,247588,base+,completed,344.0,6.9,99,245,0,11,333,344,74,158,112,344,0,141,203,344,57,0,287,344,35,68,241,344
5230743,1630,247588,dpv1,completed,340.0,6.7,114,226,53,18,269,340,32,0,308,340,91,122,127,340,0,92,248,340,29,101,210,340
5230743,1630,247588,dpv2,completed,307.0,6.7,126,181,23,67,217,307,26,59,222,307,0,21,286,307,8,0,299,307,55,125,127,307
5230743,1630,247588,new-0.0,completed,250.0,7.15,170,80,56,2,192,250,6,1,243,250,0,0,250,250,16,7,227,250,27,20,203,250
5230743,1630,247588,new-0.5,completed,274.0,7.15,174,100,0,21,253,274,25,0,249,274,28,0,246,274,47,7,220,274,76,20,178,274
5230743,1630,247588,new-1.0,completed,292.0,7.3,171,121,35,0,257,292,0,51,241,292,72,24,196,292,21,0,271,292,81,19,192,292
5230743,1630,203195,base,completed,363.0,6.6,74,289,69,13,281,363,0,122,241,363,31,67,265,363,74,0,289,363,3,246,114,363
5230743,1630,203195,base+,completed,333.0,6.35,130,203,0,144,189,333,34,0,299,333,92,60,181,333,41,0,292,333,75,7,251,333
5230743,1630,203195,dpv1,completed,276.0,6.85,164,112,0,36,240,276,36,0,240,276,50,2,224,276,6,43,227,276,39,0,237,276
5230743,1630,203195,dpv2,completed,344.0,6.65,104,240,31,8,305,344,55,66,223,344,80,139,125,344,0,71,273,344,6,83,255,344
5230743,1630,203195,new-0.0,completed,280.0,7.0,164,116,0,19,261,280,34,14,232,280,80,0,200,280,30,0,250,280,35,26,219,280
5230743,1630,203195,new-0.5,completed,266.0,7.4,169,97,37,0,229,266,7,14,245,266,7,0,259,266,61,0,205,266,0,26,240,266
5230743,1630,203195,new-1.0,completed,292.0,7.45,179,113,0,24,268,292,90,19,183,292,41,14,237,292,49,0,243,292,35,5,252,292
5230743,1630,178029,base,completed,370.0,6.8,83,287,0,140,230,370,52,87,231,370,64,0,306,370,35,60,275,370,68,166,136,370
5230743,1630,178029,base+,completed,335.0,6.75,141,194,0,91,244,335,28,82,225,335,60,86,189,335,36,42,257,335,23,25,287,335
5230743,1630,178029,dpv1,completed,312.0,6.7,143,169,70,56,186,312,41,0,271,312,29,15,268,312,55,0,257,312,0,86,226,312
5230743,1630,178029,dpv2,completed,345.0,6.75,98,247,13,90,242,345,52,64,229,345,35,4,306,345,0,57,288,345,68,140,137,345
5230743,1630,178029,new-0.0,completed,276.0,7.1,195,81,33,1,242,276,35,5,236,276,64,1,211,276,0,28,248,276,37,0,239,276
5230743,1630,178029,new-0.5,completed,267.0,7.15,182,85,23,13,231,267,1,3,263,267,0,15,252,267,26,11,230,267,56,0,211,267
5230743,1630,178029,new-1.0,completed,279.0,7.35,195,84,27,0,252,279,0,32,247,279,38,0,241,279,27,5,247,279,57,12,210,279
5230743,1630,239735,base,completed,367.0,6.8,69,298,33,140,194,367,0,38,329,367,69,148,150,367,27,59,281,367,42,97,228,367
5230743,1630,239735,base+,completed,326.0,6.8,125,201,35,10,281,326,62,76,188,326,27,83,216,326,48,36,242,326,0,99,227,326
5230743,1630,239735,dpv1,completed,317.0,7.2,121,196,13,8,296,317,0,38,279,317,31,86,200,317,61,70,186,317,53,64,200,317
5230743,1630,239735,dpv2,completed,331.0,6.75,102,229,0,83,248,331,49,60,222,331,34,3,294,331,4,53,274,331,67,125,139,331
5230743,1630,239735,new-0.0,completed,267.0,6.75,170,97,0,26,241,267,32,0,235,267,18,9,240,267,69,0,198,267,25,6,236,267
5230743,1630,239735,new-0.5,completed,285.0,7.35,188,97,34,13,238,285,51,9,225,285,61,8,216,285,0,25,260,285,70,0,215,285
5230743,1630,239735,new-1.0,completed,284.0,7.25,174,110,80,0,204,284,25,23,236,284,62,11,211,284,32,3,249,284,0,49,235,284
5230743,1630,675528,base,completed,345.0,6.85,73,272,16,0,329,345,20,0,325,345,0,72,273,345,33,196,116,345,71,135,139,345
5230743,1630,675528,base+,completed,318.0,6.6,110,208,16,30,272,318,78,45,195,318,55,0,263,318,66,0,252,318,0,114,204,318
5230743,1630,675528,dpv1,completed,323.0,6.9,128,195,31,35,257,323,11,0,312,323,61,11,251,323,0,150,173,323,49,75,199,323
5230743,1630,675528,dpv2,completed,319.0,6.9,112,207,29,53,237,319,3,100,216,319,70,0,249,319,0,62,257,319,85,0,234,319
5230743,1630,675528,new-0.0,completed,290.0,6.75,171,119,26,6,258,290,0,34,256,290,82,16,192,290,35,0,255,290,44,15,231,290
5230743,1630,675528,new-0.5,completed,287.0,7.05,185,102,31,3,253,287,0,34,253,287,22,12,253,287,49,11,227,287,62,0,225,287
5230743,1630,675528,new-1.0,completed,290.0,7.35,190,100,26,0,264,290,0,48,242,290,53,4,233,290,32,4,254,290,71,17,202,290
5230743,1630,380692,base,completed,317.0,6.9,112,205,16,71,230,317,74,4,239,317,0,72,245,317,52,0,265,317,49,75,193,317
5230743,1630,380692,base+,completed,308.0,6.8,126,182,16,100,192,308,77,69,162,308,42,0,266,308,48,0,260,308,0,27,281,308
5230743,1630,380692,dpv1,completed,328.0,6.9,118,210,34,41,253,328,18,0,310,328,75,28,225,328,0,148,180,328,35,93,200,328
5230743,1630,380692,dpv2,completed,368.0,6.8,115,253,0,111,257,368,42,111,215,368,21,33,314,368,94,0,274,368,78,157,133,368
5230743,1630,380692,new-0.0,completed,268.0,6.9,183,85,25,16,227,268,0,18,250,268,29,0,239,268,6,0,262,268,52,17,199,268
5230743,1630,380692,new-0.5,completed,273.0,7.3,192,81,35,16,222,273,34,14,225,273,17,4,252,273,0,0,273,273,45,16,212,273
5230743,1630,380692,new-1.0,completed,278.0,7.25,184,94,30,20,228,278,55,39,184,278,27,0,251,278,9,15,254,278,0,6,272,278
3688779,1866,310811,base,completed,350.0,7.0,179,171,43,68,239,350,0,0,350,350,2,0,348,350,42,64,244,350,49,89,212,350
3688779,1866,310811,base+,completed,327.0,6.85,188,139,8,0,319,327,52,0,275,327,0,26,301,327,63,76,188,327,41,0,286,327
3688779,1866,310811,dpv1,completed,312.0,7.25,173,139,25,0,287,312,50,0,262,312,0,89,223,312,37,0,275,312,3,1,308,312
3688779,1866,310811,dpv2,completed,389.0,7.3,161,228,7,139,243,389,0,104,285,389,7,162,220,389,51,25,313,389,68,0,321,389
3688779,1866,310811,new-0.0,completed,304.0,7.15,237,67,67,0,237,304,40,0,264,304,1,0,303,304,48,0,256,304,0,0,304,304
3688779,1866,310811,new-0.5,completed,316.0,7.55,225,91,26,0,290,316,0,13,303,316,42,1,273,316,67,9,240,316,46,4,266,316
3688779,1866,310811,new-1.0,completed,310.0,7.5,186,124,25,17,268,310,29,37,244,310,75,0,235,310,0,0,310,310,30,5,275,310
3688779,1866,208428,base,completed,313.0,7.1,217,96,19,44,250,313,14,0,299,313,46,0,267,313,0,50,263,313,35,0,278,313
3688779,1866,208428,base+,completed,330.0,7.1,205,125,53,0,277,330,0,20,310,330,43,34,253,330,83,2,245,330,44,9,277,330
3688779,1866,208428,dpv1,completed,323.0,7.3,179,144,39,0,284,323,63,0,260,323,4,78,241,323,66,0,257,323,0,0,323,323
3688779,1866,208428,dpv2,completed,386.0,7.3,141,245,19,109,258,386,0,93,293,386,45,146,195,386,10,47,329,386,41,57,288,386
3688779,1866,208428,new-0.0,completed,301.0,7.25,234,67,47,0,254,301,0,0,301,301,22,6,273,301,59,2,240,301,46,0,255,301
3688779,1866,208428,new-0.5,completed,316.0,7.6,213,103,0,20,296,316,41,0,275,316,39,4,273,316,62,17,237,316,49,0,267,316
3688779,1866,208428,new-1.0,completed,309.0,7.4,205,104,0,0,309,309,25,19,265,309,49,0,260,309,64,0,245,309,2,23,284,309
3688779,1866,460300,base,completed,368.0,6.85,138,230,0,11,357,368,12,115,241,368,75,0,293,368,49,100,219,368,71,9,288,368
3688779,1866,460300,base+,completed,310.0,7.05,234,76,40,4,266,310,0,30,280,310,36,0,274,310,42,4,264,310,42,0,268,310
3688779,1866,460300,dpv1,completed,331.0,7.2,168,163,43,0,288,331,84,79,168,331,0,0,331,331,58,0,273,331,21,0,310,331
3688779,1866,460300,dpv2,completed,387.0,7.3,132,255,11,47,329,387,0,95,292,387,4,171,212,387,50,60,277,387,71,58,258,387
3688779,1866,460300,new-0.0,completed,313.0,7.2,226,87,43,0,270,313,0,0,313,313,22,12,279,313,73,0,240,313,75,0,238,313
3688779,1866,460300,new-0.5,completed,304.0,7.6,245,59,0,2,302,304,25,0,279,304,31,0,273,304,37,13,254,304,44,0,260,304
3688779,1866,460300,new-1.0,completed,310.0,7.4,196,114,32,19,259,310,0,41,269,310,23,0,287,310,12,0,298,310,48,18,244,310
3688779,1866,309704,base,completed,361.0,7.25,75,286,50,0,311,361,0,37,324,361,38,181,142,361,43,38,280,361,72,0,289,361
3688779,1866,309704,base+,completed,335.0,6.95,144,191,33,82,220,335,44,57,234,335,35,0,300,335,71,0,264,335,0,23,312,335
3688779,1866,309704,dpv1,completed,328.0,7.2,187,141,0,84,244,328,57,0,271,328,37,0,291,328,53,0,275,328,29,0,299,328
3688779,1866,309704,dpv2,completed,385.0,7.4,151,234,20,26,339,385,0,102,283,385,20,154,211,385,84,36,265,385,47,50,288,385
3688779,1866,309704,new-0.0,completed,302.0,7.2,221,81,0,0,302,302,34,0,268,302,30,0,272,302,40,0,262,302,81,0,221,302
3688779,1866,309704,new-0.5,completed,313.0,7.5,231,82,60,0,253,313,31,0,282,313,0,0,313,313,35,18,260,313,64,0,249,313
3688779,1866,309704,new-1.0,completed,318.0,7.45,201,117,0,11,307,318,39,12,267,318,14,0,304,318,67,0,251,318,54,27,237,318
3688779,1866,247588,base,completed,329.0,6.85,208,121,45,0,284,329,99,0,230,329,28,18,283,329,33,27,269,329,0,32,297,329
3688779,1866,247588,base+,completed,330.0,6.85,182,148,0,90,240,330,58,0,272,330,47,0,283,330,39,5,286,330,53,1,276,330
3688779,1866,247588,dpv1,completed,328.0,7.15,145,183,22,90,216,328,64,44,220,328,58,0,270,328,0,0,328,328,58,0,270,328
3688779,1866,247588,dpv2,completed,368.0,7.35,163,205,33,56,279,368,25,71,272,368,29,139,200,368,8,42,318,368,0,107,261,368
3688779,1866,247588,new-0.0,completed,296.0,7.2,230,66,53,0,243,296,5,0,291,296,66,0,230,296,0,0,296,296,57,0,239,296
3688779,1866,247588,new-0.5,completed,318.0,7.5,214,104,0,0,318,318,55,0,263,318,61,0,257,318,56,20,242,318,84,0,234,318
3688779,1866,247588,new-1.0,completed,323.0,7.4,186,137,61,0,262,323,58,21,244,323,0,0,323,323,34,0,289,323,63,62,198,323
3688779,1866,203195,base,completed,296.0,6.9,202,94,15,0,281,296,2,0,294,296,44,25,227,296,51,18,227,296,0,0,296,296
3688779,1866,203195,base+,completed,378.0,6.85,171,207,52,0,326,378,72,0,306,378,50,114,214,378,48,40,290,378,0,106,272,378
3688779,1866,203195,dpv1,completed,305.0,7.4,212,93,43,0,262,305,18,10,277,305,16,0,289,305,0,26,279,305,42,24,239,305
3688779,1866,203195,dpv2,completed,383.0,7.3,138,245,13,51,319,383,0,106,277,383,13,157,213,383,52,42,289,383,75,43,265,383
3688779,1866,203195,new-0.0,completed,301.0,7.05,237,64,0,4,297,301,34,0,267,301,26,0,275,301,46,0,255,301,60,0,241,301
3688779,1866,203195,new-0.5,completed,306.0,7.5,248,58,0,4,302,306,25,0,281,306,46,0,260,306,43,8,255,306,38,0,268,306
3688779,1866,203195,new-1.0,completed,309.0,7.45,198,111,0,0,309,309,28,14,267,309,8,0,301,309,72,0,237,309,48,25,236,309
3688779,1866,178029,base,completed,325.0,7.15,135,190,0,101,224,325,29,16,280,325,47,35,243,325,20,0,305,325,2,71,252,325
3688779,1866,178029,base+,completed,322.0,6.85,208,114,23,22,277,322,39,0,283,322,18,14,290,322,0,61,261,322,85,0,237,322
3688779,1866,178029,dpv1,completed,306.0,7.25,212,94,0,38,268,306,16,26,264,306,18,0,288,306,41,0,265,306,36,10,260,306
3688779,1866,178029,dpv2,completed,366.0,7.4,147,219,39,45,282,366,31,61,274,366,38,123,205,366,78,35,253,366,0,16,350,366
3688779,1866,178029,new-0.0,completed,298.0,7.3,245,53,0,0,298,298,38,0,260,298,8,0,290,298,46,0,252,298,53,0,245,298
3688779,1866,178029,new-0.5,completed,290.0,7.7,249,41,21,0,269,290,0,0,290,290,33,0,257,290,37,4,249,290,26,0,264,290
3688779,1866,178029,new-1.0,completed,295.0,7.45,204,91,0,3,292,295,9,35,251,295,13,0,282,295,46,0,249,295,20,19,256,295
3688779,1866,239735,base,completed,315.0,7.15,189,126,41,0,274,315,39,69,207,315,31,0,284,315,0,16,299,315,41,0,274,315
3688779,1866,239735,base+,completed,339.0,6.7,112,227,0,55,284,339,13,0,326,339,44,59,236,339,68,66,205,339,70,0,269,339
3688779,1866,239735,dpv1,completed,319.0,7.3,133,186,52,0,267,319,16,64,239,319,6,77,236,319,53,0,266,319,0,0,319,319
3688779,1866,239735,dpv2,completed,355.0,7.3,151,204,41,54,260,355,38,0,317,355,0,134,221,355,11,0,344,355,18,153,184,355
3688779,1866,239735,new-0.0,completed,299.0,7.05,237,62,62,0,237,299,0,0,299,299,57,0,242,299,41,0,258,299,49,0,250,299
3688779,1866,239735,new-0.5,completed,296.0,7.5,230,66,0,0,296,296,6,0,290,296,50,0,246,296,46,13,237,296,35,3,258,296
3688779,1866,239735,new-1.0,completed,313.0,7.55,188,125,29,16,268,313,35,35,243,313,73,0,240,313,0,3,310,313,39,15,259,313
3688779,1866,675528,base,completed,319.0,7.0,177,142,56,0,263,319,0,25,294,319,28,6,285,319,46,0,273,319,31,61,227,319
3688779,1866,675528,base+,completed,296.0,6.85,226,70,29,0,267,296,62,0,234,296,3,0,293,296,4,8,284,296,0,0,296,296
3688779,1866,675528,dpv1,completed,330.0,7.15,185,145,36,0,294,330,68,0,262,330,0,77,253,330,66,0,264,330,45,0,285,330
3688779,1866,675528,dpv2,completed,379.0,7.4,139,240,4,38,337,379,0,94,285,379,9,156,214,379,66,52,261,379,45,53,281,379
3688779,1866,675528,new-0.0,completed,287.0,7.2,246,41,0,0,287,287,16,0,271,287,13,0,274,287,41,0,246,287,23,0,264,287
3688779,1866,675528,new-0.5,completed,313.0,7.45,187,126,0,17,296,313,43,3,267,313,1,46,266,313,31,16,266,313,44,0,269,313
3688779,1866,675528,new-1.0,completed,312.0,7.4,175,137,22,10,280,312,23,45,244,312,0,0,312,312,83,0,229,312,24,14,274,312
3688779,1866,380692,base,completed,333.0,6.9,146,187,55,0,278,333,4,0,329,333,0,0,333,333,42,126,165,333,61,43,229,333
3688779,1866,380692,base+,completed,290.0,7.0,234,56,12,0,278,290,0,0,290,290,4,0,286,290,56,0,234,290,12,0,278,290
3688779,1866,380692,dpv1,completed,322.0,7.15,171,151,32,0,290,322,71,0,251,322,0,80,242,322,59,0,263,322,24,0,298,322
3688779,1866,380692,dpv2,completed,377.0,7.4,146,231,5,33,339,377,0,97,280,377,6,148,223,377,72,38,267,377,54,52,271,377
3688779,1866,380692,new-0.0,completed,280.0,7.2,246,34,0,0,280,280,23,0,257,280,6,0,274,280,34,0,246,280,23,0,257,280
3688779,1866,380692,new-0.5,completed,325.0,7.6,220,105,0,27,298,325,45,0,280,325,50,2,273,325,57,19,249,325,57,0,268,325
3688779,1866,380692,new-1.0,completed,298.0,7.35,189,109,0,22,276,298,0,35,263,298,10,0,288,298,53,0,245,298,3,23,272,298
5797483,1963,310811,base,completed,385.0,6.95,89,296,11,203,171,385,48,0,337,385,8,96,281,385,0,0,385,385,21,114,250,385
5797483,1963,310811,base+,completed,374.0,7.0,123,251,1,39,334,374,47,78,249,374,46,139,189,374,42,0,332,374,0,44,330,374
5797483,1963,310811,dpv1,completed,343.0,7.0,178,165,57,0,286,343,27,0,316,343,39,31,273,343,61,78,204,343,0,26,317,343
5797483,1963,310811,dpv2,completed,351.0,7.25,173,178,0,38,313,351,44,29,278,351,21,23,307,351,54,46,251,351,50,13,288,351
5797483,1963,310811,new-0.0,completed,321.0,7.2,208,113,23,29,269,321,30,33,258,321,6,4,311,321,58,9,254,321,0,9,312,321
5797483,1963,310811,new-0.5,completed,324.0,7.4,217,107,41,0,283,324,28,50,246,324,22,2,300,324,0,35,289,324,21,16,287,324
5797483,1963,310811,new-1.0,completed,361.0,7.4,137,224,74,53,234,361,19,0,342,361,0,21,340,361,62,0,299,361,71,94,196,361
5797483,1963,208428,base,completed,361.0,7.05,169,192,49,0,312,361,13,0,348,361,0,129,232,361,27,117,217,361,51,0,310,361
5797483,1963,208428,base+,completed,341.0,6.8,181,160,1,0,340,341,30,23,288,341,58,59,224,341,0,23,318,341,29,28,284,341
5797483,1963,208428,dpv1,completed,370.0,7.1,121,249,0,0,370,370,56,0,314,370,25,112,233,370,21,110,239,370,43,72,255,370
5797483,1963,208428,dpv2,completed,378.0,7.2,157,221,0,91,287,378,39,6,333,378,57,0,321,378,78,55,245,378,57,72,249,378
5797483,1963,208428,new-0.0,completed,320.0,7.2,180,140,0,27,293,320,23,32,265,320,2,0,318,320,44,30,246,320,20,36,264,320
5797483,1963,208428,new-0.5,completed,302.0,7.3,236,66,21,37,244,302,17,0,285,302,10,0,292,302,0,10,292,302,7,6,289,302
5797483,1963,208428,new-1.0,completed,364.0,7.4,148,216,66,45,253,364,30,0,334,364,0,31,333,364,54,0,310,364,55,120,189,364
5797483,1963,460300,base,completed,342.0,6.8,192,150,16,0,326,342,0,8,334,342,1,39,302,342,43,99,200,342,42,0,300,342
5797483,1963,460300,base+,completed,417.0,6.95,129,288,72,127,218,417,31,216,170,417,0,60,357,417,26,0,391,417,71,23,323,417
5797483,1963,460300,dpv1,completed,355.0,7.05,142,213,50,0,305,355,35,0,320,355,56,78,221,355,0,78,277,355,29,17,309,355
5797483,1963,460300,dpv2,completed,365.0,7.35,186,179,0,49,316,365,55,62,248,365,14,25,326,365,53,60,252,365,61,0,304,365
5797483,1963,460300,new-0.0,completed,330.0,7.2,177,153,0,28,302,330,19,50,261,330,2,0,328,330,40,33,257,330,17,32,281,330
5797483,1963,460300,new-0.5,completed,322.0,7.3,242,80,0,0,322,322,20,1,301,322,29,0,293,322,55,0,267,322,36,37,249,322
5797483,1963,460300,new-1.0,completed,381.0,7.4,138,243,89,31,261,381,41,14,326,381,0,16,365,381,76,0,305,381,70,111,200,381
5797483,1963,309704,base,completed,391.0,6.85,146,245,77,12,302,391,0,74,317,391,25,166,200,391,83,0,308,391,50,0,341,391
5797483,1963,309704,base+,completed,352.0,6.7,111,241,17,119,216,352,56,0,296,352,3,0,349,352,0,80,272,352,9,36,307,352
5797483,1963,309704,dpv1,completed,346.0,7.05,153,193,52,0,294,346,12,0,334,346,0,46,300,346,26,21,299,346,56,102,188,346
5797483,1963,309704,dpv2,completed,368.0,7.35,163,205,0,84,284,368,30,0,338,368,70,63,235,368,42,66,260,368,58,0,310,368
5797483,1963,309704,new-0.0,completed,319.0,7.2,202,117,17,29,273,319,20,40,259,319,6,1,312,319,42,20,257,319,0,13,306,319
5797483,1963,309704,new-0.5,completed,305.0,7.35,240,65,0,1,304,305,29,31,245,305,23,0,282,305,3,0,302,305,21,4,280,305
5797483,1963,309704,new-1.0,completed,335.0,7.45,211,124,0,8,327,335,9,32,294,335,54,34,247,335,35,0,300,335,74,17,244,335
5797483,1963,247588,base,completed,373.0,7.05,146,227,72,0,301,373,44,42,287,373,26,101,246,373,38,0,335,373,0,101,272,373
5797483,1963,247588,base+,completed,366.0,7.05,184,182,58,94,214,366,35,0,331,366,62,0,304,366,64,118,184,366,0,0,366,366
5797483,1963,247588,dpv1,completed,348.0,7.1,148,200,20,0,328,348,40,0,308,348,61,87,200,348,74,32,242,348,0,42,306,348
5797483,1963,247588,dpv2,completed,366.0,7.35,154,212,0,80,286,366,45,0,321,366,65,62,239,366,53,74,239,366,54,0,312,366
5797483,1963,247588,new-0.0,completed,327.0,7.2,186,141,43,32,252,327,46,34,247,327,0,0,327,327,51,28,248,327,6,9,312,327
5797483,1963,247588,new-0.5,completed,309.0,7.4,222,87,4,0,305,309,11,2,296,309,19,40,250,309,0,28,281,309,25,10,274,309
5797483,1963,247588,new-1.0,completed,342.0,7.4,145,197,57,41,244,342,16,3,323,342,0,11,331,342,39,0,303,342,38,97,207,342
5797483,1963,203195,base,completed,380.0,6.85,181,199,20,2,358,380,0,0,380,380,43,152,185,380,38,0,342,380,67,93,220,380
5797483,1963,203195,base+,completed,356.0,6.95,133,223,32,0,324,356,0,0,356,356,10,76,270,356,38,0,318,356,44,124,188,356
5797483,1963,203195,dpv1,completed,381.0,7.05,118,263,4,0,377,381,45,0,336,381,17,117,247,381,0,165,216,381,39,75,267,381
5797483,1963,203195,dpv2,completed,380.0,7.35,157,223,0,76,304,380,45,0,335,380,76,67,237,380,71,66,243,380,64,0,316,380
5797483,1963,203195,new-0.0,completed,329.0,7.2,174,155,22,38,269,329,26,37,266,329,0,0,329,329,52,33,244,329,0,29,300,329
5797483,1963,203195,new-0.5,completed,322.0,7.3,223,99,37,0,285,322,30,43,249,322,25,12,285,322,0,25,297,322,17,6,299,322
5797483,1963,203195,new-1.0,completed,369.0,7.4,141,228,72,51,246,369,21,0,348,369,0,31,338,369,56,0,313,369,62,107,200,369
5797483,1963,178029,base,completed,380.0,6.7,96,284,8,141,231,380,74,0,306,380,0,96,284,380,54,80,246,380,61,0,319,380
5797483,1963,178029,base+,completed,386.0,7.0,186,200,82,104,200,386,60,0,326,386,0,60,326,386,78,0,308,386,83,42,261,386
5797483,1963,178029,dpv1,completed,332.0,6.8,177,155,36,0,296,332,7,0,325,332,0,35,297,332,37,105,190,332,4,0,328,332
5797483,1963,178029,dpv2,completed,382.0,7.15,121,261,34,133,215,382,40,99,243,382,21,0,361,382,0,59,323,382,47,0,335,382
5797483,1963,178029,new-0.0,completed,330.0,7.2,174,156,27,31,272,330,31,38,261,330,15,0,315,330,47,36,247,330,0,20,310,330
5797483,1963,178029,new-0.5,completed,331.0,7.35,207,124,23,55,253,331,33,0,298,331,26,2,303,331,0,52,279,331,16,18,297,331
5797483,1963,178029,new-1.0,completed,377.0,7.4,138,239,71,46,260,377,33,0,344,377,0,40,337,377,54,0,323,377,71,101,205,377
5797483,1963,239735,base,completed,359.0,7.25,164,195,46,0,313,359,53,0,306,359,23,56,280,359,0,142,217,359,50,26,283,359
5797483,1963,239735,base+,completed,377.0,7.0,100,277,16,118,243,377,0,91,286,377,33,86,258,377,79,13,285,377,41,0,336,377
5797483,1963,239735,dpv1,completed,343.0,6.95,169,174,59,0,284,343,44,0,299,343,0,20,323,343,62,83,198,343,17,68,258,343
5797483,1963,239735,dpv2,completed,361.0,7.2,153,208,0,64,297,361,17,22,322,361,44,0,317,361,63,66,232,361,55,73,233,361
5797483,1963,239735,new-0.0,completed,307.0,7.2,206,101,0,2,305,307,39,34,234,307,6,0,301,307,39,9,259,307,38,17,252,307
5797483,1963,239735,new-0.5,completed,292.0,7.3,229,63,16,1,275,292,19,29,244,292,4,0,288,292,0,17,275,292,9,4,279,292
5797483,1963,239735,new-1.0,completed,345.0,7.4,148,197,64,49,232,345,25,0,320,345,0,6,339,345,52,0,293,345,55,96,194,345
5797483,1963,675528,base,completed,370.0,7.0,182,188,0,10,360,370,55,71,244,370,43,58,269,370,58,0,312,370,64,97,209,370
5797483,1963,675528,base+,completed,362.0,6.85,196,166,42,0,320,362,53,61,248,362,0,0,362,362,69,97,196,362,66,0,296,362
5797483,1963,675528,dpv1,completed,412.0,7.2,118,294,67,0,345,412,85,0,327,412,0,156,256,412,83,107,222,412,56,53,303,412
5797483,1963,675528,dpv2,completed,375.0,7.25,174,201,82,0,293,375,38,0,337,375,0,56,319,375,58,76,241,375,53,71,251,375
5797483,1963,675528,new-0.0,completed,345.0,7.1,163,182,42,32,271,345,42,40,263,345,0,38,307,345,10,0,335,345,56,39,250,345
5797483,1963,675528,new-0.5,completed,330.0,7.3,228,102,47,0,283,330,19,4,307,330,24,9,297,330,0,35,295,330,31,48,251,330
5797483,1963,675528,new-1.0,completed,369.0,7.35,132,237,49,0,320,369,54,71,244,369,59,53,257,369,14,0,355,369,0,103,266,369
5797483,1963,380692,base,completed,408.0,6.75,83,325,65,0,343,408,15,128,265,408,43,237,128,408,54,76,278,408,0,0,408,408
5797483,1963,380692,base+,completed,358.0,7.1,154,204,54,7,297,358,0,36,322,358,19,36,303,358,44,85,229,358,51,9,298,358
5797483,1963,380692,dpv1,completed,417.0,7.2,115,302,0,77,340,417,72,137,208,417,48,161,208,417,69,0,348,417,28,51,338,417
5797483,1963,380692,dpv2,completed,333.0,7.25,178,155,0,27,306,333,28,23,282,333,7,8,318,333,48,39,246,333,34,22,277,333
5797483,1963,380692,new-0.0,completed,331.0,7.15,226,105,0,33,298,331,19,0,312,331,22,18,291,331,78,0,253,331,28,53,250,331
5797483,1963,380692,new-0.5,completed,319.0,7.35,229,90,32,0,287,319,18,10,291,319,24,34,261,319,0,22,297,319,8,8,303,319
5797483,1963,380692,new-1.0,completed,374.0,7.4,147,227,83,57,234,374,50,0,324,374,0,20,354,374,60,0,314,374,77,95,202,374
2557936,1744,310811,base,completed,362.0,6.75,158,204,47,104,211,362,40,0,322,362,62,58,242,362,40,153,169,362,0,68,294,362
2557936,1744,310811,base+,completed,286.0,6.8,161,125,0,6,280,286,7,35,244,286,50,0,236,286,19,18,249,286,29,25,232,286
2557936,1744,310811,dpv1,completed,276.0,7.1,181,95,15,7,254,276,22,13,241,276,0,16,260,276,54,0,222,276,4,6,266,276
2557936,1744,310811,dpv2,completed,307.0,7.35,103,204,65,86,156,307,16,52,239,307,43,0,264,307,0,0,307,307,22,15,270,307
2557936,1744,310811,new-0.0,completed,292.0,7.2,177,115,30,11,251,292,72,12,208,292,28,5,259,292,46,0,246,292,0,34,258,292
2557936,1744,310811,new-0.5,completed,277.0,7.3,193,84,45,10,222,277,3,0,274,277,29,0,248,277,46,27,204,277,0,2,275,277
2557936,1744,310811,new-1.0,completed,294.0,7.45,179,115,47,21,226,294,37,0,257,294,0,49,245,294,44,11,239,294,1,31,262,294
2557936,1744,208428,base,completed,340.0,7.1,87,253,8,168,164,340,22,66,252,340,0,76,264,340,13,93,234,340,15,0,325,340
2557936,1744,208428,base+,completed,280.0,7.1,152,128,26,21,233,280,0,6,274,280,4,59,217,280,34,29,217,280,3,0,277,280
2557936,1744,208428,dpv1,completed,281.0,6.85,179,102,13,35,233,281,48,0,233,281,0,3,278,281,11,0,270,281,36,16,229,281
2557936,1744,208428,dpv2,completed,290.0,7.35,171,119,41,0,249,290,42,0,248,290,20,63,207,290,11,15,264,290,0,24,266,290
2557936,1744,208428,new-0.0,completed,299.0,7.1,167,132,13,31,255,299,0,45,254,299,48,0,251,299,46,15,238,299,43,21,235,299
2557936,1744,208428,new-0.5,completed,304.0,7.4,188,116,39,29,236,304,52,0,252,304,80,4,220,304,45,3,256,304,0,33,271,304
2557936,1744,208428,new-1.0,completed,310.0,7.4,171,139,65,58,187,310,38,0,272,310,17,22,271,310,48,16,246,310,0,25,285,310
2557936,1744,460300,base,completed,427.0,7.1,78,349,23,26,378,427,34,272,121,427,0,157,270,427,69,112,246,427,15,163,249,427
2557936,1744,460300,base+,completed,294.0,7.0,151,143,0,0,294,294,18,1,275,294,26,66,202,294,33,36,225,294,8,34,252,294
2557936,1744,460300,dpv1,completed,280.0,6.75,206,74,0,0,280,280,58,0,222,280,32,7,241,280,25,0,255,280,9,9,262,280
2557936,1744,460300,dpv2,completed,308.0,7.1,154,154,0,57,251,308,14,36,258,308,36,55,217,308,45,0,263,308,17,30,261,308
2557936,1744,460300,new-0.0,completed,281.0,7.2,188,93,13,18,250,281,21,18,242,281,47,10,224,281,0,0,281,281,39,5,237,281
2557936,1744,460300,new-0.5,completed,290.0,7.3,171,119,43,0,247,290,16,6,268,290,0,17,273,290,65,21,204,290,8,33,249,290
2557936,1744,460300,new-1.0,completed,280.0,7.55,192,88,14,0,266,280,0,0,280,280,35,39,206,280,29,0,251,280,25,29,226,280
2557936,1744,309704,base,completed,337.0,6.95,118,219,23,69,245,337,24,40,273,337,0,0,337,337,32,83,222,337,16,136,185,337
2557936,1744,309704,base+,completed,301.0,6.8,118,183,46,0,255,301,6,37,258,301,6,36,259,301,0,87,214,301,35,0,266,301
2557936,1744,309704,dpv1,completed,273.0,6.85,191,82,6,0,267,273,35,0,238,273,41,0,232,273,0,41,232,273,5,1,267,273
2557936,1744,309704,dpv2,completed,294.0,7.4,156,138,61,22,211,294,43,0,251,294,17,22,255,294,0,51,243,294,20,9,265,294
2557936,1744,309704,new-0.0,completed,280.0,7.15,187,93,12,24,244,280,1,31,248,280,33,0,247,280,0,12,268,280,40,10,230,280
2557936,1744,309704,new-0.5,completed,292.0,7.3,180,112,57,5,230,292,0,0,292,292,42,0,250,292,67,28,197,292,18,22,252,292
2557936,1744,309704,new-1.0,completed,299.0,7.45,193,106,9,42,248,299,40,0,259,299,46,16,237,299,43,18,238,299,0,19,280,299
2557936,1744,247588,base,completed,336.0,6.95,113,223,46,31,259,336,21,0,315,336,97,0,239,336,0,149,187,336,81,21,234,336
2557936,1744,247588,base+,completed,305.0,6.9,90,215,37,13,255,305,11,11,283,305,0,0,305,305,29,88,188,305,64,78,163,305
2557936,1744,247588,dpv1,completed,268.0,6.9,208,60,10,0,258,268,2,0,266,268,19,11,238,268,0,9,259,268,40,0,228,268
2557936,1744,247588,dpv2,completed,282.0,7.35,175,107,24,11,247,282,35,0,247,282,10,48,224,282,0,0,282,282,60,0,222,282
2557936,1744,247588,new-0.0,completed,275.0,7.2,184,91,14,29,232,275,18,12,245,275,43,7,225,275,0,0,275,275,42,10,223,275
2557936,1744,247588,new-0.5,completed,275.0,7.35,169,106,49,12,214,275,0,0,275,275,7,21,247,275,15,0,260,275,33,35,207,275
2557936,1744,247588,new-1.0,completed,292.0,7.45,175,117,48,21,223,292,46,0,246,292,8,53,231,292,41,16,235,292,0,17,275,292
2557936,1744,203195,base,completed,367.0,7.15,90,277,43,129,195,367,0,0,367,367,20,0,347,367,60,195,112,367,60,113,194,367
2557936,1744,203195,base+,completed,281.0,6.7,164,117,47,0,234,281,23,0,258,281,10,28,243,281,0,23,258,281,10,19,252,281
2557936,1744,203195,dpv1,completed,282.0,6.8,181,101,18,0,264,282,63,0,219,282,13,27,242,282,16,0,266,282,0,38,244,282
2557936,1744,203195,dpv2,completed,286.0,7.4,181,105,59,2,225,286,33,0,253,286,10,13,263,286,0,46,240,286,14,0,272,286
2557936,1744,203195,new-0.0,completed,287.0,7.1,153,134,23,26,238,287,0,18,269,287,24,17,246,287,73,0,214,287,36,5,246,287
2557936,1744,203195,new-0.5,completed,288.0,7.3,177,111,0,35,253,288,21,7,260,288,0,13,275,288,60,11,217,288,43,15,230,288
2557936,1744,203195,new-1.0,completed,314.0,7.5,168,146,20,32,262,314,39,0,275,314,59,61,194,314,45,22,247,314,0,37,277,314
2557936,1744,178029,base,completed,326.0,6.8,100,226,51,82,193,326,0,0,326,326,49,101,176,326,41,33,252,326,30,19,277,326
2557936,1744,178029,base+,completed,284.0,7.2,168,116,46,0,238,284,34,32,218,284,6,53,225,284,20,0,264,284,0,0,284,284
2557936,1744,178029,dpv1,completed,290.0,6.7,163,127,20,0,270,290,65,0,225,290,30,0,260,290,17,29,244,290,0,33,257,290
2557936,1744,178029,dpv2,completed,284.0,7.25,182,102,0,31,253,284,52,0,232,284,24,6,254,284,12,39,233,284,13,5,266,284
2557936,1744,178029,new-0.0,completed,277.0,7.0,169,108,58,18,201,277,0,25,252,277,18,7,252,277,19,10,248,277,21,0,256,277
2557936,1744,178029,new-0.5,completed,308.0,7.4,170,138,44,34,230,308,25,3,280,308,63,0,245,308,0,60,248,308,88,0,220,308
2557936,1744,178029,new-1.0,completed,320.0,7.45,167,153,46,54,220,320,46,0,274,320,58,21,241,320,64,16,240,320,0,48,272,320
2557936,1744,239735,base,completed,324.0,6.95,115,209,31,113,180,324,13,160,151,324,25,0,299,324,33,0,291,324,0,21,303,324
2557936,1744,239735,base+,completed,281.0,6.95,155,126,0,5,276,281,12,78,191,281,12,1,268,281,43,0,238,281,31,27,223,281
2557936,1744,239735,dpv1,completed,264.0,6.85,175,89,2,29,233,264,0,0,264,264,1,0,263,264,47,0,217,264,28,13,223,264
2557936,1744,239735,dpv2,completed,278.0,7.3,147,131,2,49,227,278,12,17,249,278,0,5,273,278,39,35,204,278,42,0,236,278
2557936,1744,239735,new-0.0,completed,272.0,7.25,158,114,0,6,266,272,13,26,233,272,23,5,244,272,23,0,249,272,56,27,189,272
2557936,1744,239735,new-0.5,completed,272.0,7.4,181,91,20,0,252,272,33,5,234,272,0,27,245,272,64,0,208,272,22,0,250,272
2557936,1744,239735,new-1.0,completed,303.0,7.5,156,147,15,18,270,303,49,3,251,303,66,42,195,303,59,22,222,303,0,33,270,303
2557936,1744,675528,base,completed,307.0,6.65,146,161,13,49,245,307,74,0,233,307,54,0,253,307,0,73,234,307,41,17,249,307
2557936,1744,675528,base+,completed,304.0,6.7,102,202,57,94,153,304,14,9,281,304,9,21,274,304,0,11,293,304,63,16,225,304
2557936,1744,675528,dpv1,completed,268.0,7.0,195,73,43,0,225,268,9,0,259,268,6,15,247,268,4,2,262,268,0,13,255,268
2557936,1744,675528,dpv2,completed,304.0,7.2,121,183,7,60,237,304,23,3,278,304,46,0,258,304,49,77,178,304,0,0,304,304
2557936,1744,675528,new-0.0,completed,282.0,7.2,190,92,22,17,243,282,13,21,248,282,58,0,224,282,0,1,281,282,37,2,243,282
2557936,1744,675528,new-0.5,completed,314.0,7.55,175,139,37,41,236,314,47,0,267,314,84,0,230,314,0,68,246,314,63,12,239,314
2557936,1744,675528,new-1.0,completed,310.0,7.45,178,132,7,58,245,310,40,0,270,310,53,35,222,310,46,21,243,310,0,34,276,310
2557936,1744,380692,base,completed,287.0,7.1,130,157,39,43,205,287,3,15,269,287,0,0,287,287,14,64,209,287,46,0,241,287
2557936,1744,380692,base+,completed,285.0,7.05,161,124,29,6,250,285,36,0,249,285,48,0,237,285,0,7,278,285,15,77,193,285
2557936,1744,380692,dpv1,completed,276.0,7.0,159,117,54,0,222,276,12,0,264,276,6,27,243,276,0,36,240,276,4,0,272,276
2557936,1744,380692,dpv2,completed,280.0,7.25,173,107,49,0,231,280,29,6,245,280,8,63,209,280,0,10,270,280,4,8,268,280
2557936,1744,380692,new-0.0,completed,291.0,6.95,161,130,39,23,229,291,72,22,197,291,30,1,260,291,0,15,276,291,30,12,249,291
2557936,1744,380692,new-0.5,completed,301.0,7.55,170,131,42,30,229,301,42,0,259,301,58,0,243,301,76,12,213,301,0,47,254,301
2557936,1744,380692,new-1.0,completed,296.0,7.45,179,117,5,50,241,296,0,0,296,296,23,26,247,296,44,11,241,296,32,41,223,296
1017411,1716,310811,base,completed,276.0,7.1,192,84,4,0,272,276,0,0,276,276,23,46,207,276,38,0,238,276,24,0,252,276
1017411,1716,310811,base+,completed,315.0,7.0,172,143,69,70,176,315,0,20,295,315,73,0,242,315,18,0,297,315,73,0,242,315
1017411,1716,310811,dpv1,completed,303.0,7.4,171,132,77,0,226,303,37,0,266,303,69,0,234,303,19,0,284,303,0,81,222,303
1017411,1716,310811,dpv2,completed,298.0,7.4,205,93,76,0,222,298,68,0,230,298,68,17,213,298,11,0,287,298,0,30,268,298
1017411,1716,310811,new-0.0,completed,257.0,7.2,218,39,12,0,245,257,33,0,224,257,9,0,248,257,39,0,218,257,0,0,257,257
1017411,1716,310811,new-0.5,completed,278.0,7.55,227,51,49,0,229,278,51,0,227,278,0,0,278,278,38,0,240,278,50,0,228,278
1017411,1716,310811,new-1.0,completed,271.0,7.6,166,105,17,0,254,271,26,79,166,271,0,0,271,271,0,0,271,271,5,0,266,271
1017411,1716,208428,base,completed,289.0,7.05,211,78,51,0,238,289,6,0,283,289,54,10,225,289,0,23,266,289,68,0,221,289
1017411,1716,208428,base+,completed,281.0,7.25,223,58,0,10,271,281,13,0,268,281,51,0,230,281,43,0,238,281,58,0,223,281
1017411,1716,208428,dpv1,completed,286.0,7.25,197,89,51,0,235,286,18,38,230,286,34,0,252,286,50,0,236,286,0,10,276,286
1017411,1716,208428,dpv2,completed,294.0,7.4,218,76,69,0,225,294,71,0,223,294,0,26,268,294,21,5,268,294,59,0,235,294
1017411,1716,208428,new-0.0,completed,259.0,7.3,223,36,36,0,223,259,0,0,259,259,5,0,254,259,11,0,248,259,29,0,230,259
1017411,1716,208428,new-0.5,completed,285.0,7.55,226,59,0,20,265,285,46,0,239,285,55,0,230,285,17,0,268,285,59,0,226,285
1017411,1716,208428,new-1.0,completed,276.0,7.5,187,89,5,0,271,276,19,45,212,276,0,0,276,276,4,59,213,276,18,0,258,276
1017411,1716,460300,base,completed,308.0,7.0,171,137,20,0,288,308,9,94,205,308,0,0,308,308,22,103,183,308,23,26,259,308
1017411,1716,460300,base+,completed,299.0,7.15,163,136,48,0,251,299,43,51,205,299,32,0,267,299,0,61,238,299,4,0,295,299
1017411,1716,460300,dpv1,completed,298.0,7.35,191,107,69,0,229,298,10,0,288,298,69,0,229,298,27,0,271,298,0,70,228,298
1017411,1716,460300,dpv2,completed,304.0,7.4,213,91,27,0,277,304,55,0,249,304,0,40,264,304,79,0,225,304,84,0,220,304
1017411,1716,460300,new-0.0,completed,277.0,7.3,220,57,30,0,247,277,51,6,220,277,0,0,277,277,43,0,234,277,51,0,226,277
1017411,1716,460300,new-0.5,completed,273.0,7.5,229,44,40,0,233,273,37,0,236,273,0,0,273,273,12,0,261,273,44,0,229,273
1017411,1716,460300,new-1.0,completed,280.0,7.55,173,107,5,19,256,280,34,0,246,280,0,54,226,280,22,0,258,280,16,0,264,280
1017411,1716,309704,base,completed,311.0,7.0,123,188,43,0,268,311,6,128,177,311,67,0,244,311,0,57,254,311,18,0,293,311
1017411,1716,309704,base+,completed,300.0,7.2,180,120,0,85,215,300,46,0,254,300,56,0,244,300,65,0,235,300,13,0,287,300
1017411,1716,309704,dpv1,completed,298.0,7.3,207,91,60,0,238,298,0,21,277,298,55,0,243,298,54,0,244,298,12,30,256,298
1017411,1716,309704,dpv2,completed,302.0,7.45,215,87,0,24,278,302,22,0,280,302,79,0,223,302,87,0,215,302,85,0,217,302
1017411,1716,309704,new-0.0,completed,292.0,7.3,219,73,73,0,219,292,70,0,222,292,41,0,251,292,0,0,292,292,65,0,227,292
1017411,1716,309704,new-0.5,completed,270.0,7.55,216,54,34,0,236,270,53,0,217,270,43,0,227,270,23,1,246,270,0,0,270,270
1017411,1716,309704,new-1.0,completed,284.0,7.4,166,118,5,0,279,284,38,33,213,284,0,0,284,284,8,68,208,284,32,12,240,284
1017411,1716,247588,base,completed,280.0,7.1,214,66,12,0,268,280,58,0,222,280,2,0,278,280,61,0,219,280,0,30,250,280
1017411,1716,247588,base+,completed,297.0,7.05,148,149,1,0,296,297,32,0,265,297,5,54,238,297,0,96,201,297,53,0,244,297
1017411,1716,247588,dpv1,completed,281.0,7.5,188,93,23,0,258,281,14,18,249,281,29,0,252,281,31,0,250,281,0,62,219,281
1017411,1716,247588,dpv2,completed,285.0,7.45,196,89,51,0,234,285,49,0,236,285,20,23,242,285,52,0,233,285,0,27,258,285
1017411,1716,247588,new-0.0,completed,269.0,7.25,219,50,0,0,269,269,37,0,232,269,45,0,224,269,5,0,264,269,50,0,219,269
1017411,1716,247588,new-0.5,completed,268.0,7.65,213,55,37,0,231,268,24,8,236,268,0,0,268,268,41,0,227,268,47,0,221,268
1017411,1716,247588,new-1.0,completed,272.0,7.55,172,100,11,0,261,272,32,20,220,272,10,0,262,272,0,54,218,272,18,14,240,272
1017411,1716,203195,base,completed,315.0,6.95,119,196,31,0,284,315,14,107,194,315,37,97,181,315,25,19,271,315,0,23,292,315
1017411,1716,203195,base+,completed,297.0,7.2,181,116,58,0,239,297,41,0,256,297,0,0,297,297,27,58,212,297,51,0,246,297
1017411,1716,203195,dpv1,completed,287.0,7.25,195,92,47,0,240,287,13,40,234,287,38,0,249,287,52,0,235,287,0,9,278,287
1017411,1716,203195,dpv2,completed,296.0,7.4,205,91,18,0,278,296,67,0,229,296,74,17,205,296,59,0,237,296,0,30,266,296
1017411,1716,203195,new-0.0,completed,294.0,7.2,211,83,83,0,211,294,66,0,228,294,47,0,247,294,0,0,294,294,60,0,234,294
1017411,1716,203195,new-0.5,completed,260.0,7.5,234,26,22,0,238,260,26,0,234,260,0,0,260,260,26,0,234,260,9,0,251,260
1017411,1716,203195,new-1.0,completed,281.0,7.6,175,106,29,4,248,281,40,31,210,281,1,0,280,281,0,62,219,281,6,0,275,281
1017411,1716,178029,base,completed,272.0,7.1,176,96,0,63,209,272,7,43,222,272,3,0,269,272,29,0,243,272,2,0,270,272
1017411,1716,178029,base+,completed,308.0,7.1,133,175,0,55,253,308,52,0,256,308,35,96,177,308,30,7,271,308,14,7,287,308
1017411,1716,178029,dpv1,completed,299.0,7.15,161,138,56,0,243,299,27,0,272,299,18,82,199,299,26,0,273,299,0,0,299,299
1017411,1716,178029,dpv2,completed,280.0,7.4,210,70,49,0,231,280,49,0,231,280,25,0,255,280,23,0,257,280,0,29,251,280
1017411,1716,178029,new-0.0,completed,259.0,7.2,228,31,3,0,256,259,30,0,229,259,0,0,259,259,31,0,228,259,5,0,254,259
1017411,1716,178029,new-0.5,completed,288.0,7.5,223,65,55,0,233,288,13,0,275,288,0,29,259,288,62,0,226,288,45,0,243,288
1017411,1716,178029,new-1.0,completed,282.0,7.5,173,109,0,0,282,282,3,31,248,282,24,12,246,282,33,64,185,282,14,0,268,282
1017411,1716,239735,base,completed,289.0,6.9,208,81,24,0,265,289,14,0,275,289,0,32,257,289,45,0,244,289,61,0,228,289
1017411,1716,239735,base+,completed,318.0,7.05,121,197,0,145,173,318,58,0,260,318,82,0,236,318,61,0,257,318,19,0,299,318
1017411,1716,239735,dpv1,completed,291.0,7.3,184,107,60,0,231,291,14,46,231,291,0,6,285,291,33,0,258,291,61,0,230,291
1017411,1716,239735,dpv2,completed,291.0,7.4,202,89,0,14,277,291,64,0,227,291,61,25,205,291,62,0,229,291,18,0,273,291
1017411,1716,239735,new-0.0,completed,269.0,7.25,214,55,0,0,269,269,44,0,225,269,49,0,220,269,24,0,245,269,55,0,214,269
1017411,1716,239735,new-0.5,completed,258.0,7.55,213,45,1,23,234,258,21,0,237,258,3,0,255,258,22,0,236,258,0,0,258,258
1017411,1716,239735,new-1.0,completed,283.0,7.65,185,98,35,2,246,283,0,20,263,283,28,0,255,283,16,53,214,283,43,0,240,283
1017411,1716,675528,base,completed,318.0,7.15,114,204,0,163,155,318,69,0,249,318,66,0,252,318,19,0,299,318,47,0,271,318
1017411,1716,675528,base+,completed,273.0,7.2,226,47,45,0,228,273,0,0,273,273,46,0,227,273,30,0,243,273,34,1,238,273
1017411,1716,675528,dpv1,completed,295.0,7.35,165,130,72,0,223,295,39,0,256,295,36,54,205,295,17,14,264,295,0,20,275,295
1017411,1716,675528,dpv2,completed,291.0,7.45,208,83,44,0,247,291,35,0,256,291,62,0,229,291,22,0,269,291,0,33,258,291
1017411,1716,675528,new-0.0,completed,275.0,7.25,226,49,0,0,275,275,49,0,226,275,49,0,226,275,12,0,263,275,39,0,236,275
1017411,1716,675528,new-0.5,completed,284.0,7.55,223,61,41,0,243,284,0,0,284,284,57,4,223,284,41,0,243,284,42,0,242,284
1017411,1716,675528,new-1.0,completed,273.0,7.55,185,88,0,0,273,273,30,19,224,273,10,0,263,273,3,46,224,273,24,12,237,273
1017411,1716,380692,base,completed,303.0,6.9,134,169,26,0,277,303,10,0,293,303,0,111,192,303,52,30,221,303,55,0,248,303
1017411,1716,380692,base+,completed,255.0,6.95,230,25,12,0,243,255,0,0,255,255,16,0,239,255,10,9,236,255,1,0,254,255
1017411,1716,380692,dpv1,completed,300.0,7.25,154,146,11,0,289,300,0,53,247,300,48,98,154,300,15,0,285,300,46,0,254,300
1017411,1716,380692,dpv2,completed,268.0,7.4,219,49,31,0,237,268,49,0,219,268,42,0,226,268,17,0,251,268,0,7,261,268
1017411,1716,380692,new-0.0,completed,249.0,7.3,225,24,6,0,243,249,0,0,249,249,9,0,240,249,24,0,225,249,14,0,235,249
1017411,1716,380692,new-0.5,completed,276.0,7.55,205,71,26,20,230,276,18,0,258,276,0,0,276,276,43,0,233,276,51,0,225,276
1017411,1716,380692,new-1.0,completed,283.0,7.4,147,136,16,0,267,283,9,0,274,283,43,57,183,283,0,32,251,283,27,6,250,283
6269087,1774,310811,base,completed,450.0,6.9,128,322,32,231,187,450,72,0,378,450,30,164,256,450,0,155,295,450,43,258,149,450
6269087,1774,310811,base+,completed,366.0,6.85,125,241,70,0,296,366,48,155,163,366,0,3,363,366,71,106,189,366,20,50,296,366
6269087,1774,310811,dpv1,completed,350.0,7.35,102,248,67,10,273,350,21,91,238,350,43,178,129,350,49,0,301,350,0,21,329,350
6269087,1774,310811,dpv2,completed,337.0,7.1,140,197,24,52,261,337,0,100,237,337,44,102,191,337,64,0,273,337,48,0,289,337
6269087,1774,310811,new-0.0,completed,308.0,7.05,145,163,0,34,274,308,46,52,210,308,61,0,247,308,12,0,296,308,12,67,229,308
6269087,1774,310811,new-0.5,completed,287.0,7.35,154,133,1,48,238,287,3,0,284,287,45,44,198,287,44,2,241,287,0,0,287,287
6269087,1774,310811,new-1.0,completed,321.0,7.75,138,183,42,7,272,321,2,7,312,321,46,68,207,321,0,125,196,321,1,31,289,321
6269087,1774,208428,base,completed,345.0,6.9,112,233,17,0,328,345,0,0,345,345,11,185,149,345,63,0,282,345,48,87,210,345
6269087,1774,208428,base+,completed,306.0,7.05,153,153,10,18,278,306,59,0,247,306,0,96,210,306,22,24,260,306,33,0,273,306
6269087,1774,208428,dpv1,completed,359.0,7.35,103,256,72,10,277,359,25,96,238,359,43,182,134,359,44,0,315,359,0,30,329,359
6269087,1774,208428,dpv2,completed,337.0,7.35,155,182,71,0,266,337,0,62,275,337,23,28,286,337,41,65,231,337,42,73,222,337
6269087,1774,208428,new-0.0,completed,299.0,7.3,158,141,0,36,263,299,41,55,203,299,48,0,251,299,12,53,234,299,3,2,294,299
6269087,1774,208428,new-0.5,completed,296.0,7.3,169,127,0,25,271,296,15,0,281,296,28,51,217,296,48,6,242,296,54,0,242,296
6269087,1774,208428,new-1.0,completed,348.0,7.7,122,226,50,0,298,348,18,35,295,348,85,65,198,348,49,104,195,348,0,43,305,348
6269087,1774,460300,base,completed,568.0,6.9,101,467,0,422,146,568,72,312,184,568,30,328,210,568,53,258,257,568,64,0,504,568
6269087,1774,460300,base+,completed,338.0,7.1,165,173,47,29,262,338,86,0,252,338,71,0,267,338,24,35,279,338,0,126,212,338
6269087,1774,460300,dpv1,completed,346.0,7.25,93,253,17,40,289,346,56,52,238,346,0,30,316,346,41,1,304,346,29,185,132,346
6269087,1774,460300,dpv2,completed,311.0,7.3,127,184,15,37,259,311,43,0,268,311,0,29,282,311,46,55,210,311,18,68,225,311
6269087,1774,460300,new-0.0,completed,311.0,7.2,154,157,35,26,250,311,0,32,279,311,40,51,220,311,22,4,285,311,76,28,207,311
6269087,1774,460300,new-0.5,completed,288.0,7.5,180,108,30,27,231,288,22,3,263,288,0,37,251,288,44,0,244,288,10,12,266,288
6269087,1774,460300,new-1.0,completed,332.0,7.35,164,168,0,42,290,332,81,0,251,332,62,0,270,332,46,93,193,332,15,54,263,332
6269087,1774,309704,base,completed,418.0,6.9,105,313,0,69,349,418,67,211,140,418,12,0,406,418,65,106,247,418,47,216,155,418
6269087,1774,309704,base+,completed,373.0,6.95,128,245,0,62,311,373,105,52,216,373,49,35,289,373,73,101,199,373,22,87,264,373
6269087,1774,309704,dpv1,completed,367.0,7.25,124,243,83,16,268,367,28,128,211,367,80,157,130,367,0,27,340,367,52,0,315,367
6269087,1774,309704,dpv2,completed,333.0,7.35,146,187,57,0,276,333,0,107,226,333,26,106,201,333,20,34,279,333,44,0,289,333
6269087,1774,309704,new-0.0,completed,298.0,7.1,172,126,0,15,283,298,47,26,225,298,42,8,248,298,19,9,270,298,22,34,242,298
6269087,1774,309704,new-0.5,completed,281.0,7.3,172,109,0,7,274,281,1,0,280,281,41,12,228,281,45,2,234,281,15,50,216,281
6269087,1774,309704,new-1.0,completed,340.0,7.5,152,188,0,58,282,340,19,13,308,340,81,11,248,340,49,102,189,340,67,48,225,340
6269087,1774,247588,base,completed,356.0,7.1,109,247,39,4,313,356,24,121,211,356,0,173,183,356,70,33,253,356,27,0,329,356
6269087,1774,247588,base+,completed,368.0,7.15,87,281,28,105,235,368,12,237,119,368,29,0,339,368,0,0,368,368,77,76,215,368
6269087,1774,247588,dpv1,completed,345.0,7.25,94,251,14,59,272,345,72,49,224,345,0,33,312,345,34,3,308,345,49,179,117,345
6269087,1774,247588,dpv2,completed,319.0,7.3,122,197,19,39,261,319,0,105,214,319,23,97,199,319,41,0,278,319,46,0,273,319
6269087,1774,247588,new-0.0,completed,309.0,7.2,152,157,36,28,245,309,64,4,241,309,40,48,221,309,0,30,279,309,21,29,259,309
6269087,1774,247588,new-0.5,completed,295.0,7.4,163,132,0,46,249,295,24,0,271,295,27,22,246,295,47,8,240,295,30,18,247,295
6269087,1774,247588,new-1.0,completed,346.0,7.45,142,204,0,148,198,346,18,24,304,346,74,9,263,346,41,30,275,346,59,52,235,346
6269087,1774,203195,base,completed,357.0,6.85,108,249,56,0,301,357,39,154,164,357,0,210,147,357,28,0,329,357,9,0,348,357
6269087,1774,203195,base+,completed,361.0,6.85,133,228,78,29,254,361,0,33,328,361,44,104,213,361,64,110,187,361,23,42,296,361
6269087,1774,203195,dpv1,completed,357.0,7.3,104,253,25,45,287,357,80,72,205,357,55,173,129,357,47,2,308,357,0,24,333,357
6269087,1774,203195,dpv2,completed,334.0,7.4,127,207,43,0,291,334,0,109,225,334,32,86,216,334,22,44,268,334,62,0,272,334
6269087,1774,203195,new-0.0,completed,315.0,7.05,140,175,21,34,260,315,0,32,283,315,27,65,223,315,65,0,250,315,23,54,238,315
6269087,1774,203195,new-0.5,completed,276.0,7.25,171,105,24,4,248,276,0,5,271,276,2,28,246,276,42,0,234,276,2,31,243,276
6269087,1774,203195,new-1.0,completed,355.0,7.55,120,235,83,46,226,355,45,0,310,355,23,68,264,355,49,108,198,355,0,68,287,355
6269087,1774,178029,base,completed,335.0,7.05,122,213,29,0,306,335,0,26,309,335,47,141,147,335,1,0,334,335,25,154,156,335
6269087,1774,178029,base+,completed,348.0,7.0,133,215,0,101,247,348,40,22,286,348,72,110,166,348,13,58,277,348,61,0,287,348
6269087,1774,178029,dpv1,completed,348.0,7.3,93,255,58,8,282,348,12,75,261,348,0,28,320,348,40,0,308,348,35,187,126,348
6269087,1774,178029,dpv2,completed,322.0,7.35,143,179,15,35,272,322,62,0,260,322,0,42,280,322,41,55,226,322,29,67,226,322
6269087,1774,178029,new-0.0,completed,305.0,7.3,175,130,0,49,256,305,13,0,292,305,34,65,206,305,9,59,237,305,37,0,268,305
6269087,1774,178029,new-0.5,completed,284.0,7.4,186,98,6,18,260,284,0,0,284,284,27,0,257,284,16,19,249,284,42,19,223,284
6269087,1774,178029,new-1.0,completed,336.0,7.4,159,177,0,55,281,336,65,0,271,336,6,0,330,336,44,97,195,336,64,68,204,336
6269087,1774,239735,base,completed,422.0,7.15,102,320,34,153,235,422,68,0,354,422,0,197,225,422,60,148,214,422,11,155,256,422
6269087,1774,239735,base+,completed,370.0,7.1,100,270,0,108,262,370,88,76,206,370,21,20,329,370,55,171,144,370,45,0,325,370
6269087,1774,239735,dpv1,completed,355.0,7.1,106,249,55,13,287,355,36,113,206,355,0,35,320,355,15,52,288,355,66,164,125,355
6269087,1774,239735,dpv2,completed,315.0,7.3,145,170,70,21,224,315,0,47,268,315,41,18,256,315,37,66,212,315,15,22,278,315
6269087,1774,239735,new-0.0,completed,303.0,7.25,141,162,52,39,212,303,0,0,303,303,33,69,201,303,11,2,290,303,0,65,238,303
6269087,1774,239735,new-0.5,completed,286.0,7.25,166,120,20,15,251,286,0,17,269,286,24,46,216,286,36,0,250,286,49,0,237,286
6269087,1774,239735,new-1.0,completed,314.0,7.5,157,157,5,40,269,314,0,0,314,314,65,0,249,314,45,74,195,314,66,46,202,314
6269087,1774,675528,base,completed,396.0,7.1,101,295,23,177,196,396,52,0,344,396,50,9,337,396,0,245,151,396,18,143,235,396
6269087,1774,675528,base+,completed,375.0,7.15,105,270,35,101,239,375,7,92,276,375,0,28,347,375,49,0,326,375,38,195,142,375
6269087,1774,675528,dpv1,completed,378.0,7.35,88,290,76,32,270,378,23,112,243,378,50,201,127,378,49,0,329,378,0,40,338,378
6269087,1774,675528,dpv2,completed,423.0,7.35,119,304,39,0,384,423,66,179,178,423,0,218,205,423,17,168,238,423,89,52,282,423
6269087,1774,675528,new-0.0,completed,327.0,7.3,158,169,37,54,236,327,22,0,305,327,36,72,219,327,69,55,203,327,0,26,301,327
6269087,1774,675528,new-0.5,completed,282.0,7.25,184,98,0,3,279,282,5,0,277,282,3,51,228,282,43,0,239,282,52,1,229,282
6269087,1774,675528,new-1.0,completed,366.0,7.55,110,256,85,59,222,366,48,0,318,366,21,67,278,366,66,128,172,366,0,57,309,366
6269087,1774,380692,base,completed,351.0,7.05,119,232,46,152,153,351,6,9,336,351,49,0,302,351,0,6,345,351,32,164,155,351
6269087,1774,380692,base+,completed,312.0,6.85,135,177,0,62,250,312,8,27,277,312,38,10,264,312,34,0,278,312,14,101,197,312
6269087,1774,380692,dpv1,completed,369.0,7.35,103,266,74,12,283,369,22,114,233,369,54,181,134,369,48,3,318,369,0,37,332,369
6269087,1774,380692,dpv2,completed,342.0,7.3,158,184,16,66,260,342,40,72,230,342,0,62,280,342,44,64,234,342,82,0,260,342
6269087,1774,380692,new-0.0,completed,301.0,7.15,152,149,12,72,217,301,1,0,300,301,36,38,227,301,0,44,257,301,53,6,242,301
6269087,1774,380692,new-0.5,completed,288.0,7.4,155,133,53,8,227,288,2,0,286,288,16,28,244,288,0,16,272,288,33,28,227,288
6269087,1774,380692,new-1.0,completed,339.0,7.5,110,229,0,45,294,339,13,27,299,339,57,119,163,339,39,6,294,339,55,64,220,339
1277473,1600,310811,base,completed,268.0,6.95,191,77,40,10,218,268,44,0,224,268,0,0,268,268,29,1,238,268,66,0,202,268
1277473,1600,310811,base+,completed,285.0,7.05,159,126,46,21,218,285,23,50,212,285,45,0,240,285,76,0,209,285,0,5,280,285
1277473,1600,310811,dpv1,completed,317.0,7.3,129,188,33,90,194,317,0,7,310,317,72,0,245,317,45,93,179,317,87,0,230,317
1277473,1600,310811,dpv2,completed,264.0,7.45,154,110,21,0,243,264,21,50,193,264,34,0,230,264,60,0,204,264,0,6,258,264
1277473,1600,310811,new-0.0,completed,246.0,7.25,190,56,27,0,219,246,56,0,190,246,24,0,222,246,21,0,225,246,0,0,246,246
1277473,1600,310811,new-0.5,completed,280.0,7.7,155,125,20,36,224,280,30,0,250,280,54,0,226,280,0,35,245,280,69,20,191,280
1277473,1600,310811,new-1.0,completed,285.0,7.85,159,126,36,36,213,285,77,0,208,285,50,0,235,285,0,0,285,285,78,12,195,285
1277473,1600,208428,base,completed,301.0,6.8,134,167,72,0,229,301,25,95,181,301,73,0,228,301,31,14,256,301,0,29,272,301
1277473,1600,208428,base+,completed,276.0,6.9,181,95,57,12,207,276,47,0,229,276,0,6,270,276,83,0,193,276,27,0,249,276
1277473,1600,208428,dpv1,completed,277.0,7.2,131,146,0,0,277,277,32,0,245,277,72,0,205,277,36,67,174,277,23,17,237,277
1277473,1600,208428,dpv2,completed,272.0,7.7,163,109,0,0,272,272,38,0,234,272,63,0,209,272,27,46,199,272,34,0,238,272
1277473,1600,208428,new-0.0,completed,261.0,7.1,186,75,32,0,229,261,75,0,186,261,0,0,261,261,45,0,216,261,33,0,228,261
1277473,1600,208428,new-0.5,completed,274.0,7.6,186,88,75,0,199,274,0,0,274,274,48,0,226,274,29,13,232,274,73,0,201,274
1277473,1600,208428,new-1.0,completed,293.0,7.8,157,136,42,29,222,293,0,0,293,293,88,0,205,293,71,0,222,293,77,19,197,293
1277473,1600,460300,base,completed,297.0,7.2,195,102,59,0,238,297,51,33,213,297,24,0,273,297,63,0,234,297,0,78,219,297
1277473,1600,460300,base+,completed,279.0,7.3,186,93,84,0,195,279,52,9,218,279,39,0,240,279,25,0,254,279,0,22,257,279
1277473,1600,460300,dpv1,completed,301.0,7.15,136,165,25,86,190,301,38,0,263,301,74,0,227,301,34,83,184,301,0,13,288,301
1277473,1600,460300,dpv2,completed,271.0,7.65,169,102,66,0,205,271,0,0,271,271,40,0,231,271,33,36,202,271,16,0,255,271
1277473,1600,460300,new-0.0,completed,263.0,7.05,210,53,0,0,263,263,51,0,212,263,53,0,210,263,43,0,220,263,38,0,225,263
1277473,1600,460300,new-0.5,completed,294.0,7.7,174,120,86,15,193,294,0,0,294,294,64,0,230,294,41,23,230,294,84,11,199,294
1277473,1600,460300,new-1.0,completed,283.0,7.85,167,116,35,25,223,283,70,0,213,283,56,0,227,283,0,0,283,283,79,12,192,283
1277473,1600,309704,base,completed,262.0,6.9,182,80,50,20,192,262,33,6,223,262,0,0,262,262,60,0,202,262,36,0,226,262
1277473,1600,309704,base+,completed,250.0,6.85,205,45,29,0,221,250,0,9,241,250,45,0,205,250,11,0,239,250,21,0,229,250
1277473,1600,309704,dpv1,completed,276.0,7.2,135,141,0,1,275,276,75,0,201,276,25,22,229,276,38,58,180,276,26,0,250,276
1277473,1600,309704,dpv2,completed,266.0,7.75,184,82,44,0,222,266,60,0,206,266,0,0,266,266,29,22,215,266,37,0,229,266
1277473,1600,309704,new-0.0,completed,263.0,7.25,184,79,48,0,215,263,76,0,187,263,56,0,207,263,34,3,226,263,0,0,263,263
1277473,1600,309704,new-0.5,completed,274.0,7.65,184,90,80,0,194,274,0,0,274,274,51,0,223,274,29,10,235,274,72,0,202,274
1277473,1600,309704,new-1.0,completed,270.0,7.7,173,97,23,19,228,270,45,0,225,270,0,17,253,270,17,0,253,270,69,9,192,270
1277473,1600,247588,base,completed,305.0,7.2,126,179,26,36,243,305,39,0,266,305,0,72,233,305,42,91,172,305,27,41,237,305
1277473,1600,247588,base+,completed,268.0,7.1,168,100,35,42,191,268,43,14,211,268,54,0,214,268,0,0,268,268,58,0,210,268
1277473,1600,247588,dpv1,completed,269.0,7.2,128,141,0,5,264,269,32,0,237,269,73,0,196,269,40,59,170,269,20,13,236,269
1277473,1600,247588,dpv2,completed,262.0,7.65,178,84,0,7,255,262,37,0,225,262,21,27,214,262,57,0,205,262,36,0,226,262
1277473,1600,247588,new-0.0,completed,259.0,7.05,199,60,0,0,259,259,54,0,205,259,56,0,203,259,60,0,199,259,36,0,223,259
1277473,1600,247588,new-0.5,completed,286.0,7.7,153,133,22,44,220,286,22,0,264,286,59,8,219,286,0,45,241,286,63,26,197,286
1277473,1600,247588,new-1.0,completed,253.0,7.7,171,82,17,26,210,253,43,0,210,253,0,11,242,253,7,0,246,253,51,5,197,253
1277473,1600,203195,base,completed,309.0,7.1,147,162,69,0,240,309,60,66,183,309,59,53,197,309,0,39,270,309,28,0,281,309
1277473,1600,203195,base+,completed,277.0,7.05,168,109,0,18,259,277,55,0,222,277,37,35,205,277,20,54,203,277,32,0,245,277
1277473,1600,203195,dpv1,completed,290.0,7.15,125,165,25,79,186,290,19,0,271,290,0,17,273,290,70,0,220,290,31,88,171,290
1277473,1600,203195,dpv2,completed,271.0,7.65,134,137,0,23,248,271,20,63,188,271,74,0,197,271,25,0,246,271,22,0,249,271
1277473,1600,203195,new-0.0,completed,262.0,7.1,185,77,46,0,216,262,57,0,205,262,0,0,262,262,77,0,185,262,38,0,224,262
1277473,1600,203195,new-0.5,completed,283.0,7.7,150,133,26,44,213,283,23,0,260,283,70,0,213,283,0,30,253,283,68,19,196,283
1277473,1600,203195,new-1.0,completed,278.0,7.85,178,100,0,0,278,278,74,0,204,278,58,0,220,278,36,20,222,278,80,0,198,278
1277473,1600,178029,base,completed,326.0,7.0,115,211,30,134,162,326,31,44,251,326,18,130,178,326,0,45,281,326,73,0,253,326
1277473,1600,178029,base+,completed,286.0,7.15,137,149,0,23,263,286,41,37,208,286,33,0,253,286,24,74,188,286,75,0,211,286
1277473,1600,178029,dpv1,completed,282.0,7.25,144,138,27,59,196,282,39,0,243,282,0,0,282,282,79,0,203,282,36,33,213,282
1277473,1600,178029,dpv2,completed,267.0,7.7,188,79,0,13,254,267,22,0,245,267,33,0,234,267,22,27,218,267,52,0,215,267
1277473,1600,178029,new-0.0,completed,260.0,7.25,181,79,65,0,195,260,79,0,181,260,0,0,260,260,26,0,234,260,31,0,229,260
1277473,1600,178029,new-0.5,completed,275.0,7.7,172,103,66,0,209,275,0,0,275,275,43,0,232,275,35,28,212,275,75,0,200,275
1277473,1600,178029,new-1.0,completed,284.0,7.85,167,117,30,32,222,284,0,0,284,284,56,0,228,284,76,0,208,284,74,9,201,284
1277473,1600,239735,base,completed,274.0,7.2,197,77,21,0,253,274,69,0,205,274,0,56,218,274,37,0,237,274,36,0,238,274
1277473,1600,239735,base+,completed,268.0,6.95,152,116,41,0,227,268,84,0,184,268,0,24,244,268,26,32,210,268,41,7,220,268
1277473,1600,239735,dpv1,completed,268.0,7.25,153,115,75,0,193,268,37,29,202,268,0,12,256,268,18,16,234,268,46,3,219,268
1277473,1600,239735,dpv2,completed,260.0,7.75,149,111,0,23,237,260,34,6,220,260,70,0,190,260,18,41,201,260,15,0,245,260
1277473,1600,239735,new-0.0,completed,252.0,7.3,179,73,69,0,183,252,23,0,229,252,0,9,243,252,28,0,224,252,28,0,224,252
1277473,1600,239735,new-0.5,completed,267.0,7.7,151,116,22,38,207,267,24,0,243,267,43,0,224,267,0,29,238,267,65,15,187,267
1277473,1600,239735,new-1.0,completed,261.0,7.85,149,112,0,0,261,261,64,0,197,261,31,0,230,261,18,16,227,261,43,32,186,261
1277473,1600,675528,base,completed,293.0,7.15,169,124,76,0,217,293,22,0,271,293,0,40,253,293,76,38,179,293,34,38,221,293
1277473,1600,675528,base+,completed,264.0,7.05,176,88,41,0,223,264,21,24,219,264,0,4,260,264,37,24,203,264,58,0,206,264
1277473,1600,675528,dpv1,completed,318.0,7.25,130,188,28,86,204,318,85,0,233,318,0,8,310,318,79,0,239,318,41,98,179,318
1277473,1600,675528,dpv2,completed,270.0,7.65,164,106,69,0,201,270,41,0,229,270,37,0,233,270,28,37,205,270,0,0,270,270
1277473,1600,675528,new-0.0,completed,261.0,7.1,190,71,38,0,223,261,53,3,205,261,0,0,261,261,67,0,194,261,37,1,223,261
1277473,1600,675528,new-0.5,completed,281.0,7.65,197,84,75,0,206,281,0,0,281,281,29,6,246,281,58,0,223,281,78,0,203,281
1277473,1600,675528,new-1.0,completed,302.0,7.85,155,147,37,38,227,302,0,0,302,302,81,0,221,302,90,0,212,302,86,19,197,302
1277473,1600,380692,base,completed,281.0,7.35,171,110,76,0,205,281,49,14,218,281,30,33,218,281,0,0,281,281,63,19,199,281
1277473,1600,380692,base+,completed,268.0,7.1,154,114,20,14,234,268,0,27,241,268,21,0,247,268,71,0,197,268,27,34,207,268
1277473,1600,380692,dpv1,completed,304.0,7.15,125,179,25,84,195,304,77,0,227,304,0,35,269,304,25,0,279,304,40,93,171,304
1277473,1600,380692,dpv2,completed,268.0,7.7,183,85,0,0,268,268,46,0,222,268,52,0,216,268,31,25,212,268,60,0,208,268
1277473,1600,380692,new-0.0,completed,255.0,7.0,202,53,38,0,217,255,40,0,215,255,0,0,255,255,53,0,202,255,40,0,215,255
1277473,1600,380692,new-0.5,completed,272.0,7.7,183,89,64,0,208,272,0,0,272,272,52,0,220,272,34,15,223,272,74,0,198,272
1277473,1600,380692,new-1.0,completed,289.0,7.7,171,118,85,0,204,289,0,0,289,289,49,0,240,289,78,0,211,289,45,33,211,289
5307061,1696,310811,base,completed,314.0,7.15,106,208,4,10,300,314,27,0,287,314,0,116,198,314,3,0,311,314,16,161,137,314
5307061,1696,310811,base+,completed,339.0,6.85,88,251,0,0,339,339,17,214,108,339,76,0,263,339,43,0,296,339,37,71,231,339
5307061,1696,310811,dpv1,completed,333.0,7.25,78,255,5,0,328,333,0,0,333,333,39,195,99,333,63,0,270,333,60,65,208,333
5307061,1696,310811,dpv2,completed,329.0,7.25,92,237,0,39,290,329,9,209,111,329,65,47,217,329,28,14,287,329,19,0,310,329
5307061,1696,310811,new-0.0,completed,291.0,7.15,159,132,36,33,222,291,48,3,240,291,26,0,265,291,0,6,285,291,16,65,210,291
5307061,1696,310811,new-0.5,completed,274.0,7.2,163,111,0,8,266,274,43,0,231,274,10,45,219,274,31,27,216,274,4,6,264,274
5307061,1696,310811,new-1.0,completed,321.0,7.6,110,211,23,12,286,321,0,0,321,321,21,56,244,321,44,79,198,321,62,62,197,321
5307061,1696,208428,base,completed,358.0,6.95,86,272,39,158,161,358,0,160,198,358,1,117,240,358,27,34,297,358,8,0,350,358
5307061,1696,208428,base+,completed,328.0,7.05,86,242,49,24,255,328,44,176,108,328,0,0,328,328,62,0,266,328,66,8,254,328
5307061,1696,208428,dpv1,completed,334.0,7.1,106,228,31,178,125,334,0,0,334,334,61,0,273,334,50,50,234,334,61,0,273,334
5307061,1696,208428,dpv2,completed,317.0,7.35,96,221,16,0,301,317,5,198,114,317,68,33,216,317,23,16,278,317,0,9,308,317
5307061,1696,208428,new-0.0,completed,281.0,7.15,139,142,23,32,226,281,44,35,202,281,34,0,247,281,0,3,278,281,5,28,248,281
5307061,1696,208428,new-0.5,completed,269.0,7.25,159,110,28,20,221,269,17,6,246,269,7,53,209,269,0,3,266,269,0,4,265,269
5307061,1696,208428,new-1.0,completed,331.0,7.7,81,250,33,10,288,331,0,0,331,331,80,95,156,331,59,58,214,331,46,42,243,331
5307061,1696,460300,base,completed,361.0,6.95,83,278,39,29,293,361,19,236,106,361,0,0,361,361,48,0,313,361,70,124,167,361
5307061,1696,460300,base+,completed,295.0,7.05,173,122,35,0,260,295,6,66,223,295,68,12,215,295,27,38,230,295,0,1,294,295
5307061,1696,460300,dpv1,completed,349.0,7.25,84,265,0,4,345,349,32,138,179,349,9,233,107,349,73,0,276,349,8,0,341,349
5307061,1696,460300,dpv2,completed,337.0,7.3,93,244,37,0,300,337,12,211,114,337,0,38,299,337,33,71,233,337,48,0,289,337
5307061,1696,460300,new-0.0,completed,283.0,7.2,146,137,25,0,258,283,32,52,199,283,0,27,256,283,3,9,271,283,8,32,243,283
5307061,1696,460300,new-0.5,completed,293.0,7.35,153,140,49,8,236,293,41,47,205,293,17,45,231,293,0,3,290,293,28,0,265,293
5307061,1696,460300,new-1.0,completed,321.0,7.6,119,202,26,7,288,321,0,0,321,321,41,50,230,321,54,71,196,321,75,38,208,321
5307061,1696,309704,base,completed,339.0,7.05,75,264,21,132,186,339,33,0,306,339,17,0,322,339,39,140,160,339,0,97,242,339
5307061,1696,309704,base+,completed,323.0,7.1,110,213,0,47,276,323,29,66,228,323,9,34,280,323,36,103,184,323,34,18,271,323
5307061,1696,309704,dpv1,completed,321.0,7.1,115,206,26,156,139,321,0,0,321,321,1,0,320,321,57,0,264,321,50,55,216,321
5307061,1696,309704,dpv2,completed,331.0,7.25,95,236,0,39,292,331,9,205,117,331,69,42,220,331,31,8,292,331,14,0,317,331
5307061,1696,309704,new-0.0,completed,293.0,7.2,145,148,67,0,226,293,32,49,212,293,27,0,266,293,0,14,279,293,16,67,210,293
5307061,1696,309704,new-0.5,completed,301.0,7.35,140,161,57,10,234,301,36,62,203,301,12,69,220,301,0,3,298,301,34,0,267,301
5307061,1696,309704,new-1.0,completed,329.0,7.7,93,236,7,8,314,329,49,68,212,329,0,98,231,329,50,112,167,329,19,0,310,329
5307061,1696,247588,base,completed,339.0,7.2,77,262,16,11,312,339,27,0,312,339,0,143,196,339,5,59,275,339,24,161,154,339
5307061,1696,247588,base+,completed,299.0,6.9,126,173,37,114,148,299,51,0,248,299,0,0,299,299,24,0,275,299,59,0,240,299
5307061,1696,247588,dpv1,completed,296.0,7.15,112,184,17,147,132,296,37,21,238,296,0,0,296,296,31,0,265,296,42,0,254,296
5307061,1696,247588,dpv2,completed,316.0,7.5,90,226,5,0,311,316,7,199,110,316,27,20,269,316,59,47,210,316,0,31,285,316
5307061,1696,247588,new-0.0,completed,279.0,7.25,148,131,48,0,231,279,37,48,194,279,16,49,214,279,0,7,272,279,28,0,251,279
5307061,1696,247588,new-0.5,completed,286.0,7.25,168,118,34,39,213,286,14,49,223,286,53,0,233,286,0,5,281,286,39,0,247,286
5307061,1696,247588,new-1.0,completed,289.0,7.55,129,160,44,8,237,289,43,32,214,289,13,48,228,289,20,35,234,289,0,0,289,289
5307061,1696,203195,base,completed,295.0,7.15,124,171,0,59,236,295,32,1,262,295,33,0,262,295,5,23,267,295,15,93,187,295
5307061,1696,203195,base+,completed,332.0,7.2,111,221,38,63,231,332,45,156,131,332,50,0,282,332,17,59,256,332,0,0,332,332
5307061,1696,203195,dpv1,completed,387.0,7.15,80,307,69,0,318,387,29,182,176,387,7,278,102,387,0,82,305,387,51,0,336,387
5307061,1696,203195,dpv2,completed,355.0,7.25,82,273,55,0,300,355,17,234,104,355,0,53,302,355,39,94,222,355,58,0,297,355
5307061,1696,203195,new-0.0,completed,281.0,7.25,159,122,41,0,240,281,32,24,225,281,9,64,208,281,22,0,259,281,0,2,279,281
5307061,1696,203195,new-0.5,completed,292.0,7.35,143,149,54,7,231,292,36,45,211,292,15,65,212,292,0,9,283,292,27,0,265,292
5307061,1696,203195,new-1.0,completed,337.0,7.4,95,242,0,47,290,337,79,0,258,337,34,69,234,337,70,53,214,337,49,32,256,337
5307061,1696,178029,base,completed,350.0,7.25,71,279,51,182,117,350,35,90,225,350,20,0,330,350,0,74,276,350,9,54,287,350
5307061,1696,178029,base+,completed,338.0,6.9,94,244,66,145,127,338,0,0,338,338,11,95,232,338,53,26,259,338,31,14,293,338
5307061,1696,178029,dpv1,completed,319.0,7.15,81,238,0,0,319,319,35,22,262,319,12,203,104,319,45,0,274,319,55,0,264,319
5307061,1696,178029,dpv2,completed,339.0,7.4,86,253,12,0,327,339,7,225,107,339,68,50,221,339,28,21,290,339,0,49,290,339
5307061,1696,178029,new-0.0,completed,290.0,7.3,146,144,27,0,263,290,0,13,277,290,9,78,203,290,33,33,224,290,42,0,248,290
5307061,1696,178029,new-0.5,completed,300.0,7.3,132,168,22,39,239,300,45,47,208,300,26,23,251,300,0,14,286,300,51,0,249,300
5307061,1696,178029,new-1.0,completed,324.0,7.4,115,209,68,42,214,324,56,36,232,324,36,54,234,324,0,5,319,324,37,27,260,324
5307061,1696,239735,base,completed,320.0,7.05,110,210,63,95,162,320,0,98,222,320,59,0,261,320,2,0,318,320,71,0,249,320
5307061,1696,239735,base+,completed,329.0,7.05,134,195,77,98,154,329,0,0,329,329,47,27,255,329,83,0,246,329,70,32,227,329
5307061,1696,239735,dpv1,completed,322.0,7.15,79,243,0,0,322,322,47,58,217,322,24,196,102,322,70,0,252,322,1,0,321,322
5307061,1696,239735,dpv2,completed,330.0,7.3,88,242,28,0,302,330,14,208,108,330,0,56,274,330,34,82,214,330,32,0,298,330
5307061,1696,239735,new-0.0,completed,275.0,7.2,141,134,33,2,240,275,26,38,211,275,5,2,268,275,0,9,266,275,9,60,206,275
5307061,1696,239735,new-0.5,completed,279.0,7.35,142,137,22,0,257,279,29,42,208,279,7,63,209,279,0,5,274,279,37,0,242,279
5307061,1696,239735,new-1.0,completed,334.0,7.7,84,250,0,50,284,334,54,63,217,334,13,120,201,334,53,55,226,334,32,0,302,334
5307061,1696,675528,base,completed,340.0,7.2,128,212,0,0,340,340,71,116,153,340,37,106,197,340,46,0,294,340,73,0,267,340
5307061,1696,675528,base+,completed,306.0,7.05,152,154,25,21,260,306,50,0,256,306,48,35,223,306,0,0,306,306,37,85,184,306
5307061,1696,675528,dpv1,completed,346.0,7.35,83,263,66,0,280,346,16,0,330,346,13,228,105,346,35,130,181,346,0,0,346,346
5307061,1696,675528,dpv2,completed,358.0,7.3,91,267,45,0,313,358,20,227,111,358,0,58,300,358,40,93,225,358,61,0,297,358
5307061,1696,675528,new-0.0,completed,291.0,7.3,149,142,47,0,244,291,42,44,205,291,20,53,218,291,0,3,288,291,27,0,264,291
5307061,1696,675528,new-0.5,completed,287.0,7.35,163,124,48,2,237,287,28,39,220,287,8,57,222,287,0,5,282,287,1,6,280,287
5307061,1696,675528,new-1.0,completed,311.0,7.7,91,220,19,15,277,311,0,0,311,311,46,98,167,311,25,57,229,311,16,32,263,311
5307061,1696,380692,base,completed,291.0,7.05,144,147,8,54,229,291,38,63,190,291,30,5,256,291,0,19,272,291,18,0,273,291
5307061,1696,380692,base+,completed,335.0,6.85,123,212,16,105,214,335,39,37,259,335,73,58,204,335,0,18,317,335,40,68,227,335
5307061,1696,380692,dpv1,completed,386.0,7.1,82,304,72,0,314,386,29,174,183,386,6,275,105,386,52,0,334,386,0,76,310,386
5307061,1696,380692,dpv2,completed,323.0,7.35,97,226,46,4,273,323,5,200,118,323,66,47,210,323,0,13,310,323,26,9,288,323
5307061,1696,380692,new-0.0,completed,274.0,7.25,145,129,38,6,230,274,26,34,214,274,6,57,211,274,1,7,266,274,0,7,267,274
5307061,1696,380692,new-0.5,completed,282.0,7.3,133,149,45,11,226,282,27,51,204,282,6,66,210,282,0,10,272,282,5,0,277,282
5307061,1696,380692,new-1.0,completed,309.0,7.6,106,203,22,13,274,309,0,0,309,309,18,63,228,309,32,60,217,309,53,51,205,309
5882438,1487,310811,base,completed,256.0,6.9,179,77,47,0,209,256,32,0,224,256,68,0,188,256,27,0,229,256,0,29,227,256
5882438,1487,310811,base+,completed,245.0,6.8,175,70,0,0,245,245,53,0,192,245,20,0,225,245,20,0,225,245,26,25,194,245
5882438,1487,310811,dpv1,completed,252.0,7.35,189,63,59,0,193,252,63,0,189,252,33,0,219,252,37,0,215,252,0,0,252,252
5882438,1487,310811,dpv2,completed,219.0,7.55,188,31,23,0,196,219,11,0,208,219,4,0,215,219,0,0,219,219,1,8,210,219
5882438,1487,310811,new-0.0,completed,229.0,7.15,183,46,18,0,211,229,10,0,219,229,46,0,183,229,28,0,201,229,0,0,229,229
5882438,1487,310811,new-0.5,completed,240.0,7.55,195,45,0,0,240,240,29,0,211,240,31,0,209,240,43,0,197,240,45,0,195,240
5882438,1487,310811,new-1.0,completed,238.0,7.7,184,54,17,2,219,238,19,0,219,238,0,0,238,238,22,0,216,238,52,0,186,238
5882438,1487,208428,base,completed,257.0,7.05,130,127,0,4,253,257,25,0,232,257,19,94,144,257,13,0,244,257,33,0,224,257
5882438,1487,208428,base+,completed,255.0,6.8,187,68,47,0,208,255,68,0,187,255,0,0,255,255,39,0,216,255,36,0,219,255
5882438,1487,208428,dpv1,completed,239.0,7.35,197,42,39,0,200,239,42,0,197,239,24,0,215,239,34,0,205,239,0,0,239,239
5882438,1487,208428,dpv2,completed,234.0,7.65,201,33,30,0,204,234,26,3,205,234,0,0,234,234,26,0,208,234,21,0,213,234
5882438,1487,208428,new-0.0,completed,224.0,7.3,174,50,0,0,224,224,12,0,212,224,5,0,219,224,11,0,213,224,50,0,174,224
5882438,1487,208428,new-0.5,completed,227.0,7.55,189,38,35,0,192,227,0,0,227,227,7,1,219,227,28,0,199,227,6,2,219,227
5882438,1487,208428,new-1.0,completed,233.0,7.65,194,39,0,0,233,233,3,0,230,233,19,0,214,233,24,0,209,233,39,0,194,233
5882438,1487,460300,base,completed,229.0,6.9,204,25,5,0,224,229,6,0,223,229,25,0,204,229,0,0,229,229,16,0,213,229
5882438,1487,460300,base+,completed,255.0,7.05,166,89,0,0,255,255,54,0,201,255,45,0,210,255,22,35,198,255,42,0,213,255
5882438,1487,460300,dpv1,completed,272.0,7.4,197,75,62,0,210,272,0,21,251,272,47,0,225,272,52,0,220,272,75,0,197,272
5882438,1487,460300,dpv2,completed,245.0,7.5,181,64,36,0,209,245,16,0,229,245,0,28,217,245,22,0,223,245,34,0,211,245
5882438,1487,460300,new-0.0,completed,217.0,7.3,199,18,3,0,214,217,8,0,209,217,0,0,217,217,18,0,199,217,11,0,206,217
5882438,1487,460300,new-0.5,completed,228.0,7.65,199,29,27,0,201,228,17,0,211,228,10,0,218,228,0,0,228,228,29,0,199,228
5882438,1487,460300,new-1.0,completed,236.0,7.55,180,56,9,0,227,236,4,1,231,236,18,4,214,236,0,0,236,236,52,0,184,236
5882438,1487,309704,base,completed,226.0,6.9,200,26,13,0,213,226,3,0,223,226,15,0,211,226,0,0,226,226,26,0,200,226
5882438,1487,309704,base+,completed,244.0,7.3,193,51,0,0,244,244,51,0,193,244,46,0,198,244,22,0,222,244,31,0,213,244
5882438,1487,309704,dpv1,completed,250.0,7.35,192,58,27,0,223,250,52,0,198,250,0,0,250,250,54,4,192,250,34,0,216,250
5882438,1487,309704,dpv2,completed,232.0,7.7,168,64,41,3,188,232,0,20,212,232,9,10,213,232,1,0,231,232,2,0,230,232
5882438,1487,309704,new-0.0,completed,225.0,7.25,177,48,17,0,208,225,6,0,219,225,48,0,177,225,18,0,207,225,0,0,225,225
5882438,1487,309704,new-0.5,completed,235.0,7.6,195,40,36,0,199,235,20,0,215,235,23,0,212,235,39,1,195,235,0,0,235,235
5882438,1487,309704,new-1.0,completed,234.0,7.5,182,52,17,5,212,234,14,0,220,234,10,4,220,234,0,0,234,234,43,0,191,234
5882438,1487,247588,base,completed,238.0,7.2,188,50,50,0,188,238,50,0,188,238,18,0,220,238,0,0,238,238,11,0,227,238
5882438,1487,247588,base+,completed,220.0,7.15,203,17,17,0,203,220,5,0,215,220,0,0,220,220,6,0,214,220,9,0,211,220
5882438,1487,247588,dpv1,completed,262.0,7.4,156,106,46,0,216,262,61,0,201,262,0,60,202,262,65,0,197,262,22,0,240,262
5882438,1487,247588,dpv2,completed,232.0,7.55,173,59,26,0,206,232,24,0,208,232,0,0,232,232,11,0,221,232,6,33,193,232
5882438,1487,247588,new-0.0,completed,218.0,7.3,181,37,3,0,215,218,23,0,195,218,0,0,218,218,1,0,217,218,37,0,181,218
5882438,1487,247588,new-0.5,completed,227.0,7.6,190,37,37,0,190,227,14,0,213,227,9,0,218,227,34,0,193,227,0,0,227,227
5882438,1487,247588,new-1.0,completed,226.0,7.55,177,49,20,2,204,226,47,0,179,226,8,0,218,226,0,0,226,226,2,0,224,226
5882438,1487,203195,base,completed,240.0,7.0,203,37,28,0,212,240,37,0,203,240,16,0,224,240,28,0,212,240,0,0,240,240
5882438,1487,203195,base+,completed,253.0,6.75,192,61,61,0,192,253,0,13,240,253,34,0,219,253,32,0,221,253,25,0,228,253
5882438,1487,203195,dpv1,completed,260.0,7.3,176,84,46,0,214,260,0,35,225,260,72,0,188,260,49,0,211,260,48,0,212,260
5882438,1487,203195,dpv2,completed,237.0,7.5,205,32,11,0,226,237,32,0,205,237,0,0,237,237,15,0,222,237,9,0,228,237
5882438,1487,203195,new-0.0,completed,224.0,7.25,188,36,4,0,220,224,21,0,203,224,0,0,224,224,20,0,204,224,36,0,188,224
5882438,1487,203195,new-0.5,completed,224.0,7.6,183,41,23,0,201,224,4,0,220,224,5,0,219,224,0,0,224,224,41,0,183,224
5882438,1487,203195,new-1.0,completed,226.0,7.55,194,32,20,0,206,226,0,0,226,226,13,0,213,226,1,0,225,226,32,0,194,226
5882438,1487,178029,base,completed,221.0,6.8,191,30,13,0,208,221,2,16,203,221,12,0,209,221,14,0,207,221,0,0,221,221
5882438,1487,178029,base+,completed,236.0,7.1,198,38,22,0,214,236,35,0,201,236,0,0,236,236,23,0,213,236,38,0,198,236
5882438,1487,178029,dpv1,completed,252.0,7.35,185,67,67,0,185,252,47,0,205,252,10,0,242,252,0,0,252,252,58,0,194,252
5882438,1487,178029,dpv2,completed,241.0,7.65,183,58,27,0,214,241,26,7,208,241,0,31,210,241,13,0,228,241,16,0,225,241
5882438,1487,178029,new-0.0,completed,224.0,7.25,202,22,19,0,205,224,11,0,213,224,0,0,224,224,20,0,204,224,22,0,202,224
5882438,1487,178029,new-0.5,completed,226.0,7.65,202,24,24,0,202,226,9,0,217,226,9,0,217,226,0,0,226,226,19,0,207,226
5882438,1487,178029,new-1.0,completed,236.0,7.55,181,55,17,0,219,236,9,0,227,236,18,4,214,236,0,0,236,236,51,0,185,236
5882438,1487,239735,base,completed,249.0,6.9,198,51,0,18,231,249,31,0,218,249,28,0,221,249,31,0,218,249,33,0,216,249
5882438,1487,239735,base+,completed,240.0,7.05,170,70,19,31,190,240,21,0,219,240,39,0,201,240,0,0,240,240,28,0,212,240
5882438,1487,239735,dpv1,completed,244.0,7.5,186,58,30,0,214,244,58,0,186,244,54,0,190,244,34,0,210,244,0,0,244,244
5882438,1487,239735,dpv2,completed,236.0,7.6,172,64,34,7,195,236,17,0,219,236,0,23,213,236,14,0,222,236,31,0,205,236
5882438,1487,239735,new-0.0,completed,228.0,7.25,191,37,23,0,205,228,19,0,209,228,0,0,228,228,37,0,191,228,36,0,192,228
5882438,1487,239735,new-0.5,completed,227.0,7.6,195,32,26,0,201,227,19,0,208,227,4,0,223,227,32,0,195,227,0,0,227,227
5882438,1487,239735,new-1.0,completed,249.0,7.35,181,68,68,0,181,249,0,32,217,249,21,0,228,249,25,0,224,249,1,28,220,249
5882438,1487,675528,base,completed,229.0,7.1,191,38,0,0,229,229,5,0,224,229,7,0,222,229,38,0,191,229,24,0,205,229
5882438,1487,675528,base+,completed,242.0,7.25,144,98,36,0,206,242,21,0,221,242,31,0,211,242,21,0,221,242,0,62,180,242
5882438,1487,675528,dpv1,completed,243.0,7.4,181,62,62,0,181,243,34,0,209,243,43,0,200,243,0,0,243,243,3,0,240,243
5882438,1487,675528,dpv2,completed,248.0,7.55,182,66,33,0,215,248,38,0,210,248,31,0,217,248,32,0,216,248,0,28,220,248
5882438,1487,675528,new-0.0,completed,236.0,7.35,188,48,13,0,223,236,33,0,203,236,0,0,236,236,23,0,213,236,48,0,188,236
5882438,1487,675528,new-0.5,completed,250.0,7.65,196,54,0,0,250,250,36,0,214,250,32,0,218,250,54,0,196,250,53,0,197,250
5882438,1487,675528,new-1.0,completed,241.0,7.6,188,53,16,0,225,241,28,6,207,241,0,0,241,241,20,0,221,241,47,0,194,241
5882438,1487,380692,base,completed,253.0,6.8,192,61,35,0,218,253,0,17,236,253,60,0,193,253,23,0,230,253,56,0,197,253
5882438,1487,380692,base+,completed,229.0,6.95,175,54,2,9,218,229,8,6,215,229,2,0,227,229,33,0,196,229,0,19,210,229
5882438,1487,380692,dpv1,completed,238.0,7.45,191,47,19,0,219,238,47,0,191,238,0,0,238,238,36,0,202,238,46,0,192,238
5882438,1487,380692,dpv2,completed,243.0,7.45,164,79,27,0,216,243,25,0,218,243,7,0,236,243,0,52,191,243,26,0,217,243
5882438,1487,380692,new-0.0,completed,232.0,7.15,188,44,0,2,230,232,35,0,197,232,13,0,219,232,34,0,198,232,42,0,190,232
5882438,1487,380692,new-0.5,completed,231.0,7.65,200,31,29,0,202,231,28,0,203,231,19,0,212,231,0,0,231,231,31,0,200,231
5882438,1487,380692,new-1.0,completed,226.0,7.6,203,23,11,3,212,226,0,0,226,226,16,0,210,226,8,1,217,226,19,0,207,226
9700423,1746,310811,base,completed,301.0,6.95,218,83,83,0,218,301,38,0,263,301,39,0,262,301,0,9,292,301,55,0,246,301
9700423,1746,310811,base+,completed,304.0,6.8,207,97,0,41,263,304,43,0,261,304,37,0,267,304,6,0,298,304,68,0,236,304
9700423,1746,310811,dpv1,completed,301.0,7.15,178,123,0,46,255,301,41,0,260,301,70,0,231,301,18,43,240,301,35,0,266,301
9700423,1746,310811,dpv2,completed,317.0,7.5,212,105,85,0,232,317,45,0,272,317,81,0,236,317,105,0,212,317,0,38,279,317
9700423,1746,310811,new-0.0,completed,284.0,7.3,213,71,0,0,284,284,71,0,213,284,12,0,272,284,55,0,229,284,61,0,223,284
9700423,1746,310811,new-0.5,completed,278.0,7.6,197,81,18,0,260,278,62,0,216,278,31,14,233,278,39,0,239,278,0,6,272,278
9700423,1746,310811,new-1.0,completed,275.0,7.55,209,66,42,0,233,275,22,0,253,275,33,11,231,275,7,0,268,275,0,13,262,275
9700423,1746,208428,base,completed,319.0,7.2,218,101,41,0,278,319,74,0,245,319,53,0,266,319,101,0,218,319,0,32,287,319
9700423,1746,208428,base+,completed,317.0,6.95,182,135,38,0,279,317,78,0,239,317,75,0,242,317,0,76,241,317,27,0,290,317
9700423,1746,208428,dpv1,completed,315.0,7.5,216,99,63,0,252,315,40,0,275,315,99,0,216,315,0,30,285,315,89,0,226,315
9700423,1746,208428,dpv2,completed,296.0,7.55,203,93,51,0,245,296,0,42,254,296,59,0,237,296,31,0,265,296,49,0,247,296
9700423,1746,208428,new-0.0,completed,261.0,7.2,229,32,8,0,253,261,0,0,261,261,27,0,234,261,32,0,229,261,4,0,257,261
9700423,1746,208428,new-0.5,completed,276.0,7.6,229,47,0,0,276,276,35,0,241,276,8,0,268,276,47,0,229,276,18,0,258,276
9700423,1746,208428,new-1.0,completed,275.0,7.5,214,61,42,0,233,275,28,0,247,275,32,7,236,275,16,0,259,275,0,12,263,275
9700423,1746,460300,base,completed,309.0,6.85,228,81,0,20,289,309,41,0,268,309,46,0,263,309,78,0,231,309,81,0,228,309
9700423,1746,460300,base+,completed,334.0,7.05,218,116,116,0,218,334,82,0,252,334,41,0,293,334,0,46,288,334,97,0,237,334
9700423,1746,460300,dpv1,completed,349.0,7.45,179,170,107,28,214,349,100,15,234,349,0,81,268,349,118,0,231,349,43,0,306,349
9700423,1746,460300,dpv2,completed,319.0,7.65,208,111,82,0,237,319,73,0,246,319,0,48,271,319,79,0,240,319,44,0,275,319
9700423,1746,460300,new-0.0,completed,290.0,7.3,223,67,0,0,290,290,63,0,227,290,61,0,229,290,67,0,223,290,39,0,251,290
9700423,1746,460300,new-0.5,completed,293.0,7.55,210,83,83,0,210,293,0,10,283,293,42,0,251,293,55,0,238,293,34,0,259,293
9700423,1746,460300,new-1.0,completed,283.0,7.5,229,54,0,0,283,283,32,0,251,283,32,1,250,283,15,0,268,283,35,18,230,283
9700423,1746,309704,base,completed,306.0,7.15,203,103,82,9,215,306,39,0,267,306,72,6,228,306,61,6,239,306,0,22,284,306
9700423,1746,309704,base+,completed,314.0,6.85,220,94,76,0,238,314,0,32,282,314,85,0,229,314,77,0,237,314,41,0,273,314
9700423,1746,309704,dpv1,completed,303.0,7.2,188,115,44,0,259,303,99,0,204,303,34,28,241,303,46,0,257,303,0,18,285,303
9700423,1746,309704,dpv2,completed,302.0,7.55,197,105,60,0,242,302,41,0,261,302,0,41,261,302,69,0,233,302,60,0,242,302
9700423,1746,309704,new-0.0,completed,278.0,7.3,219,59,15,0,263,278,0,0,278,278,58,0,220,278,59,0,219,278,37,0,241,278
9700423,1746,309704,new-0.5,completed,272.0,7.6,201,71,0,0,272,272,60,0,212,272,12,4,256,272,17,7,248,272,33,0,239,272
9700423,1746,309704,new-1.0,completed,272.0,7.55,206,66,43,0,229,272,19,0,253,272,21,17,234,272,16,0,256,272,0,6,266,272
9700423,1746,247588,base,completed,333.0,7.1,186,147,0,42,291,333,91,0,242,333,112,35,186,333,72,0,261,333,36,0,297,333
9700423,1746,247588,base+,completed,355.0,6.95,149,206,101,23,231,355,103,24,228,355,101,0,254,355,42,46,267,355,0,106,249,355
9700423,1746,247588,dpv1,completed,309.0,7.35,185,124,73,0,236,309,43,0,266,309,62,15,232,309,45,0,264,309,0,48,261,309
9700423,1746,247588,dpv2,completed,304.0,7.55,199,105,67,0,237,304,74,0,230,304,0,45,259,304,39,0,265,304,48,0,256,304
9700423,1746,247588,new-0.0,completed,253.0,7.3,215,38,14,1,238,253,6,0,247,253,4,0,249,253,37,0,216,253,0,0,253,253
9700423,1746,247588,new-0.5,completed,292.0,7.65,200,92,0,27,265,292,60,0,232,292,53,7,232,292,39,0,253,292,46,0,246,292
9700423,1746,247588,new-1.0,completed,278.0,7.55,203,75,16,0,262,278,22,0,256,278,26,10,242,278,0,0,278,278,47,18,213,278
9700423,1746,203195,base,completed,289.0,7.0,241,48,44,0,245,289,38,0,251,289,48,0,241,289,38,0,251,289,0,0,289,289
9700423,1746,203195,base+,completed,323.0,7.1,185,138,72,0,251,323,0,89,234,323,28,0,295,323,75,0,248,323,65,0,258,323
9700423,1746,203195,dpv1,completed,304.0,7.05,177,127,0,36,268,304,100,0,204,304,40,0,264,304,24,41,239,304,37,0,267,304
9700423,1746,203195,dpv2,completed,301.0,7.6,218,83,35,0,266,301,67,0,234,301,60,0,241,301,81,0,220,301,0,26,275,301
9700423,1746,203195,new-0.0,completed,263.0,7.3,222,41,10,0,253,263,2,0,261,263,25,0,238,263,41,0,222,263,0,0,263,263
9700423,1746,203195,new-0.5,completed,285.0,7.65,203,82,71,0,214,285,0,0,285,285,33,11,241,285,49,0,236,285,40,0,245,285
9700423,1746,203195,new-1.0,completed,285.0,7.55,189,96,17,0,268,285,38,0,247,285,43,15,227,285,0,0,285,285,58,23,204,285
9700423,1746,178029,base,completed,308.0,7.0,189,119,29,0,279,308,0,64,244,308,71,0,237,308,46,0,262,308,76,0,232,308
9700423,1746,178029,base+,completed,304.0,6.85,245,59,0,0,304,304,57,0,247,304,38,0,266,304,59,0,245,304,55,0,249,304
9700423,1746,178029,dpv1,completed,321.0,7.25,214,107,0,43,278,321,97,0,224,321,74,10,237,321,32,0,289,321,85,0,236,321
9700423,1746,178029,dpv2,completed,294.0,7.65,216,78,66,0,228,294,64,0,230,294,61,0,233,294,35,0,259,294,0,22,272,294
9700423,1746,178029,new-0.0,completed,269.0,7.2,224,45,0,0,269,269,20,0,249,269,39,0,230,269,45,0,224,269,13,0,256,269
9700423,1746,178029,new-0.5,completed,276.0,7.65,213,63,0,0,276,276,58,0,218,276,32,5,239,276,32,0,244,276,30,0,246,276
9700423,1746,178029,new-1.0,completed,283.0,7.65,206,77,0,0,283,283,58,0,225,283,25,18,240,283,28,0,255,283,18,1,264,283
9700423,1746,239735,base,completed,319.0,6.95,223,96,77,0,242,319,0,27,292,319,35,0,284,319,96,0,223,319,79,0,240,319
9700423,1746,239735,base+,completed,335.0,7.2,146,189,70,0,265,335,98,0,237,335,0,128,207,335,42,0,293,335,85,31,219,335
9700423,1746,239735,dpv1,completed,277.0,7.05,207,70,19,0,258,277,40,0,237,277,0,11,266,277,39,0,238,277,33,19,225,277
9700423,1746,239735,dpv2,completed,310.0,7.65,205,105,69,0,241,310,92,0,218,310,0,42,268,310,72,0,238,310,45,0,265,310
9700423,1746,239735,new-0.0,completed,281.0,7.4,219,62,30,0,251,281,62,0,219,281,61,0,220,281,37,0,244,281,0,0,281,281
9700423,1746,239735,new-0.5,completed,282.0,7.65,199,83,78,0,204,282,0,12,270,282,42,5,235,282,38,0,244,282,42,0,240,282
9700423,1746,239735,new-1.0,completed,284.0,7.5,191,93,0,0,284,284,34,0,250,284,53,2,229,284,25,0,259,284,40,38,206,284
9700423,1746,675528,base,completed,308.0,6.75,215,93,70,0,238,308,82,0,226,308,35,0,273,308,0,35,273,308,64,0,244,308
9700423,1746,675528,base+,completed,301.0,7.0,217,84,37,0,264,301,0,30,271,301,84,0,217,301,6,0,295,301,78,0,223,301
9700423,1746,675528,dpv1,completed,276.0,7.15,219,57,23,0,253,276,53,0,223,276,8,25,243,276,5,0,271,276,0,0,276,276
9700423,1746,675528,dpv2,completed,324.0,7.7,221,103,94,0,230,324,98,0,226,324,90,0,234,324,43,0,281,324,0,40,284,324
9700423,1746,675528,new-0.0,completed,283.0,7.25,212,71,33,0,250,283,27,0,256,283,27,0,256,283,0,0,283,283,71,0,212,283
9700423,1746,675528,new-0.5,completed,283.0,7.6,224,59,7,0,276,283,59,0,224,283,0,0,283,283,34,0,249,283,37,0,246,283
9700423,1746,675528,new-1.0,completed,272.0,7.5,216,56,45,0,227,272,13,0,259,272,0,11,261,272,12,0,260,272,1,0,271,272
9700423,1746,380692,base,completed,301.0,6.9,228,73,52,0,249,301,0,16,285,301,67,0,234,301,73,0,228,301,26,0,275,301
9700423,1746,380692,base+,completed,314.0,6.95,224,90,38,0,276,314,75,0,239,314,0,34,280,314,76,0,238,314,59,0,255,314
9700423,1746,380692,dpv1,completed,307.0,7.0,192,115,37,23,247,307,35,0,272,307,54,0,253,307,0,35,272,307,101,0,206,307
9700423,1746,380692,dpv2,completed,312.0,7.65,201,111,62,0,250,312,89,0,223,312,0,51,261,312,76,0,236,312,42,0,270,312
9700423,1746,380692,new-0.0,completed,269.0,7.15,209,60,0,0,269,269,15,0,254,269,39,0,230,269,6,0,263,269,60,0,209,269
9700423,1746,380692,new-0.5,completed,266.0,7.6,216,50,1,0,265,266,43,0,223,266,12,0,254,266,45,0,221,266,0,5,261,266
9700423,1746,380692,new-1.0,completed,259.0,7.55,237,22,15,4,240,259,3,0,256,259,13,0,246,259,0,0,259,259,18,0,241,259
2997987,1891,310811,base,completed,425.0,7.1,149,276,36,0,389,425,14,165,246,425,90,130,205,425,15,214,196,425,0,113,312,425
2997987,1891,310811,base+,completed,309.0,7.0,199,110,12,9,288,309,6,1,302,309,54,23,232,309,0,27,282,309,63,0,246,309
2997987,1891,310811,dpv1,completed,315.0,7.45,218,97,16,12,287,315,48,0,267,315,42,37,236,315,0,44,271,315,4,10,301,315
2997987,1891,310811,dpv2,completed,302.0,7.3,220,82,0,15,287,302,56,11,235,302,61,0,241,302,16,0,286,302,7,0,295,302
2997987,1891,310811,new-0.0,completed,303.0,7.35,215,88,28,0,275,303,29,0,274,303,0,20,283,303,62,6,235,303,56,0,247,303
2997987,1891,310811,new-0.5,completed,304.0,7.5,236,68,5,1,298,304,42,0,262,304,0,2,302,304,57,0,247,304,58,7,239,304
2997987,1891,310811,new-1.0,completed,332.0,7.55,165,167,0,62,270,332,31,42,259,332,30,47,255,332,14,0,318,332,52,33,247,332
2997987,1891,208428,base,completed,359.0,7.3,136,223,16,90,253,359,0,44,315,359,33,56,270,359,76,54,229,359,21,41,297,359
2997987,1891,208428,base+,completed,324.0,7.15,191,133,5,29,290,324,18,88,218,324,23,89,212,324,0,0,324,324,15,0,309,324
2997987,1891,208428,dpv1,completed,339.0,7.45,193,146,40,9,290,339,20,0,319,339,0,45,294,339,68,44,227,339,73,45,221,339
2997987,1891,208428,dpv2,completed,305.0,7.6,227,78,50,18,237,305,58,0,247,305,0,2,303,305,23,0,282,305,9,0,296,305
2997987,1891,208428,new-0.0,completed,303.0,7.4,232,71,0,0,303,303,54,0,249,303,2,15,286,303,57,0,246,303,57,0,246,303
2997987,1891,208428,new-0.5,completed,297.0,7.7,235,62,55,0,242,297,45,7,245,297,43,0,254,297,0,0,297,297,19,0,278,297
2997987,1891,208428,new-1.0,completed,327.0,7.5,161,166,44,30,253,327,0,64,263,327,41,27,259,327,42,2,283,327,3,45,279,327
2997987,1891,460300,base,completed,347.0,7.1,157,190,88,0,259,347,30,0,317,347,66,9,272,347,0,122,225,347,73,16,258,347
2997987,1891,460300,base+,completed,322.0,7.15,182,140,54,0,268,322,32,89,201,322,37,0,285,322,37,0,285,322,0,0,322,322
2997987,1891,460300,dpv1,completed,344.0,7.45,165,179,0,83,261,344,60,32,252,344,54,0,290,344,12,46,286,344,14,55,275,344
2997987,1891,460300,dpv2,completed,306.0,7.6,218,88,42,28,236,306,48,0,258,306,5,0,301,306,11,0,295,306,0,28,278,306
2997987,1891,460300,new-0.0,completed,297.0,7.55,231,66,52,0,245,297,18,0,279,297,0,13,284,297,50,0,247,297,11,1,285,297
2997987,1891,460300,new-0.5,completed,294.0,7.6,217,77,33,0,261,294,6,17,271,294,49,0,245,294,0,0,294,294,20,14,260,294
2997987,1891,460300,new-1.0,completed,340.0,7.5,163,177,57,37,246,340,0,68,272,340,46,38,256,340,47,7,286,340,1,40,299,340
2997987,1891,309704,base,completed,327.0,7.3,165,162,0,126,201,327,1,70,256,327,27,41,259,327,19,0,308,327,47,0,280,327
2997987,1891,309704,base+,completed,320.0,7.35,181,139,0,32,288,320,40,17,263,320,72,0,248,320,6,43,271,320,69,0,251,320
2997987,1891,309704,dpv1,completed,337.0,7.45,178,159,32,14,291,337,9,0,328,337,53,41,243,337,56,51,230,337,0,87,250,337
2997987,1891,309704,dpv2,completed,301.0,7.45,197,104,2,18,281,301,31,59,211,301,0,0,301,301,40,0,261,301,6,0,295,301
2997987,1891,309704,new-0.0,completed,307.0,7.45,234,73,22,7,278,307,46,0,261,307,56,0,251,307,0,0,307,307,62,4,241,307
2997987,1891,309704,new-0.5,completed,291.0,7.75,226,65,28,0,263,291,54,0,237,291,0,0,291,291,0,12,279,291,23,9,259,291
2997987,1891,309704,new-1.0,completed,348.0,7.65,169,179,62,0,286,348,0,76,272,348,0,53,295,348,3,63,282,348,68,62,218,348
2997987,1891,247588,base,completed,357.0,7.15,159,198,15,29,313,357,72,15,270,357,0,59,298,357,75,0,282,357,79,102,176,357
2997987,1891,247588,base+,completed,330.0,7.0,174,156,5,0,325,330,26,7,297,330,54,31,245,330,0,76,254,330,63,60,207,330
2997987,1891,247588,dpv1,completed,320.0,7.45,180,140,23,7,290,320,0,0,320,320,61,35,224,320,4,56,260,320,61,47,212,320
2997987,1891,247588,dpv2,completed,308.0,7.6,213,95,65,16,227,308,68,0,240,308,0,16,292,308,17,0,291,308,39,0,269,308
2997987,1891,247588,new-0.0,completed,283.0,7.25,212,71,2,14,267,283,31,0,252,283,0,0,283,283,24,19,240,283,38,0,245,283
2997987,1891,247588,new-0.5,completed,292.0,7.75,220,72,39,0,253,292,0,0,292,292,55,0,237,292,32,14,246,292,8,5,279,292
2997987,1891,247588,new-1.0,completed,330.0,7.6,165,165,0,70,260,330,42,43,245,330,41,40,249,330,36,7,287,330,0,29,301,330
2997987,1891,203195,base,completed,316.0,7.05,206,110,47,3,266,316,59,0,257,316,51,23,242,316,22,0,294,316,0,25,291,316
2997987,1891,203195,base+,completed,320.0,7.1,199,121,55,57,208,320,25,3,292,320,20,0,300,320,61,0,259,320,0,28,292,320
2997987,1891,203195,dpv1,completed,333.0,7.55,196,137,24,17,292,333,75,0,258,333,72,12,249,333,2,50,281,333,0,50,283,333
2997987,1891,203195,dpv2,completed,301.0,7.6,214,87,43,33,225,301,50,0,251,301,0,4,297,301,5,0,296,301,16,0,285,301
2997987,1891,203195,new-0.0,completed,301.0,7.35,239,62,8,0,293,301,0,0,301,301,60,0,241,301,48,2,251,301,54,0,247,301
2997987,1891,203195,new-0.5,completed,301.0,7.75,229,72,51,0,250,301,44,0,257,301,0,0,301,301,17,21,263,301,43,0,258,301
2997987,1891,203195,new-1.0,completed,328.0,7.65,164,164,11,56,261,328,19,26,283,328,36,46,246,328,52,4,272,328,0,31,297,328
2997987,1891,178029,base,completed,352.0,7.15,152,200,39,49,264,352,24,25,303,352,0,92,260,352,20,56,276,352,37,106,209,352
2997987,1891,178029,base+,completed,334.0,7.35,187,147,10,44,280,334,13,49,272,334,60,13,261,334,70,50,214,334,0,18,316,334
2997987,1891,178029,dpv1,completed,332.0,7.55,212,120,36,17,279,332,0,15,317,332,66,36,230,332,64,0,268,332,5,52,275,332
2997987,1891,178029,dpv2,completed,303.0,7.6,223,80,46,23,234,303,52,0,251,303,0,5,298,303,16,0,287,303,6,0,297,303
2997987,1891,178029,new-0.0,completed,307.0,7.45,235,72,3,0,304,307,62,0,245,307,0,18,289,307,43,0,264,307,62,0,245,307
2997987,1891,178029,new-0.5,completed,296.0,7.7,243,53,46,0,250,296,39,4,253,296,49,0,247,296,0,0,296,296,8,0,288,296
2997987,1891,178029,new-1.0,completed,332.0,7.45,163,169,0,69,263,332,45,48,239,332,24,39,269,332,37,10,285,332,4,38,290,332
2997987,1891,239735,base,completed,320.0,7.25,189,131,0,84,236,320,2,0,318,320,36,0,284,320,62,0,258,320,36,38,246,320
2997987,1891,239735,base+,completed,356.0,7.15,155,201,14,0,342,356,50,81,225,356,63,52,241,356,60,65,231,356,0,63,293,356
2997987,1891,239735,dpv1,completed,320.0,7.45,186,134,29,19,272,320,13,0,307,320,46,33,241,320,0,62,258,320,56,46,218,320
2997987,1891,239735,dpv2,completed,315.0,7.6,192,123,66,43,206,315,70,0,245,315,0,24,291,315,37,0,278,315,15,0,300,315
2997987,1891,239735,new-0.0,completed,290.0,7.45,227,63,18,0,272,290,40,0,250,290,43,0,247,290,0,0,290,290,30,20,240,290
2997987,1891,239735,new-0.5,completed,292.0,7.7,223,69,8,0,284,292,0,14,278,292,69,0,223,292,47,0,245,292,45,1,246,292
2997987,1891,239735,new-1.0,completed,312.0,7.65,161,151,0,54,258,312,16,21,275,312,38,41,233,312,12,9,291,312,9,32,271,312
2997987,1891,675528,base,completed,336.0,7.3,189,147,80,0,256,336,31,0,305,336,38,55,243,336,90,14,232,336,0,39,297,336
2997987,1891,675528,base+,completed,309.0,7.45,224,85,12,0,297,309,0,15,294,309,75,1,233,309,26,0,283,309,75,9,225,309
2997987,1891,675528,dpv1,completed,333.0,7.45,193,140,25,11,297,333,16,0,317,333,62,25,246,333,0,58,275,333,71,41,221,333
2997987,1891,675528,dpv2,completed,312.0,7.65,207,105,41,0,271,312,58,3,251,312,0,6,306,312,35,48,229,312,4,0,308,312
2997987,1891,675528,new-0.0,completed,299.0,7.4,228,71,23,0,276,299,36,0,263,299,0,5,294,299,52,0,247,299,18,14,267,299
2997987,1891,675528,new-0.5,completed,307.0,7.65,249,58,12,1,294,307,36,0,271,307,0,0,307,307,52,5,250,307,48,0,259,307
2997987,1891,675528,new-1.0,completed,311.0,7.65,163,148,0,18,293,311,37,54,220,311,29,25,257,311,13,0,298,311,4,35,272,311
2997987,1891,380692,base,completed,304.0,7.05,188,116,0,8,296,304,66,0,238,304,20,0,284,304,4,63,237,304,28,0,276,304
2997987,1891,380692,base+,completed,341.0,7.05,152,189,11,59,271,341,66,43,232,341,33,35,273,341,66,0,275,341,0,75,266,341
2997987,1891,380692,dpv1,completed,312.0,7.55,204,108,17,21,274,312,49,0,263,312,39,38,235,312,12,11,289,312,0,48,264,312
2997987,1891,380692,dpv2,completed,311.0,7.6,223,88,69,0,242,311,60,10,241,311,16,0,295,311,37,0,274,311,0,20,291,311
2997987,1891,380692,new-0.0,completed,297.0,7.35,213,84,2,0,295,297,43,0,254,297,0,15,282,297,45,0,252,297,33,24,240,297
2997987,1891,380692,new-0.5,completed,299.0,7.7,239,60,10,0,289,299,42,0,257,299,60,0,239,299,49,0,250,299,0,0,299,299
2997987,1891,380692,new-1.0,completed,341.0,7.6,165,176,0,35,306,341,53,66,222,341,49,45,247,341,6,4,331,341,55,41,245,341
4260327,1671,310811,base,completed,290.0,7.0,145,145,0,8,282,290,26,0,264,290,11,76,203,290,69,0,221,290,10,0,280,290
4260327,1671,310811,base+,completed,278.0,6.8,162,116,0,0,278,278,16,11,251,278,7,50,221,278,20,36,222,278,30,0,248,278
4260327,1671,310811,dpv1,completed,260.0,7.1,188,72,0,0,260,260,26,46,188,260,22,0,238,260,20,0,240,260,1,0,259,260
4260327,1671,310811,dpv2,completed,272.0,7.35,153,119,12,0,260,272,0,59,213,272,22,0,250,272,26,0,246,272,60,0,212,272
4260327,1671,310811,new-0.0,completed,269.0,6.9,204,65,60,0,209,269,21,4,244,269,0,5,264,269,32,0,237,269,41,0,228,269
4260327,1671,310811,new-0.5,completed,258.0,7.45,211,47,0,0,258,258,15,0,243,258,47,0,211,258,22,0,236,258,42,0,216,258
4260327,1671,310811,new-1.0,completed,287.0,7.45,137,150,0,43,244,287,60,47,180,287,33,35,219,287,31,0,256,287,8,0,279,287
4260327,1671,208428,base,completed,283.0,6.85,180,103,0,40,243,283,27,40,216,283,37,0,246,283,15,0,268,283,60,0,223,283
4260327,1671,208428,base+,completed,291.0,7.0,157,134,26,49,216,291,48,0,243,291,13,37,241,291,55,0,236,291,0,16,275,291
4260327,1671,208428,dpv1,completed,269.0,7.0,176,93,0,45,224,269,10,18,241,269,27,16,226,269,11,3,255,269,20,0,249,269
4260327,1671,208428,dpv2,completed,304.0,7.25,164,140,0,38,266,304,33,0,271,304,56,7,241,304,71,55,178,304,67,0,237,304
4260327,1671,208428,new-0.0,completed,261.0,7.05,210,51,0,0,261,261,7,0,254,261,51,0,210,261,48,0,213,261,25,0,236,261
4260327,1671,208428,new-0.5,completed,258.0,7.45,209,49,8,0,250,258,0,0,258,258,49,0,209,258,21,0,237,258,31,0,227,258
4260327,1671,208428,new-1.0,completed,291.0,7.4,135,156,9,41,241,291,0,48,243,291,33,36,222,291,24,0,267,291,64,0,227,291
4260327,1671,460300,base,completed,285.0,7.0,143,142,7,21,257,285,65,0,220,285,8,77,200,285,36,0,249,285,0,0,285,285
4260327,1671,460300,base+,completed,266.0,7.05,216,50,50,0,216,266,20,0,246,266,33,0,233,266,11,5,250,266,0,0,266,266
4260327,1671,460300,dpv1,completed,274.0,7.1,185,89,0,0,274,274,32,42,200,274,47,0,227,274,31,0,243,274,12,0,262,274
4260327,1671,460300,dpv2,completed,288.0,7.45,170,118,0,14,274,288,72,23,193,288,42,2,244,288,37,0,251,288,29,16,243,288
4260327,1671,460300,new-0.0,completed,282.0,6.95,169,113,65,14,203,282,14,0,268,282,0,0,282,282,59,0,223,282,29,34,219,282
4260327,1671,460300,new-0.5,completed,270.0,7.45,209,61,0,0,270,270,23,0,247,270,57,0,213,270,21,0,249,270,61,0,209,270
4260327,1671,460300,new-1.0,completed,278.0,7.4,143,135,36,0,242,278,43,80,155,278,13,12,253,278,0,0,278,278,21,0,257,278
4260327,1671,309704,base,completed,295.0,7.15,129,166,23,0,272,295,0,88,207,295,22,0,273,295,69,0,226,295,11,67,217,295
4260327,1671,309704,base+,completed,270.0,6.95,206,64,0,3,267,270,61,0,209,270,10,0,260,270,2,12,256,270,57,0,213,270
4260327,1671,309704,dpv1,completed,274.0,7.05,160,114,0,26,248,274,17,66,191,274,48,0,226,274,11,0,263,274,4,0,270,274
4260327,1671,309704,dpv2,completed,287.0,7.4,160,127,14,0,273,287,69,22,196,287,0,24,263,287,53,0,234,287,3,38,246,287
4260327,1671,309704,new-0.0,completed,278.0,7.0,163,115,63,16,199,278,10,15,253,278,0,3,275,278,50,0,228,278,13,24,241,278
4260327,1671,309704,new-0.5,completed,257.0,7.45,197,60,60,0,197,257,0,0,257,257,32,0,225,257,23,0,234,257,1,0,256,257
4260327,1671,309704,new-1.0,completed,271.0,7.4,162,109,38,0,233,271,51,55,165,271,17,3,251,271,0,0,271,271,14,0,257,271
4260327,1671,247588,base,completed,319.0,6.75,134,185,16,39,264,319,26,54,239,319,0,10,309,319,24,108,187,319,40,54,225,319
4260327,1671,247588,base+,completed,315.0,6.9,177,138,66,41,208,315,34,6,275,315,0,67,248,315,25,62,228,315,65,0,250,315
4260327,1671,247588,dpv1,completed,277.0,7.0,134,143,0,82,195,277,8,41,228,277,41,0,236,277,9,0,268,277,7,0,270,277
4260327,1671,247588,dpv2,completed,275.0,7.4,167,108,20,0,255,275,59,26,190,275,0,23,252,275,34,0,241,275,11,18,246,275
4260327,1671,247588,new-0.0,completed,262.0,7.0,192,70,0,3,259,262,16,10,236,262,58,9,195,262,27,0,235,262,49,0,213,262
4260327,1671,247588,new-0.5,completed,276.0,7.45,207,69,0,0,276,276,43,0,233,276,69,0,207,276,54,0,222,276,69,0,207,276
4260327,1671,247588,new-1.0,completed,288.0,7.4,135,153,3,43,242,288,0,59,229,288,28,38,222,288,31,0,257,288,61,0,227,288
4260327,1671,203195,base,completed,275.0,7.1,226,49,0,0,275,275,30,0,245,275,46,0,229,275,42,0,233,275,49,0,226,275
4260327,1671,203195,base+,completed,278.0,6.85,164,114,13,0,265,278,18,0,260,278,72,22,184,278,11,0,267,278,0,51,227,278
4260327,1671,203195,dpv1,completed,267.0,7.05,175,92,1,42,224,267,50,0,217,267,0,0,267,267,38,0,229,267,27,7,233,267
4260327,1671,203195,dpv2,completed,310.0,7.45,134,176,34,0,276,310,0,44,266,310,32,23,255,310,56,78,176,310,60,22,228,310
4260327,1671,203195,new-0.0,completed,259.0,6.95,197,62,57,0,202,259,3,9,247,259,0,5,254,259,14,0,245,259,35,0,224,259
4260327,1671,203195,new-0.5,completed,255.0,7.45,216,39,0,0,255,255,13,0,242,255,39,0,216,255,15,0,240,255,25,0,230,255
4260327,1671,203195,new-1.0,completed,295.0,7.4,147,148,10,43,242,295,0,61,234,295,41,44,210,295,21,0,274,295,49,0,246,295
4260327,1671,178029,base,completed,327.0,6.9,99,228,8,66,253,327,64,70,193,327,8,39,280,327,11,0,316,327,0,164,163,327
4260327,1671,178029,base+,completed,306.0,7.15,131,175,23,0,283,306,12,70,224,306,15,77,214,306,49,13,244,306,0,83,223,306
4260327,1671,178029,dpv1,completed,288.0,7.1,141,147,21,33,234,288,21,62,205,288,57,0,231,288,38,0,250,288,0,0,288,288
4260327,1671,178029,dpv2,completed,293.0,7.35,162,131,0,11,282,293,61,0,232,293,35,10,248,293,58,59,176,293,29,0,264,293
4260327,1671,178029,new-0.0,completed,265.0,7.0,202,63,29,0,236,265,44,4,217,265,59,0,206,265,15,0,250,265,0,0,265,265
4260327,1671,178029,new-0.5,completed,282.0,7.45,213,69,46,5,231,282,64,0,218,282,54,0,228,282,52,0,230,282,0,0,282,282
4260327,1671,178029,new-1.0,completed,274.0,7.4,155,119,38,0,236,274,54,62,158,274,19,3,252,274,5,0,269,274,0,0,274,274
4260327,1671,239735,base,completed,273.0,7.2,190,83,0,6,267,273,21,0,252,273,13,9,251,273,68,0,205,273,13,36,224,273
4260327,1671,239735,base+,completed,281.0,6.8,154,127,13,5,263,281,36,0,245,281,53,0,228,281,0,65,216,281,8,38,235,281
4260327,1671,239735,dpv1,completed,265.0,7.1,188,77,17,46,202,265,29,0,236,265,31,17,217,265,0,4,261,265,8,0,257,265
4260327,1671,239735,dpv2,completed,266.0,7.4,169,97,15,0,251,266,59,16,191,266,0,2,264,266,45,0,221,266,3,20,243,266
4260327,1671,239735,new-0.0,completed,255.0,6.95,201,54,40,0,215,255,6,0,249,255,0,0,255,255,12,14,229,255,23,0,232,255
4260327,1671,239735,new-0.5,completed,270.0,7.45,206,64,47,8,215,270,56,0,214,270,39,0,231,270,51,0,219,270,0,0,270,270
4260327,1671,239735,new-1.0,completed,287.0,7.45,128,159,59,37,191,287,0,52,235,287,30,47,210,287,27,0,260,287,23,0,264,287
4260327,1671,675528,base,completed,312.0,6.75,134,178,23,11,278,312,13,121,178,312,0,101,211,312,15,0,297,312,59,0,253,312
4260327,1671,675528,base+,completed,285.0,6.9,143,142,60,0,225,285,8,15,262,285,1,0,284,285,50,0,235,285,0,97,188,285
4260327,1671,675528,dpv1,completed,269.0,7.1,188,81,34,0,235,269,27,47,195,269,32,0,237,269,3,0,266,269,0,0,269,269
4260327,1671,675528,dpv2,completed,294.0,7.4,180,114,59,23,212,294,0,41,253,294,30,0,264,294,56,0,238,294,40,14,240,294
4260327,1671,675528,new-0.0,completed,263.0,7.0,210,53,8,2,253,263,0,0,263,263,51,0,212,263,0,9,254,263,50,0,213,263
4260327,1671,675528,new-0.5,completed,267.0,7.4,207,60,60,0,207,267,8,0,259,267,35,0,232,267,58,0,209,267,0,0,267,267
4260327,1671,675528,new-1.0,completed,274.0,7.4,172,102,43,0,231,274,47,51,176,274,32,4,238,274,20,0,254,274,0,0,274,274
4260327,1671,380692,base,completed,286.0,6.9,155,131,11,0,275,286,0,42,244,286,5,70,211,286,61,0,225,286,5,0,281,286
4260327,1671,380692,base+,completed,281.0,6.7,141,140,22,23,236,281,29,0,252,281,15,61,205,281,0,0,281,281,56,0,225,281
4260327,1671,380692,dpv1,completed,270.0,7.15,167,103,12,67,191,270,28,0,242,270,29,0,241,270,27,0,243,270,0,7,263,270
4260327,1671,380692,dpv2,completed,278.0,7.3,143,135,0,22,256,278,3,74,201,278,5,10,263,278,32,0,246,278,61,0,217,278
4260327,1671,380692,new-0.0,completed,269.0,6.95,178,91,18,8,243,269,23,0,246,269,67,12,190,269,0,12,257,269,30,0,239,269
4260327,1671,380692,new-0.5,completed,271.0,7.45,209,62,0,0,271,271,30,0,241,271,59,0,212,271,27,0,244,271,62,0,209,271
4260327,1671,380692,new-1.0,completed,274.0,7.45,164,110,40,4,230,274,49,55,170,274,9,0,265,274,0,0,274,274,11,2,261,274
5899589,1856,310811,base,completed,332.0,6.7,154,178,63,7,262,332,0,26,306,332,36,68,228,332,5,27,300,332,56,29,247,332
5899589,1856,310811,base+,completed,379.0,6.9,87,292,0,0,379,379,61,201,117,379,68,22,289,379,23,55,301,379,67,53,259,379
5899589,1856,310811,dpv1,completed,378.0,6.95,74,304,82,101,195,378,56,21,301,378,0,0,378,378,51,160,167,378,47,56,275,378
5899589,1856,310811,dpv2,completed,325.0,7.05,157,168,0,60,265,325,24,35,266,325,9,11,305,325,71,32,222,325,38,12,275,325
5899589,1856,310811,new-0.0,completed,290.0,6.75,219,71,42,0,248,290,0,0,290,290,13,19,258,290,27,19,244,290,1,0,289,290
5899589,1856,310811,new-0.5,completed,308.0,6.95,192,116,6,30,272,308,30,7,271,308,23,0,285,308,52,0,256,308,0,62,246,308
5899589,1856,310811,new-1.0,completed,334.0,7.0,165,169,63,24,247,334,48,0,286,334,31,45,258,334,0,59,275,334,62,11,261,334
5899589,1856,208428,base,completed,448.0,6.7,59,389,17,293,138,448,58,42,348,448,44,0,404,448,0,269,179,448,79,104,265,448
5899589,1856,208428,base+,completed,375.0,6.8,91,284,11,155,209,375,44,12,319,375,0,0,375,375,69,196,110,375,24,35,316,375
5899589,1856,208428,dpv1,completed,359.0,7.0,63,296,35,80,244,359,0,5,354,359,65,34,260,359,1,181,177,359,38,22,299,359
5899589,1856,208428,dpv2,completed,333.0,6.85,126,207,47,44,242,333,37,30,266,333,10,7,316,333,30,0,303,333,0,147,186,333
5899589,1856,208428,new-0.0,completed,309.0,6.8,211,98,0,0,309,309,43,20,246,309,9,37,263,309,51,0,258,309,50,0,259,309
5899589,1856,208428,new-0.5,completed,298.0,6.95,199,99,50,24,224,298,20,0,278,298,30,0,268,298,0,14,284,298,19,25,254,298
5899589,1856,208428,new-1.0,completed,330.0,7.0,182,148,48,25,257,330,49,4,277,330,26,45,259,330,0,54,276,330,51,0,279,330
5899589,1856,460300,base,completed,415.0,6.8,69,346,87,24,304,415,24,0,391,415,0,113,302,415,59,180,176,415,122,115,178,415
5899589,1856,460300,base+,completed,361.0,7.1,129,232,32,13,316,361,60,90,211,361,91,0,270,361,0,100,261,361,45,23,293,361
5899589,1856,460300,dpv1,completed,377.0,6.95,71,306,20,93,264,377,79,26,272,377,0,34,343,377,17,166,194,377,47,30,300,377
5899589,1856,460300,dpv2,completed,413.0,7.0,81,332,43,161,209,413,38,33,342,413,65,0,348,413,0,255,158,413,8,104,301,413
5899589,1856,460300,new-0.0,completed,307.0,6.95,216,91,37,0,270,307,0,11,296,307,21,31,255,307,35,33,239,307,16,3,288,307
5899589,1856,460300,new-0.5,completed,301.0,6.95,204,97,0,35,266,301,23,0,278,301,33,0,268,301,46,0,255,301,11,25,265,301
5899589,1856,460300,new-1.0,completed,333.0,7.05,180,153,12,17,304,333,40,12,281,333,85,56,192,333,0,0,333,333,51,26,256,333
5899589,1856,309704,base,completed,390.0,6.75,78,312,54,49,287,390,0,213,177,390,32,33,325,390,103,0,287,390,73,51,266,390
5899589,1856,309704,base+,completed,390.0,6.8,71,319,54,166,170,390,0,154,236,390,43,0,347,390,34,0,356,390,98,63,229,390
5899589,1856,309704,dpv1,completed,359.0,6.85,86,273,56,88,215,359,0,0,359,359,48,148,163,359,22,46,291,359,25,42,292,359
5899589,1856,309704,dpv2,completed,325.0,7.0,120,205,0,141,184,325,42,30,253,325,5,4,316,325,34,0,291,325,33,0,292,325
5899589,1856,309704,new-0.0,completed,298.0,6.9,215,83,9,0,289,298,17,0,281,298,0,30,268,298,47,25,226,298,28,0,270,298
5899589,1856,309704,new-0.5,completed,307.0,7.0,207,100,62,26,219,307,0,0,307,307,8,0,299,307,54,0,253,307,22,21,264,307
5899589,1856,309704,new-1.0,completed,334.0,7.0,154,180,57,28,249,334,16,0,318,334,36,53,245,334,31,0,303,334,0,80,254,334
5899589,1856,247588,base,completed,429.0,6.95,50,379,64,104,261,429,32,26,371,429,70,136,223,429,0,58,371,429,70,237,122,429
5899589,1856,247588,base+,completed,351.0,6.75,99,252,51,121,179,351,32,22,297,351,54,20,277,351,0,5,346,351,15,131,205,351
5899589,1856,247588,dpv1,completed,360.0,6.85,53,307,39,84,237,360,6,3,351,360,0,197,163,360,61,33,266,360,35,47,278,360
5899589,1856,247588,dpv2,completed,365.0,7.15,78,287,38,92,235,365,32,0,333,365,73,0,292,365,0,239,126,365,34,33,298,365
5899589,1856,247588,new-0.0,completed,286.0,6.7,207,79,19,0,267,286,5,0,281,286,14,21,251,286,37,35,214,286,0,3,283,286
5899589,1856,247588,new-0.5,completed,306.0,6.95,198,108,52,29,225,306,1,0,305,306,25,0,281,306,0,0,306,306,55,47,204,306
5899589,1856,247588,new-1.0,completed,313.0,7.05,196,117,0,0,313,313,28,0,285,313,11,55,247,313,66,0,247,313,42,23,248,313
5899589,1856,203195,base,completed,370.0,6.9,79,291,36,105,229,370,0,50,320,370,65,86,219,370,100,0,270,370,27,36,307,370
5899589,1856,203195,base+,completed,384.0,6.85,79,305,55,66,263,384,0,49,335,384,33,11,340,384,38,148,198,384,89,76,219,384
5899589,1856,203195,dpv1,completed,376.0,6.95,99,277,33,95,248,376,63,31,282,376,0,52,324,376,30,164,182,376,65,0,311,376
5899589,1856,203195,dpv2,completed,375.0,6.8,116,259,0,208,167,375,46,31,298,375,12,108,255,375,72,0,303,375,36,11,328,375
5899589,1856,203195,new-0.0,completed,290.0,6.8,212,78,32,0,258,290,16,0,274,290,0,36,254,290,37,20,233,290,7,0,283,290
5899589,1856,203195,new-0.5,completed,312.0,6.9,215,97,66,20,226,312,0,18,294,312,26,0,286,312,25,0,287,312,23,31,258,312
5899589,1856,203195,new-1.0,completed,302.0,7.05,185,117,14,0,288,302,0,20,282,302,14,50,238,302,1,11,290,302,36,29,237,302
5899589,1856,178029,base,completed,397.0,6.85,70,327,0,229,168,397,9,234,154,397,0,73,324,397,48,39,310,397,46,0,351,397
5899589,1856,178029,base+,completed,384.0,6.75,82,302,0,236,148,384,21,0,363,384,42,0,342,384,55,90,239,384,11,166,207,384
5899589,1856,178029,dpv1,completed,369.0,6.85,89,280,68,82,219,369,50,30,289,369,44,150,175,369,0,0,369,369,35,38,296,369
5899589,1856,178029,dpv2,completed,372.0,6.95,112,260,29,37,306,372,0,66,306,372,93,109,170,372,24,0,348,372,41,144,187,372
5899589,1856,178029,new-0.0,completed,282.0,6.9,210,72,2,0,280,282,9,6,267,282,4,27,251,282,34,24,224,282,0,0,282,282
5899589,1856,178029,new-0.5,completed,312.0,7.0,209,103,10,28,274,312,34,2,276,312,0,0,312,312,50,0,262,312,55,44,213,312
5899589,1856,178029,new-1.0,completed,312.0,7.05,195,117,26,10,276,312,13,13,286,312,7,57,248,312,0,8,304,312,38,32,242,312
5899589,1856,239735,base,completed,362.0,6.6,97,265,0,83,279,362,22,12,328,362,31,83,248,362,46,133,183,362,46,0,316,362
5899589,1856,239735,base+,completed,376.0,6.6,85,291,48,0,328,376,0,0,376,376,77,148,151,376,48,14,314,376,21,218,137,376
5899589,1856,239735,dpv1,completed,374.0,6.95,59,315,27,94,253,374,70,0,304,374,0,76,298,374,31,165,178,374,50,40,284,374
5899589,1856,239735,dpv2,completed,330.0,7.15,82,248,18,23,289,330,45,0,285,330,70,0,260,330,0,167,163,330,15,10,305,330
5899589,1856,239735,new-0.0,completed,293.0,6.95,219,74,45,0,248,293,47,17,229,293,3,0,290,293,0,23,270,293,41,0,252,293
5899589,1856,239735,new-0.5,completed,305.0,7.0,221,84,29,17,259,305,0,4,301,305,53,0,252,305,52,1,252,305,29,16,260,305
5899589,1856,239735,new-1.0,completed,319.0,7.0,142,177,39,27,253,319,49,27,243,319,5,65,249,319,0,37,282,319,13,14,292,319
5899589,1856,675528,base,completed,496.0,6.8,80,416,62,77,357,496,77,247,172,496,122,0,374,496,0,345,151,496,31,162,303,496
5899589,1856,675528,base+,completed,406.0,6.7,58,348,0,235,171,406,57,175,174,406,53,2,351,406,28,0,378,406,118,0,288,406
5899589,1856,675528,dpv1,completed,391.0,7.0,55,336,0,127,264,391,95,0,296,391,73,50,268,391,40,169,182,391,37,36,318,391
5899589,1856,675528,dpv2,completed,322.0,7.05,168,154,52,12,258,322,47,35,240,322,0,66,256,322,4,1,317,322,35,17,270,322
5899589,1856,675528,new-0.0,completed,296.0,6.95,226,70,32,0,264,296,25,0,271,296,22,22,252,296,11,26,259,296,0,3,293,296
5899589,1856,675528,new-0.5,completed,317.0,6.75,212,105,10,28,279,317,45,31,241,317,0,0,317,317,61,0,256,317,60,13,244,317
5899589,1856,675528,new-1.0,completed,334.0,7.0,164,170,38,29,267,334,51,5,278,334,31,49,254,334,0,64,270,334,54,0,280,334
5899589,1856,380692,base,completed,432.0,6.9,82,350,0,78,354,432,67,168,197,432,67,255,110,432,95,88,249,432,30,0,402,432
5899589,1856,380692,base+,completed,397.0,6.75,71,326,0,248,149,397,60,80,257,397,19,0,378,397,13,54,330,397,57,93,247,397
5899589,1856,380692,dpv1,completed,387.0,6.95,61,326,37,103,247,387,84,22,281,387,57,70,260,387,28,171,188,387,0,29,358,387
5899589,1856,380692,dpv2,completed,374.0,7.15,84,290,52,80,242,374,0,30,344,374,37,32,305,374,42,190,142,374,3,67,304,374
5899589,1856,380692,new-0.0,completed,294.0,6.7,202,92,10,0,284,294,10,0,284,294,20,27,247,294,41,38,215,294,0,5,289,294
5899589,1856,380692,new-0.5,completed,298.0,6.7,227,71,0,18,280,298,21,20,257,298,39,0,259,298,4,0,294,298,40,8,250,298
5899589,1856,380692,new-1.0,completed,334.0,7.0,157,177,44,21,269,334,60,1,273,334,27,65,242,334,41,0,293,334,0,61,273,334
7394070,1413,310811,base,completed,260.0,7.35,137,123,79,0,181,260,18,0,242,260,76,0,184,260,25,30,205,260,0,66,194,260
7394070,1413,310811,base+,completed,265.0,7.0,143,122,70,0,195,265,25,0,240,265,23,22,220,265,0,68,197,265,77,0,188,265
7394070,1413,310811,dpv1,completed,238.0,7.35,153,85,27,0,211,238,77,0,161,238,19,0,219,238,42,0,196,238,0,31,207,238
7394070,1413,310811,dpv2,completed,253.0,7.4,131,122,38,10,205,253,75,0,178,253,16,56,181,253,0,62,191,253,42,0,211,253
7394070,1413,310811,new-0.0,completed,229.0,7.0,146,83,72,0,157,229,24,1,204,229,28,0,201,229,0,28,201,229,54,0,175,229
7394070,1413,310811,new-0.5,completed,269.0,7.7,151,118,81,0,188,269,91,0,178,269,79,0,190,269,20,37,212,269,0,54,215,269
7394070,1413,310811,new-1.0,completed,225.0,7.85,154,71,0,0,225,225,30,8,187,225,35,34,156,225,1,0,224,225,37,0,188,225
7394070,1413,208428,base,completed,277.0,7.05,123,154,49,28,200,277,0,38,239,277,27,71,179,277,84,0,193,277,83,0,194,277
7394070,1413,208428,base+,completed,263.0,6.85,148,115,86,0,177,263,17,18,228,263,75,0,188,263,46,22,195,263,0,40,223,263
7394070,1413,208428,dpv1,completed,234.0,7.25,182,52,0,10,224,234,42,0,192,234,25,0,209,234,34,0,200,234,40,0,194,234
7394070,1413,208428,dpv2,completed,235.0,7.3,161,74,21,0,214,235,69,0,166,235,37,0,198,235,17,0,218,235,0,23,212,235
7394070,1413,208428,new-0.0,completed,228.0,6.9,141,87,23,0,205,228,0,29,199,228,54,0,174,228,66,0,162,228,19,6,203,228
7394070,1413,208428,new-0.5,completed,249.0,7.8,147,102,0,25,224,249,51,0,198,249,22,23,204,249,56,0,193,249,73,0,176,249
7394070,1413,208428,new-1.0,completed,225.0,7.75,177,48,46,0,179,225,47,0,178,225,0,1,224,225,46,0,179,225,11,0,214,225
7394070,1413,460300,base,completed,265.0,7.05,115,150,24,0,241,265,77,0,188,265,0,99,166,265,27,29,209,265,67,0,198,265
7394070,1413,460300,base+,completed,233.0,7.1,169,64,0,0,233,233,59,0,174,233,24,0,209,233,48,0,185,233,2,10,221,233
7394070,1413,460300,dpv1,completed,272.0,7.05,146,126,59,0,213,272,89,5,178,272,103,0,169,272,26,32,214,272,0,49,223,272
7394070,1413,460300,dpv2,completed,245.0,7.2,160,85,68,0,177,245,0,36,209,245,66,0,179,245,25,0,220,245,18,0,227,245
7394070,1413,460300,new-0.0,completed,223.0,7.15,147,76,29,0,194,223,0,31,192,223,10,0,213,223,16,0,207,223,46,0,177,223
7394070,1413,460300,new-0.5,completed,263.0,7.7,170,93,83,0,180,263,91,0,172,263,68,0,195,263,26,10,227,263,0,37,226,263
7394070,1413,460300,new-1.0,completed,229.0,7.8,146,83,5,0,224,229,0,0,229,229,35,39,155,229,44,0,185,229,30,0,199,229
7394070,1413,309704,base,completed,285.0,7.15,119,166,77,0,208,285,15,31,239,285,54,59,172,285,102,0,183,285,0,76,209,285
7394070,1413,309704,base+,completed,235.0,6.9,161,74,56,7,172,235,29,11,195,235,52,0,183,235,0,0,235,235,33,0,202,235
7394070,1413,309704,dpv1,completed,236.0,7.4,151,85,19,0,217,236,30,0,206,236,47,0,189,236,0,38,198,236,53,0,183,236
7394070,1413,309704,dpv2,completed,246.0,7.2,164,82,76,0,170,246,0,22,224,246,68,0,178,246,26,0,220,246,39,3,204,246
7394070,1413,309704,new-0.0,completed,228.0,7.0,151,77,65,0,163,228,13,4,211,228,28,0,200,228,0,26,202,228,50,0,178,228
7394070,1413,309704,new-0.5,completed,258.0,7.75,157,101,74,0,184,258,86,0,172,258,0,51,207,258,69,0,189,258,22,15,221,258
7394070,1413,309704,new-1.0,completed,231.0,7.75,147,84,55,0,176,231,0,0,231,231,33,29,169,231,18,0,213,231,32,0,199,231
7394070,1413,247588,base,completed,265.0,7.05,147,118,24,4,237,265,50,22,193,265,0,63,202,265,80,0,185,265,87,0,178,265
7394070,1413,247588,base+,completed,266.0,6.7,144,122,90,0,176,266,23,4,239,266,82,0,184,266,54,22,190,266,0,65,201,266
7394070,1413,247588,dpv1,completed,223.0,7.25,187,36,36,0,187,223,21,0,202,223,31,0,192,223,23,0,200,223,0,0,223,223
7394070,1413,247588,dpv2,completed,239.0,7.45,134,105,0,58,181,239,4,0,235,239,15,0,224,239,66,0,173,239,54,0,185,239
7394070,1413,247588,new-0.0,completed,240.0,7.0,149,91,74,0,166,240,15,15,210,240,38,0,202,240,0,26,214,240,69,0,171,240
7394070,1413,247588,new-0.5,completed,249.0,7.75,162,87,71,0,178,249,76,0,173,249,0,41,208,249,62,0,187,249,9,10,230,249
7394070,1413,247588,new-1.0,completed,227.0,7.85,154,73,8,0,219,227,28,4,195,227,41,28,158,227,0,0,227,227,45,0,182,227
7394070,1413,203195,base,completed,238.0,6.9,130,108,14,27,197,238,0,0,238,238,45,0,193,238,25,36,177,238,41,0,197,238
7394070,1413,203195,base+,completed,280.0,6.85,152,128,0,63,217,280,20,28,232,280,78,2,200,280,72,11,197,280,100,0,180,280
7394070,1413,203195,dpv1,completed,250.0,7.35,159,91,65,0,185,250,0,35,215,250,86,0,164,250,23,0,227,250,36,0,214,250
7394070,1413,203195,dpv2,completed,241.0,7.25,148,93,19,16,206,241,0,44,197,241,41,0,200,241,1,34,206,241,65,0,176,241
7394070,1413,203195,new-0.0,completed,220.0,7.2,147,73,0,24,196,220,29,0,191,220,15,0,205,220,49,0,171,220,23,0,197,220
7394070,1413,203195,new-0.5,completed,267.0,7.7,145,122,87,0,180,267,82,0,185,267,0,41,226,267,27,35,205,267,90,0,177,267
7394070,1413,203195,new-1.0,completed,230.0,7.85,145,85,0,0,230,230,44,10,176,230,35,36,159,230,48,0,182,230,17,0,213,230
7394070,1413,178029,base,completed,287.0,6.9,140,147,119,0,168,287,81,4,202,287,0,65,222,287,81,0,206,287,26,66,195,287
7394070,1413,178029,base+,completed,251.0,7.1,152,99,30,0,221,251,75,0,176,251,82,0,169,251,26,0,225,251,0,43,208,251
7394070,1413,178029,dpv1,completed,244.0,7.45,172,72,65,0,179,244,43,0,201,244,0,19,225,244,56,0,188,244,16,0,228,244
7394070,1413,178029,dpv2,completed,256.0,7.2,160,96,0,38,218,256,71,0,185,256,64,0,192,256,30,23,203,256,17,12,227,256
7394070,1413,178029,new-0.0,completed,219.0,7.0,147,72,0,25,194,219,11,0,208,219,47,0,172,219,16,0,203,219,19,0,200,219
7394070,1413,178029,new-0.5,completed,251.0,7.7,153,98,75,0,176,251,59,0,192,251,0,35,216,251,18,23,210,251,79,0,172,251
7394070,1413,178029,new-1.0,completed,229.0,7.85,152,77,0,0,229,229,34,3,192,229,30,33,166,229,12,0,217,229,41,0,188,229
7394070,1413,239735,base,completed,260.0,6.9,132,128,63,0,197,260,79,0,181,260,0,48,212,260,22,49,189,260,19,9,232,260
7394070,1413,239735,base+,completed,265.0,7.1,118,147,0,48,217,265,91,34,140,265,47,7,211,265,29,14,222,265,72,0,193,265
7394070,1413,239735,dpv1,completed,220.0,7.35,159,61,51,0,169,220,0,12,208,220,20,0,200,220,31,0,189,220,13,0,207,220
7394070,1413,239735,dpv2,completed,235.0,7.4,142,93,20,20,195,235,43,0,192,235,9,23,203,235,0,45,190,235,60,0,175,235
7394070,1413,239735,new-0.0,completed,248.0,7.0,154,94,27,12,209,248,0,42,206,248,76,0,172,248,64,0,184,248,54,0,194,248
7394070,1413,239735,new-0.5,completed,252.0,7.65,155,97,74,0,178,252,20,10,222,252,71,8,173,252,70,0,182,252,0,41,211,252
7394070,1413,239735,new-1.0,completed,237.0,7.85,159,78,23,0,214,237,47,4,186,237,54,24,159,237,0,0,237,237,54,0,183,237
7394070,1413,675528,base,completed,286.0,7.05,127,159,67,0,219,286,0,80,206,286,114,0,172,286,26,81,179,286,78,0,208,286
7394070,1413,675528,base+,completed,240.0,7.05,150,90,0,48,192,240,56,0,184,240,50,0,190,240,11,0,229,240,16,0,224,240
7394070,1413,675528,dpv1,completed,232.0,7.3,151,81,0,37,195,232,47,0,185,232,12,0,220,232,23,0,209,232,4,4,224,232
7394070,1413,675528,dpv2,completed,257.0,7.2,143,114,31,0,226,257,20,49,188,257,59,0,198,257,0,29,228,257,84,0,173,257
7394070,1413,675528,new-0.0,completed,231.0,7.15,155,76,53,0,178,231,67,0,164,231,16,7,208,231,11,3,217,231,0,22,209,231
7394070,1413,675528,new-0.5,completed,246.0,7.65,168,78,69,0,177,246,14,7,225,246,66,2,178,246,49,0,197,246,0,32,214,246
7394070,1413,675528,new-1.0,completed,239.0,7.85,172,67,50,0,189,239,45,0,194,239,50,17,172,239,30,0,209,239,0,0,239,239
7394070,1413,380692,base,completed,275.0,7.05,124,151,58,7,210,275,0,40,235,275,82,0,193,275,24,70,181,275,76,0,199,275
7394070,1413,380692,base+,completed,257.0,6.95,146,111,10,27,220,257,56,5,196,257,66,0,191,257,0,66,191,257,82,0,175,257
7394070,1413,380692,dpv1,completed,228.0,7.4,146,82,42,0,186,228,62,0,166,228,17,0,211,228,5,0,223,228,0,31,197,228
7394070,1413,380692,dpv2,completed,238.0,7.2,158,80,0,31,207,238,16,0,222,238,70,0,168,238,79,0,159,238,19,0,219,238
7394070,1413,380692,new-0.0,completed,231.0,7.05,149,82,19,5,207,231,56,0,175,231,40,0,191,231,0,26,205,231,60,0,171,231
7394070,1413,380692,new-0.5,completed,251.0,7.75,160,91,74,0,177,251,74,0,177,251,0,46,205,251,76,0,175,251,13,9,229,251
7394070,1413,380692,new-1.0,completed,220.0,7.8,161,59,7,0,213,220,0,0,220,220,32,25,163,220,27,1,192,220,33,0,187,220
6359528,1633,310811,base,completed,273.0,6.85,193,80,16,20,237,273,80,0,193,273,25,0,248,273,0,27,246,273,8,0,265,273
6359528,1633,310811,base+,completed,301.0,7.05,192,109,15,73,213,301,88,0,213,301,24,0,277,301,43,0,258,301,0,75,226,301
6359528,1633,310811,dpv1,completed,278.0,7.1,188,90,87,3,188,278,7,0,271,278,21,0,257,278,0,33,245,278,16,44,218,278
6359528,1633,310811,dpv2,completed,292.0,7.3,200,92,0,29,263,292,85,0,207,292,66,0,226,292,23,0,269,292,16,49,227,292
6359528,1633,310811,new-0.0,completed,254.0,7.2,218,36,22,0,232,254,23,0,231,254,0,0,254,254,36,0,218,254,20,2,232,254
6359528,1633,310811,new-0.5,completed,266.0,7.3,208,58,0,0,266,266,44,0,222,266,38,0,228,266,17,26,223,266,23,0,243,266
6359528,1633,310811,new-1.0,completed,280.0,7.3,180,100,0,68,212,280,35,0,245,280,16,59,205,280,5,0,275,280,20,0,260,280
6359528,1633,208428,base,completed,289.0,7.05,206,83,15,0,274,289,15,0,274,289,13,50,226,289,83,0,206,289,0,57,232,289
6359528,1633,208428,base+,completed,271.0,6.95,201,70,70,0,201,271,19,33,219,271,0,15,256,271,22,0,249,271,14,0,257,271
6359528,1633,208428,dpv1,completed,301.0,7.1,197,104,40,0,261,301,19,68,214,301,0,69,232,301,104,0,197,301,25,0,276,301
6359528,1633,208428,dpv2,completed,284.0,7.35,191,93,11,0,273,284,15,0,269,284,66,0,218,284,14,25,245,284,0,79,205,284
6359528,1633,208428,new-0.0,completed,265.0,7.2,206,59,21,0,244,265,49,0,216,265,0,7,258,265,48,0,217,265,14,29,222,265
6359528,1633,208428,new-0.5,completed,271.0,7.35,211,60,16,33,222,271,0,22,249,271,44,0,227,271,16,0,255,271,60,0,211,271
6359528,1633,208428,new-1.0,completed,284.0,7.3,183,101,0,71,213,284,18,0,266,284,16,62,206,284,20,0,264,284,46,0,238,284
6359528,1633,460300,base,completed,313.0,7.1,153,160,72,0,241,313,14,78,221,313,39,0,274,313,0,131,182,313,22,0,291,313
6359528,1633,460300,base+,completed,275.0,6.9,195,80,80,0,195,275,24,0,251,275,0,23,252,275,19,21,235,275,0,0,275,275
6359528,1633,460300,dpv1,completed,292.0,7.15,157,135,3,0,289,292,15,44,233,292,88,0,204,292,0,45,247,292,23,47,222,292
6359528,1633,460300,dpv2,completed,289.0,7.4,202,87,87,0,202,289,18,0,271,289,0,41,248,289,53,0,236,289,17,49,223,289
6359528,1633,460300,new-0.0,completed,260.0,7.2,202,58,41,17,202,260,35,0,225,260,40,0,220,260,34,0,226,260,0,0,260,260
6359528,1633,460300,new-0.5,completed,274.0,7.35,200,74,37,23,214,274,51,0,223,274,42,0,232,274,40,0,234,274,0,0,274,274
6359528,1633,460300,new-1.0,completed,288.0,7.3,159,129,16,30,242,288,0,20,268,288,26,0,262,288,79,50,159,288,10,0,278,288
6359528,1633,309704,base,completed,273.0,7.05,195,78,0,0,273,273,29,25,219,273,58,1,214,273,29,7,237,273,14,29,230,273
6359528,1633,309704,base+,completed,294.0,6.85,196,98,20,58,216,294,20,0,274,294,0,60,234,294,39,0,255,294,98,0,196,294
6359528,1633,309704,dpv1,completed,296.0,7.1,201,95,19,0,277,296,0,54,242,296,17,66,213,296,35,0,261,296,93,0,203,296
6359528,1633,309704,dpv2,completed,274.0,7.35,199,75,69,5,200,274,20,1,253,274,34,0,240,274,0,24,250,274,15,28,231,274
6359528,1633,309704,new-0.0,completed,277.0,7.2,211,66,47,0,230,277,61,0,216,277,48,0,229,277,0,0,277,277,41,9,227,277
6359528,1633,309704,new-0.5,completed,273.0,7.25,206,67,0,25,248,273,18,0,255,273,24,0,249,273,16,35,222,273,63,0,210,273
6359528,1633,309704,new-1.0,completed,285.0,7.3,162,123,19,38,228,285,79,4,202,285,0,65,220,285,10,0,275,285,20,0,265,285
6359528,1633,247588,base,completed,285.0,7.1,207,78,27,0,258,285,14,30,241,285,25,0,260,285,78,0,207,285,0,38,247,285
6359528,1633,247588,base+,completed,285.0,6.9,175,110,87,0,198,285,15,0,270,285,12,42,231,285,0,98,187,285,16,0,269,285
6359528,1633,247588,dpv1,completed,287.0,7.05,201,86,40,0,247,287,18,52,217,287,0,46,241,287,86,0,201,287,24,0,263,287
6359528,1633,247588,dpv2,completed,280.0,7.45,194,86,77,0,203,280,0,29,251,280,25,9,246,280,54,0,226,280,15,36,229,280
6359528,1633,247588,new-0.0,completed,254.0,7.2,207,47,16,0,238,254,34,0,220,254,0,6,248,254,26,0,228,254,14,21,219,254
6359528,1633,247588,new-0.5,completed,261.0,7.35,209,52,31,13,217,261,30,0,231,261,51,0,210,261,27,0,234,261,0,0,261,261
6359528,1633,247588,new-1.0,completed,298.0,7.4,176,122,20,0,278,298,12,78,208,298,52,0,246,298,0,88,210,298,58,0,240,298
6359528,1633,203195,base,completed,284.0,7.2,202,82,70,0,214,284,52,0,232,284,22,52,210,284,0,0,284,284,37,0,247,284
6359528,1633,203195,base+,completed,282.0,6.85,204,78,69,0,213,282,23,0,259,282,16,50,216,282,19,0,263,282,0,38,244,282
6359528,1633,203195,dpv1,completed,300.0,7.1,165,135,100,0,200,300,16,60,224,300,0,60,240,300,31,0,269,300,24,35,241,300
6359528,1633,203195,dpv2,completed,306.0,7.3,202,104,19,2,285,306,80,0,226,306,102,0,204,306,0,66,240,306,15,60,231,306
6359528,1633,203195,new-0.0,completed,262.0,7.25,199,63,0,0,262,262,47,0,215,262,39,0,223,262,31,0,231,262,35,16,211,262
6359528,1633,203195,new-0.5,completed,262.0,7.3,213,49,0,13,249,262,49,0,213,262,4,0,258,262,18,14,230,262,23,0,239,262
6359528,1633,203195,new-1.0,completed,279.0,7.3,184,95,0,58,221,279,43,0,236,279,17,52,210,279,7,0,272,279,20,0,259,279
6359528,1633,178029,base,completed,314.0,7.05,125,189,47,0,267,314,71,53,190,314,0,76,238,314,17,137,160,314,21,0,293,314
6359528,1633,178029,base+,completed,275.0,6.8,198,77,0,40,235,275,77,0,198,275,20,0,255,275,16,35,224,275,20,0,255,275
6359528,1633,178029,dpv1,completed,275.0,7.2,194,81,15,50,210,275,17,0,258,275,22,0,253,275,81,0,194,275,0,26,249,275
6359528,1633,178029,dpv2,completed,276.0,7.3,205,71,71,0,205,276,15,0,261,276,38,0,238,276,0,27,249,276,14,38,224,276
6359528,1633,178029,new-0.0,completed,256.0,7.15,213,43,17,14,225,256,0,7,249,256,22,0,234,256,24,0,232,256,43,0,213,256
6359528,1633,178029,new-0.5,completed,261.0,7.3,209,52,16,12,233,261,13,0,248,261,17,0,244,261,0,7,254,261,52,0,209,261
6359528,1633,178029,new-1.0,completed,277.0,7.25,176,101,4,51,222,277,0,0,277,277,19,60,198,277,21,0,256,277,45,0,232,277
6359528,1633,239735,base,completed,276.0,7.0,206,70,69,0,207,276,16,39,221,276,0,50,226,276,6,0,270,276,22,0,254,276
6359528,1633,239735,base+,completed,289.0,7.2,190,99,26,0,263,289,0,53,236,289,92,7,190,289,19,0,270,289,18,52,219,289
6359528,1633,239735,dpv1,completed,276.0,7.1,195,81,0,34,242,276,16,49,211,276,81,0,195,276,23,0,253,276,22,0,254,276
6359528,1633,239735,dpv2,completed,280.0,7.35,177,103,79,0,201,280,16,0,264,280,13,31,236,280,10,0,270,280,0,90,190,280
6359528,1633,239735,new-0.0,completed,265.0,7.25,205,60,0,0,265,265,40,0,225,265,37,0,228,265,36,0,229,265,33,20,212,265
6359528,1633,239735,new-0.5,completed,255.0,7.35,200,55,13,31,211,255,0,21,234,255,25,0,230,255,13,0,242,255,52,0,203,255
6359528,1633,239735,new-1.0,completed,285.0,7.3,171,114,0,64,221,285,17,0,268,285,15,74,196,285,41,0,244,285,52,0,233,285
6359528,1633,675528,base,completed,279.0,7.0,203,76,18,0,261,279,15,16,248,279,76,0,203,279,22,0,257,279,0,46,233,279
6359528,1633,675528,base+,completed,297.0,7.05,171,126,19,0,278,297,81,44,172,297,17,0,280,297,0,67,230,297,13,53,231,297
6359528,1633,675528,dpv1,completed,283.0,7.1,202,81,0,44,239,283,25,0,258,283,65,0,218,283,22,0,261,283,15,52,216,283
6359528,1633,675528,dpv2,completed,289.0,7.35,202,87,87,0,202,289,0,36,253,289,43,0,246,289,15,0,274,289,14,46,229,289
6359528,1633,675528,new-0.0,completed,248.0,7.15,209,39,15,15,218,248,0,1,247,248,17,0,231,248,20,0,228,248,36,0,212,248
6359528,1633,675528,new-0.5,completed,278.0,7.35,213,65,0,26,252,278,17,22,239,278,65,0,213,278,21,0,257,278,63,0,215,278
6359528,1633,675528,new-1.0,completed,285.0,7.3,189,96,0,56,229,285,20,0,265,285,18,55,212,285,29,0,256,285,46,0,239,285
6359528,1633,380692,base,completed,280.0,7.05,201,79,18,0,262,280,22,0,258,280,0,51,229,280,79,0,201,280,16,40,224,280
6359528,1633,380692,base+,completed,284.0,6.85,181,103,80,0,204,284,0,55,229,284,14,47,223,284,13,0,271,284,20,23,241,284
6359528,1633,380692,dpv1,completed,277.0,7.15,202,75,18,0,259,277,15,45,217,277,70,0,207,277,20,0,257,277,0,31,246,277
6359528,1633,380692,dpv2,completed,281.0,7.4,178,103,76,0,205,281,18,23,240,281,0,0,281,281,25,0,256,281,3,85,193,281
6359528,1633,380692,new-0.0,completed,278.0,7.2,198,80,56,0,222,278,45,19,214,278,54,0,224,278,0,0,278,278,64,0,214,278
6359528,1633,380692,new-0.5,completed,265.0,7.45,212,53,45,0,220,265,0,0,265,265,38,0,227,265,51,0,214,265,30,7,228,265
6359528,1633,380692,new-1.0,completed,281.0,7.3,181,100,0,60,221,281,44,0,237,281,17,60,204,281,22,0,259,281,5,0,276,281
4826783,1792,310811,base,completed,285.0,7.15,240,45,37,0,248,285,45,0,240,285,0,1,284,285,14,0,271,285,26,0,259,285
4826783,1792,310811,base+,completed,287.0,6.85,217,70,50,0,237,287,0,0,287,287,42,0,245,287,31,3,253,287,29,18,240,287
4826783,1792,310811,dpv1,completed,297.0,7.1,209,88,35,0,262,297,0,21,276,297,52,0,245,297,29,39,229,297,16,29,252,297
4826783,1792,310811,dpv2,completed,290.0,7.55,221,69,69,0,221,290,47,0,243,290,0,0,290,290,35,0,255,290,34,0,256,290
4826783,1792,310811,new-0.0,completed,308.0,7.15,223,85,68,0,240,308,73,0,235,308,77,0,231,308,85,0,223,308,0,0,308,308
4826783,1792,310811,new-0.5,completed,274.0,7.65,208,66,60,0,214,274,66,0,208,274,25,0,249,274,0,0,274,274,1,0,273,274
4826783,1792,310811,new-1.0,completed,310.0,7.55,204,106,70,0,240,310,62,33,215,310,56,3,251,310,0,0,310,310,38,0,272,310
4826783,1792,208428,base,completed,342.0,7.1,142,200,68,51,223,342,44,0,298,342,81,0,261,342,82,104,156,342,0,0,342,342
4826783,1792,208428,base+,completed,299.0,6.85,208,91,54,0,245,299,50,3,246,299,19,0,280,299,0,13,286,299,38,36,225,299
4826783,1792,208428,dpv1,completed,301.0,7.15,207,94,0,15,286,301,58,0,243,301,20,45,236,301,39,0,262,301,12,36,253,301
4826783,1792,208428,dpv2,completed,296.0,7.55,229,67,65,0,231,296,67,0,229,296,0,0,296,296,54,0,242,296,33,0,263,296
4826783,1792,208428,new-0.0,completed,274.0,7.2,231,43,0,0,274,274,29,0,245,274,43,0,231,274,43,0,231,274,16,0,258,274
4826783,1792,208428,new-0.5,completed,287.0,7.55,216,71,71,0,216,287,0,0,287,287,34,0,253,287,43,4,240,287,51,0,236,287
4826783,1792,208428,new-1.0,completed,292.0,7.55,230,62,38,0,254,292,35,6,251,292,52,4,236,292,28,9,255,292,0,0,292,292
4826783,1792,460300,base,completed,310.0,7.0,210,100,0,0,310,310,68,0,242,310,39,0,271,310,48,27,235,310,73,0,237,310
4826783,1792,460300,base+,completed,300.0,6.85,221,79,24,0,276,300,56,0,244,300,0,0,300,300,40,13,247,300,66,0,234,300
4826783,1792,460300,dpv1,completed,291.0,7.05,233,58,34,0,257,291,16,0,275,291,50,4,237,291,0,16,275,291,54,0,237,291
4826783,1792,460300,dpv2,completed,293.0,7.5,232,61,39,0,254,293,50,0,243,293,42,0,251,293,0,1,292,293,60,0,233,293
4826783,1792,460300,new-0.0,completed,302.0,7.15,221,81,71,0,231,302,54,0,248,302,0,0,302,302,72,3,227,302,78,0,224,302
4826783,1792,460300,new-0.5,completed,295.0,7.4,213,82,0,0,295,295,45,6,244,295,82,0,213,295,41,0,254,295,50,0,245,295
4826783,1792,460300,new-1.0,completed,294.0,7.4,203,91,16,0,278,294,39,13,242,294,40,0,254,294,44,34,216,294,0,0,294,294
4826783,1792,309704,base,completed,296.0,7.1,217,79,43,0,253,296,79,0,217,296,0,0,296,296,33,13,250,296,43,0,253,296
4826783,1792,309704,base+,completed,285.0,7.0,212,73,27,4,254,285,38,0,247,285,69,0,216,285,25,25,235,285,0,0,285,285
4826783,1792,309704,dpv1,completed,308.0,7.05,204,104,83,0,225,308,56,21,231,308,61,0,247,308,58,0,250,308,0,0,308,308
4826783,1792,309704,dpv2,completed,282.0,7.6,222,60,39,0,243,282,57,0,225,282,0,3,279,282,21,0,261,282,23,0,259,282
4826783,1792,309704,new-0.0,completed,292.0,7.3,218,74,61,0,231,292,38,0,254,292,0,0,292,292,54,13,225,292,58,0,234,292
4826783,1792,309704,new-0.5,completed,278.0,7.6,209,69,67,0,211,278,69,0,209,278,37,0,241,278,2,0,276,278,0,0,278,278
4826783,1792,309704,new-1.0,completed,290.0,7.45,221,69,0,0,290,290,22,3,265,290,48,0,242,290,49,0,241,290,28,17,245,290
4826783,1792,247588,base,completed,300.0,6.8,160,140,32,0,268,300,3,109,188,300,0,33,267,300,24,0,276,300,47,1,252,300
4826783,1792,247588,base+,completed,295.0,6.75,217,78,65,0,230,295,64,0,231,295,41,0,254,295,40,13,242,295,0,0,295,295
4826783,1792,247588,dpv1,completed,316.0,7.25,196,120,76,10,230,316,55,38,223,316,44,25,247,316,62,0,254,316,0,0,316,316
4826783,1792,247588,dpv2,completed,309.0,7.4,210,99,52,0,257,309,0,0,309,309,56,18,235,309,74,0,235,309,66,7,236,309
4826783,1792,247588,new-0.0,completed,293.0,7.2,218,75,59,0,234,293,48,0,245,293,75,0,218,293,0,0,293,293,61,0,232,293
4826783,1792,247588,new-0.5,completed,279.0,7.5,205,74,1,0,278,279,70,0,209,279,37,0,242,279,60,4,215,279,0,0,279,279
4826783,1792,247588,new-1.0,completed,302.0,7.55,212,90,54,0,248,302,48,29,225,302,65,2,235,302,0,0,302,302,23,0,279,302
4826783,1792,203195,base,completed,291.0,6.95,224,67,41,0,250,291,39,11,241,291,0,0,291,291,31,3,257,291,56,0,235,291
4826783,1792,203195,base+,completed,296.0,6.8,215,81,27,6,263,296,71,0,225,296,37,0,259,296,26,0,270,296,0,10,286,296
4826783,1792,203195,dpv1,completed,300.0,7.15,222,78,59,0,241,300,40,0,260,300,19,17,264,300,0,14,286,300,36,25,239,300
4826783,1792,203195,dpv2,completed,288.0,7.4,232,56,13,0,275,288,0,0,288,288,42,3,243,288,41,0,247,288,53,0,235,288
4826783,1792,203195,new-0.0,completed,301.0,7.35,223,78,73,0,228,301,56,0,245,301,78,0,223,301,67,0,234,301,0,0,301,301
4826783,1792,203195,new-0.5,completed,291.0,7.65,216,75,70,0,221,291,75,0,216,291,47,0,244,291,0,0,291,291,14,0,277,291
4826783,1792,203195,new-1.0,completed,327.0,7.65,177,150,72,0,255,327,67,44,216,327,0,0,327,327,75,31,221,327,48,0,279,327
4826783,1792,178029,base,completed,296.0,6.75,231,65,47,0,249,296,65,0,231,296,50,0,246,296,41,5,250,296,0,0,296,296
4826783,1792,178029,base+,completed,301.0,7.15,230,71,0,0,301,301,47,0,254,301,71,0,230,301,39,0,262,301,52,0,249,301
4826783,1792,178029,dpv1,completed,299.0,7.15,223,76,35,8,256,299,76,0,223,299,50,0,249,299,44,0,255,299,0,0,299,299
4826783,1792,178029,dpv2,completed,303.0,7.45,226,77,77,0,226,303,69,0,234,303,0,0,303,303,49,0,254,303,51,0,252,303
4826783,1792,178029,new-0.0,completed,261.0,7.45,228,33,23,0,238,261,7,0,254,261,5,0,256,261,0,0,261,261,33,0,228,261
4826783,1792,178029,new-0.5,completed,290.0,7.55,207,83,83,0,207,290,81,0,209,290,41,0,249,290,0,0,290,290,30,0,260,290
4826783,1792,178029,new-1.0,completed,286.0,7.45,216,70,0,0,286,286,25,0,261,286,43,12,231,286,30,0,256,286,32,15,239,286
4826783,1792,239735,base,completed,310.0,6.9,173,137,22,0,288,310,0,29,281,310,58,0,252,310,28,17,265,310,8,109,193,310
4826783,1792,239735,base+,completed,281.0,6.95,219,62,29,0,252,281,52,0,229,281,28,0,253,281,62,0,219,281,0,0,281,281
4826783,1792,239735,dpv1,completed,271.0,7.1,215,56,36,0,235,271,0,0,271,271,17,12,242,271,29,10,232,271,36,0,235,271
4826783,1792,239735,dpv2,completed,274.0,7.35,229,45,43,0,231,274,44,0,230,274,31,1,242,274,16,0,258,274,0,0,274,274
4826783,1792,239735,new-0.0,completed,259.0,7.25,225,34,0,0,259,259,15,0,244,259,3,0,256,259,34,0,225,259,30,0,229,259
4826783,1792,239735,new-0.5,completed,278.0,7.6,217,61,61,0,217,278,41,0,237,278,0,0,278,278,54,0,224,278,39,0,239,278
4826783,1792,239735,new-1.0,completed,292.0,7.55,194,98,60,0,232,292,57,38,197,292,58,0,234,292,0,0,292,292,24,0,268,292
4826783,1792,675528,base,completed,352.0,7.0,124,228,73,95,184,352,0,33,319,352,82,0,270,352,83,94,175,352,41,0,311,352
4826783,1792,675528,base+,completed,289.0,7.1,240,49,29,0,260,289,34,0,255,289,32,0,257,289,0,0,289,289,25,15,249,289
4826783,1792,675528,dpv1,completed,281.0,7.0,209,72,11,12,258,281,35,0,246,281,31,0,250,281,25,28,228,281,0,0,281,281
4826783,1792,675528,dpv2,completed,321.0,7.4,219,102,81,0,240,321,85,0,236,321,73,0,248,321,70,17,234,321,0,0,321,321
4826783,1792,675528,new-0.0,completed,302.0,7.35,230,72,69,0,233,302,63,0,239,302,72,0,230,302,0,0,302,302,72,0,230,302
4826783,1792,675528,new-0.5,completed,294.0,7.65,218,76,75,0,219,294,76,0,218,294,48,0,246,294,0,0,294,294,16,0,278,294
4826783,1792,675528,new-1.0,completed,291.0,7.45,198,93,0,0,291,291,29,46,216,291,5,1,285,291,44,0,247,291,35,4,252,291
4826783,1792,380692,base,completed,291.0,6.95,220,71,35,0,256,291,64,0,227,291,44,0,247,291,71,0,220,291,0,0,291,291
4826783,1792,380692,base+,completed,275.0,7.1,213,62,35,0,240,275,26,27,222,275,0,0,275,275,24,0,251,275,31,0,244,275
4826783,1792,380692,dpv1,completed,301.0,7.1,214,87,53,0,248,301,35,0,266,301,28,38,235,301,0,13,288,301,19,27,255,301
4826783,1792,380692,dpv2,completed,287.0,7.5,229,58,38,0,249,287,54,0,233,287,0,0,287,287,35,4,248,287,16,0,271,287
4826783,1792,380692,new-0.0,completed,292.0,7.3,212,80,59,8,225,292,47,0,245,292,0,0,292,292,58,0,234,292,72,0,220,292
4826783,1792,380692,new-0.5,completed,287.0,7.65,219,68,64,0,223,287,68,0,219,287,45,0,242,287,9,0,278,287,0,0,287,287
4826783,1792,380692,new-1.0,completed,285.0,7.5,211,74,19,0,266,285,17,9,259,285,55,2,228,285,11,0,274,285,0,10,275,285
4884278,1762,310811,base,completed,440.0,7.1,94,346,29,181,230,440,46,225,169,440,17,18,405,440,0,195,245,440,66,133,241,440
4884278,1762,310811,base+,completed,347.0,6.8,137,210,13,127,207,347,0,0,347,347,74,45,228,347,31,42,274,347,47,71,229,347
4884278,1762,310811,dpv1,completed,345.0,7.25,76,269,21,17,307,345,82,0,263,345,49,42,254,345,0,150,195,345,29,87,229,345
4884278,1762,310811,dpv2,completed,343.0,7.35,105,238,0,62,281,343,68,59,216,343,55,0,288,343,31,126,186,343,30,7,306,343
4884278,1762,310811,new-0.0,completed,302.0,7.05,155,147,34,7,261,302,48,43,211,302,61,0,241,302,28,4,270,302,0,46,256,302
4884278,1762,310811,new-0.5,completed,333.0,7.25,126,207,0,35,298,333,65,13,255,333,41,95,197,333,61,1,271,333,46,20,267,333
4884278,1762,310811,new-1.0,completed,297.0,7.25,158,139,38,57,202,297,20,0,277,297,0,8,289,297,45,37,215,297,9,4,284,297
4884278,1762,208428,base,completed,429.0,6.85,100,329,70,161,198,429,37,246,146,429,0,177,252,429,42,54,333,429,41,25,363,429
4884278,1762,208428,base+,completed,396.0,6.6,133,263,56,150,190,396,0,112,284,396,55,182,159,396,61,13,322,396,18,35,343,396
4884278,1762,208428,dpv1,completed,345.0,7.2,98,247,33,0,312,345,26,80,239,345,0,110,235,345,23,0,322,345,92,85,168,345
4884278,1762,208428,dpv2,completed,304.0,7.2,176,128,24,34,246,304,0,31,273,304,35,0,269,304,55,0,249,304,40,52,212,304
4884278,1762,208428,new-0.0,completed,292.0,7.0,179,113,0,50,242,292,32,0,260,292,70,0,222,292,41,1,250,292,7,0,285,292
4884278,1762,208428,new-0.5,completed,314.0,7.3,148,166,0,38,276,314,50,9,255,314,57,48,209,314,38,32,244,314,27,6,281,314
4884278,1762,208428,new-1.0,completed,288.0,7.25,179,109,40,40,208,288,8,0,280,288,11,5,272,288,54,15,219,288,0,0,288,288
4884278,1762,460300,base,completed,361.0,7.1,92,269,90,9,262,361,52,35,274,361,34,0,327,361,25,105,231,361,0,178,183,361
4884278,1762,460300,base+,completed,333.0,6.9,133,200,22,11,300,333,0,0,333,333,71,92,170,333,9,70,254,333,57,27,249,333
4884278,1762,460300,dpv1,completed,341.0,7.3,110,231,40,0,301,341,52,46,243,341,0,96,245,341,97,0,244,341,32,70,239,341
4884278,1762,460300,dpv2,completed,377.0,7.25,108,269,65,0,312,377,62,25,290,377,84,63,230,377,38,142,197,377,0,114,263,377
4884278,1762,460300,new-0.0,completed,288.0,7.2,178,110,16,4,268,288,21,0,267,288,0,12,276,288,38,43,207,288,51,0,237,288
4884278,1762,460300,new-0.5,completed,324.0,7.25,142,182,0,48,276,324,42,14,268,324,53,52,219,324,69,8,247,324,45,9,270,324
4884278,1762,460300,new-1.0,completed,305.0,7.3,148,157,0,34,271,305,7,9,289,305,8,26,271,305,48,43,214,305,73,0,232,305
4884278,1762,309704,base,completed,385.0,6.8,107,278,52,0,333,385,55,71,259,385,17,169,199,385,19,0,366,385,0,223,162,385
4884278,1762,309704,base+,completed,315.0,6.85,104,211,0,0,315,315,14,87,214,315,52,16,247,315,11,33,271,315,40,48,227,315
4884278,1762,309704,dpv1,completed,332.0,7.2,136,196,8,0,324,332,54,0,278,332,0,83,249,332,33,87,212,332,13,87,232,332
4884278,1762,309704,dpv2,completed,318.0,7.45,138,180,9,48,261,318,24,0,294,318,0,0,318,318,37,95,186,318,59,63,196,318
4884278,1762,309704,new-0.0,completed,312.0,7.05,127,185,34,65,213,312,50,11,251,312,63,0,249,312,34,20,258,312,0,41,271,312
4884278,1762,309704,new-0.5,completed,298.0,7.3,149,149,0,10,288,298,24,20,254,298,8,57,233,298,67,1,230,298,34,4,260,298
4884278,1762,309704,new-1.0,completed,305.0,7.25,153,152,51,35,219,305,57,12,236,305,0,14,291,305,28,49,228,305,1,0,304,305
4884278,1762,247588,base,completed,361.0,6.9,75,286,19,124,218,361,0,42,319,361,51,39,271,361,47,91,223,361,107,10,244,361
4884278,1762,247588,base+,completed,305.0,6.95,115,190,1,0,304,305,27,122,156,305,54,0,251,305,22,0,283,305,0,43,262,305
4884278,1762,247588,dpv1,completed,370.0,7.3,125,245,37,93,240,370,13,48,309,370,56,141,173,370,46,131,193,370,0,48,322,370
4884278,1762,247588,dpv2,completed,320.0,7.2,159,161,0,58,262,320,41,16,263,320,54,2,264,320,67,0,253,320,47,65,208,320
4884278,1762,247588,new-0.0,completed,292.0,6.9,146,146,30,49,213,292,0,2,290,292,51,0,241,292,27,27,238,292,3,20,269,292
4884278,1762,247588,new-0.5,completed,297.0,7.35,162,135,13,10,274,297,0,26,271,297,57,28,212,297,36,14,247,297,34,4,259,297
4884278,1762,247588,new-1.0,completed,297.0,7.3,139,158,12,28,257,297,0,6,291,297,1,29,267,297,37,59,201,297,68,0,229,297
4884278,1762,203195,base,completed,340.0,6.75,143,197,61,0,279,340,27,88,225,340,24,72,244,340,0,47,293,340,34,71,235,340
4884278,1762,203195,base+,completed,324.0,7.15,154,170,2,110,212,324,47,0,277,324,0,3,321,324,28,83,213,324,43,45,236,324
4884278,1762,203195,dpv1,completed,315.0,7.35,102,213,0,22,293,315,44,31,240,315,57,9,249,315,30,62,223,315,0,73,242,315
4884278,1762,203195,dpv2,completed,309.0,7.2,171,138,0,61,248,309,25,11,273,309,42,0,267,309,57,0,252,309,41,56,212,309
4884278,1762,203195,new-0.0,completed,292.0,6.85,185,107,52,22,218,292,32,0,260,292,0,20,272,292,67,0,225,292,18,4,270,292
4884278,1762,203195,new-0.5,completed,307.0,7.25,151,156,0,5,302,307,64,0,243,307,33,70,204,307,39,13,255,307,13,10,284,307
4884278,1762,203195,new-1.0,completed,302.0,7.15,132,170,47,42,213,302,23,36,243,302,0,27,275,302,45,9,248,302,12,9,281,302
4884278,1762,178029,base,completed,355.0,6.85,84,271,30,178,147,355,70,0,285,355,19,168,168,355,35,28,292,355,0,28,327,355
4884278,1762,178029,base+,completed,322.0,7.0,169,153,12,5,305,322,22,78,222,322,64,14,244,322,0,53,269,322,43,38,241,322
4884278,1762,178029,dpv1,completed,334.0,7.3,104,230,51,9,274,334,27,0,307,334,64,13,257,334,52,71,211,334,0,99,235,334
4884278,1762,178029,dpv2,completed,312.0,7.1,133,179,64,33,215,312,24,7,281,312,57,56,199,312,0,0,312,312,18,37,257,312
4884278,1762,178029,new-0.0,completed,291.0,7.05,178,113,30,46,215,291,50,0,241,291,0,17,274,291,37,0,254,291,7,0,284,291
4884278,1762,178029,new-0.5,completed,297.0,7.3,160,137,0,10,287,297,23,13,261,297,13,58,226,297,51,0,246,297,38,15,244,297
4884278,1762,178029,new-1.0,completed,305.0,7.25,135,170,54,33,218,305,54,1,250,305,3,10,292,305,28,66,211,305,0,10,295,305
4884278,1762,239735,base,completed,398.0,7.2,106,292,27,125,246,398,33,175,190,398,84,0,314,398,0,207,191,398,46,40,312,398
4884278,1762,239735,base+,completed,295.0,6.95,147,148,30,9,256,295,0,15,280,295,16,56,223,295,22,39,234,295,60,0,235,295
4884278,1762,239735,dpv1,completed,311.0,7.4,110,201,1,0,310,311,51,0,260,311,12,58,241,311,0,104,207,311,29,74,208,311
4884278,1762,239735,dpv2,completed,318.0,7.2,109,209,57,41,220,318,39,10,269,318,53,0,265,318,27,94,197,318,0,30,288,318
4884278,1762,239735,new-0.0,completed,301.0,6.9,152,149,45,35,221,301,81,0,220,301,0,39,262,301,29,20,252,301,30,10,261,301
4884278,1762,239735,new-0.5,completed,308.0,7.3,145,163,51,0,257,308,25,16,267,308,49,48,211,308,37,32,239,308,0,51,257,308
4884278,1762,239735,new-1.0,completed,306.0,7.25,143,163,46,35,225,306,66,13,227,306,0,25,281,306,36,58,212,306,8,0,298,306
4884278,1762,675528,base,completed,418.0,6.8,96,322,13,135,270,418,70,170,178,418,0,152,266,418,38,7,373,418,16,219,183,418
4884278,1762,675528,base+,completed,334.0,6.95,118,216,19,106,209,334,67,0,267,334,17,103,214,334,62,40,232,334,0,0,334,334
4884278,1762,675528,dpv1,completed,373.0,7.45,97,276,48,0,325,373,84,24,265,373,63,48,262,373,0,152,221,373,44,139,190,373
4884278,1762,675528,dpv2,completed,307.0,7.2,166,141,0,48,259,307,23,14,270,307,32,0,275,307,66,0,241,307,47,54,206,307
4884278,1762,675528,new-0.0,completed,305.0,7.0,148,157,27,61,217,305,40,11,254,305,57,0,248,305,0,39,266,305,30,1,274,305
4884278,1762,675528,new-0.5,completed,318.0,7.2,138,180,0,22,296,318,26,31,261,318,41,63,214,318,36,23,259,318,58,0,260,318
4884278,1762,675528,new-1.0,completed,323.0,7.3,101,222,42,29,252,323,66,18,239,323,0,53,270,323,13,85,225,323,9,31,283,323
4884278,1762,380692,base,completed,366.0,7.1,113,253,50,19,297,366,50,179,137,366,74,58,234,366,21,94,251,366,0,0,366,366
4884278,1762,380692,base+,completed,303.0,6.8,93,210,9,79,215,303,8,3,292,303,58,47,198,303,0,6,297,303,38,19,246,303
4884278,1762,380692,dpv1,completed,323.0,7.3,106,217,51,19,253,323,20,0,303,323,58,1,264,323,32,66,225,323,0,96,227,323
4884278,1762,380692,dpv2,completed,318.0,7.45,130,188,0,48,270,318,19,0,299,318,3,0,315,318,39,97,182,318,54,71,193,318
4884278,1762,380692,new-0.0,completed,293.0,7.05,168,125,26,0,267,293,26,47,220,293,0,20,273,293,43,0,250,293,58,0,235,293
4884278,1762,380692,new-0.5,completed,323.0,7.3,129,194,0,37,286,323,34,15,274,323,62,53,208,323,41,34,248,323,45,18,260,323
4884278,1762,380692,new-1.0,completed,321.0,7.15,153,168,44,53,224,321,68,6,247,321,0,22,299,321,54,30,237,321,40,5,276,321
6993441,1505,310811,base,completed,241.0,6.85,179,62,27,14,200,241,0,15,226,241,11,0,230,241,49,0,192,241,6,0,235,241
6993441,1505,310811,base+,completed,257.0,7.15,190,67,0,0,257,257,31,6,220,257,67,0,190,257,44,0,213,257,1,25,231,257
6993441,1505,310811,dpv1,completed,250.0,7.25,185,65,62,0,188,250,33,0,217,250,32,0,218,250,0,28,222,250,15,0,235,250
6993441,1505,310811,dpv2,completed,254.0,7.55,176,78,34,0,220,254,52,0,202,254,0,39,215,254,37,0,217,254,52,0,202,254
6993441,1505,310811,new-0.0,completed,235.0,7.15,192,43,0,0,235,235,36,0,199,235,27,0,208,235,43,0,192,235,13,0,222,235
6993441,1505,310811,new-0.5,completed,243.0,7.65,194,49,49,0,194,243,33,0,210,243,41,0,202,243,21,0,222,243,0,8,235,243
6993441,1505,310811,new-1.0,completed,244.0,7.55,192,52,0,11,233,244,28,0,216,244,41,0,203,244,35,0,209,244,26,0,218,244
6993441,1505,208428,base,completed,257.0,7.0,192,65,27,1,229,257,65,0,192,257,1,28,228,257,64,0,193,257,0,0,257,257
6993441,1505,208428,base+,completed,277.0,7.0,188,89,74,0,203,277,0,0,277,277,31,35,211,277,6,38,233,277,78,0,199,277
6993441,1505,208428,dpv1,completed,244.0,7.35,187,57,41,0,203,244,26,0,218,244,0,30,214,244,23,0,221,244,15,0,229,244
6993441,1505,208428,dpv2,completed,249.0,7.45,159,90,0,0,249,249,31,0,218,249,2,62,185,249,24,0,225,249,57,0,192,249
6993441,1505,208428,new-0.0,completed,238.0,7.1,191,47,19,0,219,238,42,0,196,238,22,0,216,238,0,21,217,238,42,0,196,238
6993441,1505,208428,new-0.5,completed,240.0,7.5,199,41,0,0,240,240,24,0,216,240,36,0,204,240,34,5,201,240,16,0,224,240
6993441,1505,208428,new-1.0,completed,239.0,7.45,194,45,21,0,218,239,0,0,239,239,26,0,213,239,45,0,194,239,45,0,194,239
6993441,1505,460300,base,completed,264.0,6.85,182,82,33,0,231,264,0,48,216,264,68,0,196,264,29,0,235,264,72,0,192,264
6993441,1505,460300,base+,completed,232.0,7.05,205,27,22,0,210,232,0,0,232,232,22,0,210,232,27,0,205,232,1,0,231,232
6993441,1505,460300,dpv1,completed,246.0,7.35,173,73,47,0,199,246,33,0,213,246,21,0,225,246,0,33,213,246,13,0,233,246
6993441,1505,460300,dpv2,completed,252.0,7.4,176,76,0,43,209,252,37,0,215,252,21,0,231,252,26,0,226,252,58,0,194,252
6993441,1505,460300,new-0.0,completed,239.0,7.2,197,42,6,0,233,239,32,0,207,239,0,0,239,239,29,0,210,239,42,0,197,239
6993441,1505,460300,new-0.5,completed,236.0,7.5,201,35,13,0,223,236,17,0,219,236,35,0,201,236,0,0,236,236,31,0,205,236
6993441,1505,460300,new-1.0,completed,235.0,7.45,206,29,0,4,231,235,25,0,210,235,19,0,216,235,24,0,211,235,17,0,218,235
6993441,1505,309704,base,completed,259.0,7.0,169,90,50,0,209,259,61,0,198,259,2,0,257,259,30,0,229,259,0,53,206,259
6993441,1505,309704,base+,completed,247.0,7.3,175,72,50,0,197,247,28,22,197,247,53,0,194,247,4,0,243,247,0,24,223,247
6993441,1505,309704,dpv1,completed,243.0,7.25,188,55,5,16,222,243,13,0,230,243,0,0,243,243,46,0,197,243,33,0,210,243
6993441,1505,309704,dpv2,completed,267.0,7.5,181,86,11,0,256,267,34,8,225,267,0,45,222,267,86,0,181,267,71,0,196,267
6993441,1505,309704,new-0.0,completed,236.0,7.25,195,41,0,0,236,236,21,0,215,236,41,0,195,236,41,0,195,236,28,0,208,236
6993441,1505,309704,new-0.5,completed,247.0,7.5,183,64,0,22,225,247,23,0,224,247,39,0,208,247,56,4,187,247,32,0,215,247
6993441,1505,309704,new-1.0,completed,244.0,7.55,197,47,38,0,206,244,0,0,244,244,47,0,197,244,46,0,198,244,27,0,217,244
6993441,1505,247588,base,completed,234.0,7.15,169,65,2,28,204,234,30,2,202,234,0,0,234,234,2,0,232,234,47,0,187,234
6993441,1505,247588,base+,completed,237.0,7.0,187,50,45,0,192,237,0,20,217,237,16,0,221,237,22,0,215,237,20,0,217,237
6993441,1505,247588,dpv1,completed,235.0,7.4,180,55,40,0,195,235,1,0,234,235,0,27,208,235,22,0,213,235,26,0,209,235
6993441,1505,247588,dpv2,completed,248.0,7.45,170,78,57,0,191,248,50,0,198,248,0,48,200,248,23,0,225,248,14,0,234,248
6993441,1505,247588,new-0.0,completed,252.0,7.2,188,64,61,3,188,252,52,0,200,252,22,0,230,252,37,0,215,252,0,24,228,252
6993441,1505,247588,new-0.5,completed,236.0,7.55,187,49,20,0,216,236,20,0,216,236,0,21,215,236,49,0,187,236,43,0,193,236
6993441,1505,247588,new-1.0,completed,242.0,7.55,187,55,45,10,187,242,30,0,212,242,43,0,199,242,0,0,242,242,31,0,211,242
6993441,1505,203195,base,completed,256.0,6.8,158,98,0,66,190,256,44,0,212,256,29,0,227,256,22,0,234,256,35,0,221,256
6993441,1505,203195,base+,completed,248.0,7.0,179,69,32,0,216,248,8,0,240,248,0,32,216,248,48,0,200,248,7,0,241,248
6993441,1505,203195,dpv1,completed,241.0,7.4,160,81,38,0,203,241,4,0,237,241,0,51,190,241,23,0,218,241,15,0,226,241
6993441,1505,203195,dpv2,completed,254.0,7.35,162,92,36,0,218,254,51,0,203,254,19,0,235,254,28,0,226,254,0,59,195,254
6993441,1505,203195,new-0.0,completed,241.0,7.2,184,57,20,0,221,241,20,0,221,241,0,0,241,241,57,0,184,241,48,0,193,241
6993441,1505,203195,new-0.5,completed,235.0,7.6,201,34,0,0,235,235,32,2,201,235,32,0,203,235,5,0,230,235,31,0,204,235
6993441,1505,203195,new-1.0,completed,246.0,7.55,205,41,30,0,216,246,33,1,212,246,39,0,207,246,0,0,246,246,40,0,206,246
6993441,1505,178029,base,completed,249.0,6.8,191,58,52,0,197,249,3,31,215,249,0,0,249,249,20,0,229,249,53,0,196,249
6993441,1505,178029,base+,completed,238.0,7.0,180,58,31,2,205,238,33,0,205,238,20,0,218,238,0,25,213,238,2,0,236,238
6993441,1505,178029,dpv1,completed,267.0,7.35,179,88,33,0,234,267,53,0,214,267,27,0,240,267,60,0,207,267,0,50,217,267
6993441,1505,178029,dpv2,completed,239.0,7.35,187,52,52,0,187,239,21,0,218,239,20,0,219,239,0,21,218,239,23,0,216,239
6993441,1505,178029,new-0.0,completed,233.0,7.15,193,40,37,0,196,233,40,0,193,233,4,0,229,233,0,0,233,233,19,0,214,233
6993441,1505,178029,new-0.5,completed,234.0,7.5,191,43,27,0,207,234,13,0,221,234,0,4,230,234,23,0,211,234,43,0,191,234
6993441,1505,178029,new-1.0,completed,255.0,7.55,180,75,50,0,205,255,35,0,220,255,48,0,207,255,0,0,255,255,18,25,212,255
6993441,1505,239735,base,completed,264.0,7.3,179,85,28,0,236,264,64,0,200,264,0,50,214,264,28,0,236,264,70,0,194,264
6993441,1505,239735,base+,completed,230.0,7.05,200,30,27,0,203,230,25,0,205,230,29,0,201,230,2,1,227,230,0,0,230,230
6993441,1505,239735,dpv1,completed,238.0,7.4,164,74,35,0,203,238,19,0,219,238,2,0,236,238,29,0,209,238,0,41,197,238
6993441,1505,239735,dpv2,completed,238.0,7.35,163,75,21,10,207,238,47,0,191,238,0,48,190,238,24,0,214,238,7,0,231,238
6993441,1505,239735,new-0.0,completed,229.0,7.15,186,43,43,0,186,229,24,0,205,229,34,0,195,229,0,0,229,229,3,5,221,229
6993441,1505,239735,new-0.5,completed,224.0,7.55,193,31,0,0,224,224,31,0,193,224,14,0,210,224,23,0,201,224,16,0,208,224
6993441,1505,239735,new-1.0,completed,247.0,7.5,191,56,54,0,193,247,56,0,191,247,31,0,216,247,0,0,247,247,41,0,206,247
6993441,1505,675528,base,completed,247.0,7.05,178,69,6,0,241,247,42,0,205,247,54,0,193,247,25,9,213,247,0,36,211,247
6993441,1505,675528,base+,completed,263.0,7.05,192,71,4,0,259,263,28,4,231,263,0,37,226,263,57,0,206,263,53,0,210,263
6993441,1505,675528,dpv1,completed,246.0,7.35,177,69,46,0,200,246,0,0,246,246,6,0,240,246,30,24,192,246,2,18,226,246
6993441,1505,675528,dpv2,completed,254.0,7.45,172,82,32,0,222,254,50,0,204,254,18,0,236,254,65,0,189,254,0,45,209,254
6993441,1505,675528,new-0.0,completed,236.0,7.15,196,40,0,0,236,236,16,0,220,236,37,0,199,236,9,0,227,236,40,0,196,236
6993441,1505,675528,new-0.5,completed,227.0,7.5,188,39,26,0,201,227,7,0,220,227,39,0,188,227,25,0,202,227,0,2,225,227
6993441,1505,675528,new-1.0,completed,245.0,7.55,199,46,0,0,245,245,30,0,215,245,40,0,205,245,32,6,207,245,17,0,228,245
6993441,1505,380692,base,completed,254.0,7.05,185,69,23,0,231,254,0,40,214,254,6,0,248,254,48,0,206,254,63,0,191,254
6993441,1505,380692,base+,completed,266.0,7.2,160,106,75,0,191,266,27,27,212,266,44,0,222,266,8,0,258,266,0,73,193,266
6993441,1505,380692,dpv1,completed,237.0,7.3,178,59,0,20,217,237,8,0,229,237,8,0,229,237,27,9,201,237,40,0,197,237
6993441,1505,380692,dpv2,completed,250.0,7.45,175,75,1,0,249,250,55,0,195,250,0,45,205,250,26,5,219,250,61,0,189,250
6993441,1505,380692,new-0.0,completed,227.0,7.1,194,33,12,0,215,227,30,0,197,227,33,0,194,227,0,0,227,227,8,0,219,227
6993441,1505,380692,new-0.5,completed,237.0,7.65,194,43,43,0,194,237,25,0,212,237,33,0,204,237,18,0,219,237,0,7,230,237
6993441,1505,380692,new-1.0,completed,247.0,7.55,198,49,0,13,234,247,25,0,222,247,42,0,205,247,29,0,218,247,48,0,199,247
9150215,1719,310811,base,completed,324.0,7.2,150,174,43,83,198,324,60,0,264,324,91,0,233,324,0,5,319,324,90,0,234,324
9150215,1719,310811,base+,completed,304.0,7.15,169,135,46,0,258,304,62,0,242,304,97,0,207,304,0,18,286,304,40,38,226,304
9150215,1719,310811,dpv1,completed,292.0,7.35,199,93,75,18,199,292,59,0,233,292,46,0,246,292,32,0,260,292,0,0,292,292
9150215,1719,310811,dpv2,completed,300.0,7.45,166,134,68,0,232,300,0,94,206,300,40,0,260,300,20,0,280,300,69,0,231,300
9150215,1719,310811,new-0.0,completed,270.0,7.5,215,55,21,7,242,270,0,0,270,270,48,0,222,270,29,0,241,270,45,0,225,270
9150215,1719,310811,new-0.5,completed,289.0,8.0,202,87,38,0,251,289,87,0,202,289,0,0,289,289,47,0,242,289,66,0,223,289
9150215,1719,310811,new-1.0,completed,293.0,8.05,205,88,43,6,244,293,6,0,287,293,0,0,293,293,82,0,211,293,74,0,219,293
9150215,1719,208428,base,completed,318.0,6.95,218,100,0,58,260,318,98,0,220,318,42,0,276,318,58,0,260,318,91,0,227,318
9150215,1719,208428,base+,completed,312.0,7.45,189,123,61,6,245,312,63,0,249,312,91,26,195,312,47,0,265,312,0,16,296,312
9150215,1719,208428,dpv1,completed,304.0,7.25,222,82,44,0,260,304,76,0,228,304,82,0,222,304,65,0,239,304,0,0,304,304
9150215,1719,208428,dpv2,completed,308.0,7.5,157,151,66,0,242,308,0,0,308,308,34,68,206,308,72,0,236,308,60,11,237,308
9150215,1719,208428,new-0.0,completed,305.0,7.35,222,83,0,1,304,305,65,0,240,305,68,0,237,305,69,0,236,305,82,0,223,305
9150215,1719,208428,new-0.5,completed,268.0,8.0,212,56,11,0,257,268,56,0,212,268,0,0,268,268,2,0,266,268,45,0,223,268
9150215,1719,208428,new-1.0,completed,288.0,8.0,213,75,42,0,246,288,16,0,272,288,75,0,213,288,0,0,288,288,62,0,226,288
9150215,1719,460300,base,completed,281.0,7.05,214,67,39,10,232,281,2,0,279,281,45,11,225,281,29,0,252,281,0,1,280,281
9150215,1719,460300,base+,completed,279.0,7.15,213,66,38,0,241,279,66,0,213,279,0,1,278,279,10,0,269,279,42,0,237,279
9150215,1719,460300,dpv1,completed,303.0,7.5,216,87,45,0,258,303,84,0,219,303,0,0,303,303,58,0,245,303,87,0,216,303
9150215,1719,460300,dpv2,completed,307.0,7.55,173,134,65,0,242,307,38,0,269,307,0,96,211,307,28,0,279,307,75,0,232,307
9150215,1719,460300,new-0.0,completed,293.0,7.35,225,68,0,2,291,293,63,0,230,293,66,0,227,293,64,0,229,293,64,0,229,293
9150215,1719,460300,new-0.5,completed,271.0,8.05,214,57,13,0,258,271,57,0,214,271,0,0,271,271,31,0,240,271,19,0,252,271
9150215,1719,460300,new-1.0,completed,298.0,8.05,172,126,0,39,259,298,60,0,238,298,30,6,262,298,22,19,257,298,68,0,230,298
9150215,1719,309704,base,completed,324.0,7.15,176,148,0,34,290,324,92,0,232,324,55,0,269,324,78,0,246,324,43,56,225,324
9150215,1719,309704,base+,completed,275.0,7.25,210,65,65,0,210,275,3,0,272,275,9,0,266,275,0,17,258,275,45,0,230,275
9150215,1719,309704,dpv1,completed,297.0,7.5,219,78,0,0,297,297,78,0,219,297,76,0,221,297,12,0,285,297,78,0,219,297
9150215,1719,309704,dpv2,completed,317.0,7.35,173,144,104,0,213,317,0,102,215,317,42,0,275,317,79,0,238,317,31,0,286,317
9150215,1719,309704,new-0.0,completed,283.0,7.3,223,60,0,0,283,283,58,0,225,283,40,0,243,283,54,0,229,283,60,0,223,283
9150215,1719,309704,new-0.5,completed,291.0,8.05,219,72,36,0,255,291,72,0,219,291,0,0,291,291,62,0,229,291,30,0,261,291
9150215,1719,309704,new-1.0,completed,283.0,8.05,197,86,30,7,246,283,79,0,204,283,0,0,283,283,2,0,281,283,52,0,231,283
9150215,1719,247588,base,completed,394.0,6.9,147,247,94,0,300,394,0,174,220,394,37,69,288,394,58,160,176,394,126,0,268,394
9150215,1719,247588,base+,completed,311.0,7.15,151,160,0,98,213,311,26,18,267,311,88,0,223,311,44,0,267,311,58,0,253,311
9150215,1719,247588,dpv1,completed,284.0,7.45,200,84,25,0,259,284,0,8,276,284,57,0,227,284,45,0,239,284,76,0,208,284
9150215,1719,247588,dpv2,completed,299.0,7.55,168,131,16,0,283,299,0,94,205,299,87,0,212,299,67,0,232,299,37,0,262,299
9150215,1719,247588,new-0.0,completed,286.0,7.3,215,71,60,0,226,286,45,0,241,286,0,1,285,286,61,0,225,286,57,9,220,286
9150215,1719,247588,new-0.5,completed,269.0,8.05,223,46,39,0,230,269,46,0,223,269,0,0,269,269,38,0,231,269,23,0,246,269
9150215,1719,247588,new-1.0,completed,276.0,8.05,203,73,27,12,237,276,55,0,221,276,13,0,263,276,0,0,276,276,61,0,215,276
9150215,1719,203195,base,completed,313.0,7.0,217,96,90,0,223,313,64,0,249,313,65,0,248,313,45,6,262,313,0,15,298,313
9150215,1719,203195,base+,completed,302.0,7.2,222,80,68,0,234,302,59,0,243,302,19,0,283,302,52,12,238,302,0,0,302,302
9150215,1719,203195,dpv1,completed,298.0,7.5,222,76,0,0,298,298,54,0,244,298,76,0,222,298,31,0,267,298,76,0,222,298
9150215,1719,203195,dpv2,completed,293.0,7.4,205,88,43,0,250,293,38,0,255,293,0,50,243,293,41,0,252,293,64,0,229,293
9150215,1719,203195,new-0.0,completed,295.0,7.4,202,93,54,3,238,295,27,0,268,295,90,0,205,295,0,0,295,295,88,0,207,295
9150215,1719,203195,new-0.5,completed,279.0,8.05,209,70,8,0,271,279,70,0,209,279,0,0,279,279,54,0,225,279,31,0,248,279
9150215,1719,203195,new-1.0,completed,289.0,8.05,175,114,0,37,252,289,62,0,227,289,20,5,264,289,10,13,266,289,64,0,225,289
9150215,1719,178029,base,completed,303.0,7.1,169,134,42,13,248,303,77,12,214,303,65,57,181,303,0,4,299,303,50,0,253,303
9150215,1719,178029,base+,completed,305.0,7.2,205,100,0,56,249,305,53,0,252,305,36,0,269,305,44,0,261,305,69,0,236,305
9150215,1719,178029,dpv1,completed,287.0,7.35,212,75,0,0,287,287,75,0,212,287,26,0,261,287,71,0,216,287,29,0,258,287
9150215,1719,178029,dpv2,completed,305.0,7.35,165,140,79,0,226,305,0,97,208,305,10,8,287,305,35,0,270,305,62,0,243,305
9150215,1719,178029,new-0.0,completed,266.0,7.5,226,40,16,0,250,266,0,3,263,266,18,0,248,266,40,0,226,266,37,0,229,266
9150215,1719,178029,new-0.5,completed,292.0,7.65,198,94,0,10,282,292,94,0,198,292,42,0,250,292,31,0,261,292,66,0,226,292
9150215,1719,178029,new-1.0,completed,286.0,8.05,201,85,16,14,256,286,66,0,220,286,13,0,273,286,0,0,286,286,71,0,215,286
9150215,1719,239735,base,completed,293.0,6.85,212,81,81,0,212,293,35,0,258,293,49,0,244,293,71,0,222,293,0,0,293,293
9150215,1719,239735,base+,completed,269.0,7.05,227,42,0,0,269,269,42,0,227,269,40,0,229,269,13,0,256,269,39,0,230,269
9150215,1719,239735,dpv1,completed,275.0,7.55,196,79,58,0,217,275,7,0,268,275,22,0,253,275,79,0,196,275,0,0,275,275
9150215,1719,239735,dpv2,completed,287.0,7.5,161,126,0,0,287,287,58,0,229,287,8,60,219,287,45,0,242,287,43,23,221,287
9150215,1719,239735,new-0.0,completed,259.0,7.5,214,45,22,0,237,259,0,0,259,259,21,0,238,259,45,0,214,259,37,0,222,259
9150215,1719,239735,new-0.5,completed,280.0,8.05,213,67,29,0,251,280,67,0,213,280,0,0,280,280,47,0,233,280,43,0,237,280
9150215,1719,239735,new-1.0,completed,272.0,8.05,195,77,22,12,238,272,65,0,207,272,7,0,265,272,0,0,272,272,53,0,219,272
9150215,1719,675528,base,completed,294.0,7.35,173,121,40,26,228,294,0,13,281,294,29,0,265,294,95,0,199,294,61,0,233,294
9150215,1719,675528,base+,completed,300.0,7.05,186,114,89,0,211,300,0,18,282,300,38,0,262,300,37,25,238,300,46,0,254,300
9150215,1719,675528,dpv1,completed,296.0,7.3,230,66,66,0,230,296,41,0,255,296,59,0,237,296,45,0,251,296,0,0,296,296
9150215,1719,675528,dpv2,completed,311.0,7.5,163,148,71,0,240,311,0,0,311,311,38,59,214,311,67,0,244,311,67,18,226,311
9150215,1719,675528,new-0.0,completed,262.0,7.45,217,45,0,0,262,262,26,0,236,262,0,7,255,262,41,0,221,262,38,0,224,262
9150215,1719,675528,new-0.5,completed,272.0,8.05,220,52,4,0,268,272,52,0,220,272,0,0,272,272,45,0,227,272,20,0,252,272
9150215,1719,675528,new-1.0,completed,295.0,8.05,174,121,0,39,256,295,57,0,238,295,25,5,265,295,4,16,275,295,66,0,229,295
9150215,1719,380692,base,completed,282.0,7.05,197,85,8,0,274,282,33,3,246,282,43,7,232,282,0,29,253,282,75,0,207,282
9150215,1719,380692,base+,completed,296.0,7.3,192,104,38,0,258,296,65,0,231,296,63,0,233,296,26,0,270,296,0,66,230,296
9150215,1719,380692,dpv1,completed,294.0,7.4,198,96,29,0,265,294,67,0,227,294,80,16,198,294,45,0,249,294,0,0,294,294
9150215,1719,380692,dpv2,completed,322.0,7.35,178,144,87,0,235,322,0,104,218,322,47,0,275,322,40,0,282,322,91,0,231,322
9150215,1719,380692,new-0.0,completed,296.0,7.35,213,83,0,0,296,296,80,0,216,296,75,3,218,296,60,0,236,296,71,0,225,296
9150215,1719,380692,new-0.5,completed,294.0,8.0,210,84,42,0,252,294,84,0,210,294,0,0,294,294,21,0,273,294,78,0,216,294
9150215,1719,380692,new-1.0,completed,289.0,8.05,191,98,0,33,256,289,63,0,226,289,24,0,265,289,3,0,286,289,65,0,224,289
3008249,1770,310811,base,completed,302.0,6.8,236,66,57,0,245,302,0,5,297,302,30,0,272,302,61,0,241,302,39,10,253,302
3008249,1770,310811,base+,completed,302.0,6.75,184,118,36,43,223,302,0,0,302,302,12,0,290,302,19,48,235,302,50,0,252,302
3008249,1770,310811,dpv1,completed,293.0,7.05,199,94,43,37,213,293,37,0,256,293,33,14,246,293,0,0,293,293,42,0,251,293
3008249,1770,310811,dpv2,completed,288.0,7.2,226,62,0,0,288,288,62,0,226,288,57,0,231,288,31,0,257,288,44,9,235,288
3008249,1770,310811,new-0.0,completed,281.0,6.9,238,43,39,4,238,281,37,0,244,281,0,0,281,281,29,0,252,281,39,0,242,281
3008249,1770,310811,new-0.5,completed,278.0,7.1,222,56,0,0,278,278,14,0,264,278,29,0,249,278,56,0,222,278,41,0,237,278
3008249,1770,310811,new-1.0,completed,273.0,7.4,214,59,9,0,264,273,54,0,219,273,0,5,268,273,0,0,273,273,29,0,244,273
3008249,1770,208428,base,completed,274.0,6.7,217,57,7,0,267,274,9,0,265,274,57,0,217,274,34,0,240,274,0,0,274,274
3008249,1770,208428,base+,completed,299.0,6.9,204,95,48,28,223,299,67,0,232,299,16,36,247,299,0,0,299,299,14,0,285,299
3008249,1770,208428,dpv1,completed,308.0,6.95,237,71,64,0,244,308,58,0,250,308,64,0,244,308,0,0,308,308,70,1,237,308
3008249,1770,208428,dpv2,completed,296.0,7.15,234,62,0,0,296,296,28,0,268,296,46,0,250,296,60,0,236,296,43,13,240,296
3008249,1770,208428,new-0.0,completed,279.0,6.9,223,56,52,0,227,279,39,0,240,279,0,3,276,279,25,0,254,279,53,0,226,279
3008249,1770,208428,new-0.5,completed,287.0,7.4,240,47,29,0,258,287,41,0,246,287,19,0,268,287,47,0,240,287,0,0,287,287
3008249,1770,208428,new-1.0,completed,286.0,7.4,228,58,53,2,231,286,0,0,286,286,24,0,262,286,19,3,264,286,31,0,255,286
3008249,1770,460300,base,completed,283.0,6.95,219,64,22,31,230,283,0,0,283,283,34,0,249,283,21,0,262,283,14,0,269,283
3008249,1770,460300,base+,completed,286.0,6.8,220,66,0,0,286,286,52,0,234,286,24,14,248,286,28,0,258,286,20,0,266,286
3008249,1770,460300,dpv1,completed,295.0,6.95,235,60,34,0,261,295,57,0,238,295,60,0,235,295,32,0,263,295,0,0,295,295
3008249,1770,460300,dpv2,completed,297.0,7.15,232,65,57,0,240,297,28,0,269,297,58,0,239,297,0,0,297,297,34,20,243,297
3008249,1770,460300,new-0.0,completed,289.0,6.85,209,80,0,0,289,289,25,0,264,289,68,8,213,289,36,0,253,289,72,0,217,289
3008249,1770,460300,new-0.5,completed,287.0,7.2,217,70,58,0,229,287,0,0,287,287,11,0,276,287,63,7,217,287,22,0,265,287
3008249,1770,460300,new-1.0,completed,287.0,7.4,227,60,44,0,243,287,4,0,283,287,57,0,230,287,16,0,271,287,0,3,284,287
3008249,1770,309704,base,completed,316.0,6.85,157,159,12,33,271,316,20,76,220,316,0,0,316,316,50,23,243,316,28,91,197,316
3008249,1770,309704,base+,completed,290.0,6.95,191,99,40,3,247,290,33,37,220,290,0,0,290,290,15,0,275,290,35,48,207,290
3008249,1770,309704,dpv1,completed,304.0,7.15,181,123,63,43,198,304,0,0,304,304,45,0,259,304,24,17,263,304,31,0,273,304
3008249,1770,309704,dpv2,completed,289.0,7.1,226,63,55,1,233,289,36,0,253,289,0,0,289,289,28,0,261,289,62,0,227,289
3008249,1770,309704,new-0.0,completed,274.0,6.9,225,49,42,0,232,274,43,0,231,274,0,0,274,274,11,0,263,274,49,0,225,274
3008249,1770,309704,new-0.5,completed,275.0,7.3,236,39,8,0,267,275,39,0,236,275,0,0,275,275,32,0,243,275,23,0,252,275
3008249,1770,309704,new-1.0,completed,281.0,7.35,220,61,21,5,255,281,3,0,278,281,56,0,225,281,0,0,281,281,9,0,272,281
3008249,1770,247588,base,completed,283.0,6.85,195,88,8,0,275,283,43,0,240,283,0,6,277,283,48,0,235,283,17,40,226,283
3008249,1770,247588,base+,completed,282.0,6.95,224,58,58,0,224,282,33,0,249,282,0,0,282,282,37,8,237,282,43,0,239,282
3008249,1770,247588,dpv1,completed,294.0,6.95,230,64,42,12,240,294,0,0,294,294,63,0,231,294,57,0,237,294,36,0,258,294
3008249,1770,247588,dpv2,completed,289.0,7.1,228,61,46,0,243,289,38,0,251,289,61,0,228,289,35,0,254,289,0,0,289,289
3008249,1770,247588,new-0.0,completed,279.0,6.9,213,66,36,6,237,279,57,3,219,279,0,0,279,279,39,0,240,279,41,0,238,279
3008249,1770,247588,new-0.5,completed,272.0,7.25,214,58,0,0,272,272,7,0,265,272,46,9,217,272,49,0,223,272,37,0,235,272
3008249,1770,247588,new-1.0,completed,272.0,7.4,208,64,34,5,233,272,9,0,263,272,59,0,213,272,14,0,258,272,0,0,272,272
3008249,1770,203195,base,completed,275.0,6.9,228,47,11,0,264,275,47,0,228,275,21,0,254,275,0,0,275,275,13,0,262,275
3008249,1770,203195,base+,completed,292.0,7.0,235,57,55,0,237,292,54,0,238,292,15,0,277,292,0,0,292,292,21,26,245,292
3008249,1770,203195,dpv1,completed,282.0,7.05,184,98,29,39,214,282,5,30,247,282,25,0,257,282,13,0,269,282,0,0,282,282
3008249,1770,203195,dpv2,completed,296.0,7.25,224,72,0,0,296,296,20,0,276,296,63,0,233,296,58,0,238,296,30,31,235,296
3008249,1770,203195,new-0.0,completed,290.0,6.9,224,66,36,0,254,290,48,0,242,290,0,2,288,290,60,0,230,290,64,0,226,290
3008249,1770,203195,new-0.5,completed,273.0,7.25,226,47,3,0,270,273,28,0,245,273,0,0,273,273,47,0,226,273,19,0,254,273
3008249,1770,203195,new-1.0,completed,282.0,7.4,212,70,4,0,278,282,67,0,215,282,0,3,279,282,19,0,263,282,28,0,254,282
3008249,1770,178029,base,completed,283.0,6.85,204,79,0,0,283,283,25,36,222,283,8,16,259,283,41,0,242,283,20,15,248,283
3008249,1770,178029,base+,completed,300.0,6.85,222,78,54,0,246,300,0,0,300,300,24,42,234,300,56,3,241,300,23,0,277,300
3008249,1770,178029,dpv1,completed,300.0,7.1,168,132,48,47,205,300,10,0,290,300,53,0,247,300,0,0,300,300,26,32,242,300
3008249,1770,178029,dpv2,completed,303.0,7.15,217,86,0,0,303,303,32,0,271,303,60,0,243,303,46,33,224,303,67,0,236,303
3008249,1770,178029,new-0.0,completed,289.0,6.9,224,65,58,0,231,289,42,0,247,289,0,0,289,289,31,0,258,289,65,0,224,289
3008249,1770,178029,new-0.5,completed,271.0,7.35,227,44,13,0,258,271,37,2,232,271,11,0,260,271,42,0,229,271,0,0,271,271
3008249,1770,178029,new-1.0,completed,284.0,7.4,223,61,12,3,269,284,58,0,226,284,0,0,284,284,30,0,254,284,20,0,264,284
3008249,1770,239735,base,completed,286.0,6.8,228,58,40,0,246,286,36,0,250,286,37,18,231,286,17,0,269,286,0,0,286,286
3008249,1770,239735,base+,completed,293.0,7.0,225,68,0,0,293,293,61,2,230,293,58,0,235,293,66,0,227,293,44,0,249,293
3008249,1770,239735,dpv1,completed,274.0,7.2,224,50,41,0,233,274,0,0,274,274,34,0,240,274,8,0,266,274,19,26,229,274
3008249,1770,239735,dpv2,completed,285.0,7.3,222,63,56,0,229,285,19,0,266,285,55,0,230,285,0,0,285,285,34,23,228,285
3008249,1770,239735,new-0.0,completed,266.0,6.9,208,58,42,0,224,266,28,0,238,266,0,0,266,266,18,0,248,266,58,0,208,266
3008249,1770,239735,new-0.5,completed,271.0,7.3,216,55,5,0,266,271,42,0,229,271,0,2,269,271,53,0,218,271,25,0,246,271
3008249,1770,239735,new-1.0,completed,258.0,7.3,225,33,33,0,225,258,11,0,247,258,4,0,254,258,0,0,258,258,4,0,254,258
3008249,1770,675528,base,completed,275.0,6.85,195,80,6,0,269,275,26,0,249,275,0,2,273,275,40,29,206,275,2,19,254,275
3008249,1770,675528,base+,completed,302.0,7.0,181,121,0,0,302,302,28,27,247,302,44,0,258,302,31,70,201,302,41,0,261,302
3008249,1770,675528,dpv1,completed,301.0,7.15,184,117,45,45,211,301,22,0,279,301,25,27,249,301,0,0,301,301,34,0,267,301
3008249,1770,675528,dpv2,completed,286.0,7.1,224,62,39,0,247,286,31,0,255,286,62,0,224,286,16,0,270,286,0,0,286,286
3008249,1770,675528,new-0.0,completed,284.0,6.9,226,58,43,0,241,284,50,4,230,284,0,2,282,284,27,0,257,284,52,0,232,284
3008249,1770,675528,new-0.5,completed,294.0,7.15,235,59,0,0,294,294,36,0,258,294,36,0,258,294,58,0,236,294,59,0,235,294
3008249,1770,675528,new-1.0,completed,294.0,7.4,218,76,69,6,219,294,0,0,294,294,20,1,273,294,24,0,270,294,46,0,248,294
3008249,1770,380692,base,completed,286.0,6.85,222,64,0,0,286,286,33,0,253,286,32,31,223,286,30,0,256,286,28,0,258,286
3008249,1770,380692,base+,completed,279.0,6.85,227,52,52,0,227,279,35,0,244,279,20,0,259,279,0,0,279,279,52,0,227,279
3008249,1770,380692,dpv1,completed,297.0,7.1,214,83,33,0,264,297,33,0,264,297,45,16,236,297,58,0,239,297,0,25,272,297
3008249,1770,380692,dpv2,completed,277.0,7.15,224,53,39,0,238,277,5,0,272,277,0,0,277,277,53,0,224,277,9,19,249,277
3008249,1770,380692,new-0.0,completed,286.0,6.9,221,65,29,0,257,286,32,0,254,286,60,0,226,286,45,0,241,286,0,5,281,286
3008249,1770,380692,new-0.5,completed,267.0,7.35,224,43,13,0,254,267,30,0,237,267,15,0,252,267,43,0,224,267,0,0,267,267
3008249,1770,380692,new-1.0,completed,276.0,7.4,205,71,18,10,248,276,52,0,224,276,1,0,275,276,9,0,267,276,0,9,267,276
5929262,1587,310811,base,completed,260.0,6.9,198,62,62,0,198,260,0,0,260,260,9,0,251,260,37,0,223,260,53,0,207,260
5929262,1587,310811,base+,completed,265.0,7.05,201,64,57,0,208,265,64,0,201,265,27,0,238,265,5,2,258,265,0,0,265,265
5929262,1587,310811,dpv1,completed,261.0,7.45,209,52,42,0,219,261,40,0,221,261,0,10,251,261,29,0,232,261,22,0,239,261
5929262,1587,310811,dpv2,completed,251.0,7.35,173,78,22,21,208,251,15,2,234,251,0,0,251,251,18,0,233,251,55,0,196,251
5929262,1587,310811,new-0.0,completed,248.0,7.25,203,45,36,0,212,248,0,1,247,248,45,0,203,248,39,0,209,248,23,0,225,248
5929262,1587,310811,new-0.5,completed,259.0,7.35,188,71,58,6,195,259,0,0,259,259,65,0,194,259,15,0,244,259,34,0,225,259
5929262,1587,310811,new-1.0,completed,261.0,7.55,179,82,57,0,204,261,6,18,237,261,9,0,252,261,0,12,249,261,49,0,212,261
5929262,1587,208428,base,completed,263.0,6.95,198,65,0,24,239,263,40,0,223,263,41,0,222,263,4,0,259,263,17,0,246,263
5929262,1587,208428,base+,completed,257.0,7.1,203,54,0,1,256,257,4,0,253,257,9,0,248,257,54,0,203,257,42,0,215,257
5929262,1587,208428,dpv1,completed,271.0,7.35,190,81,56,0,215,271,61,0,210,271,24,20,227,271,39,0,232,271,0,0,271,271
5929262,1587,208428,dpv2,completed,264.0,7.2,175,89,35,26,203,264,0,0,264,264,63,0,201,264,6,0,258,264,23,0,241,264
5929262,1587,208428,new-0.0,completed,259.0,7.25,205,54,38,0,221,259,0,8,251,259,54,0,205,259,46,0,213,259,25,0,234,259
5929262,1587,208428,new-0.5,completed,273.0,7.4,196,77,54,0,219,273,51,0,222,273,77,0,196,273,59,0,214,273,0,0,273,273
5929262,1587,208428,new-1.0,completed,257.0,7.55,181,76,51,0,206,257,21,18,218,257,0,0,257,257,2,7,248,257,44,0,213,257
5929262,1587,460300,base,completed,264.0,7.0,154,110,65,0,199,264,10,0,254,264,0,0,264,264,11,45,208,264,7,0,257,264
5929262,1587,460300,base+,completed,270.0,7.05,209,61,51,0,219,270,0,0,270,270,54,0,216,270,6,10,254,270,32,0,238,270
5929262,1587,460300,dpv1,completed,266.0,7.35,217,49,35,0,231,266,32,0,234,266,0,0,266,266,22,0,244,266,49,0,217,266
5929262,1587,460300,dpv2,completed,267.0,7.5,176,91,51,12,204,267,14,0,253,267,42,14,211,267,65,0,202,267,0,0,267,267
5929262,1587,460300,new-0.0,completed,250.0,7.25,202,48,23,0,227,250,0,1,249,250,48,0,202,250,42,0,208,250,18,0,232,250
5929262,1587,460300,new-0.5,completed,251.0,7.6,204,47,3,6,242,251,15,0,236,251,0,0,251,251,41,0,210,251,22,2,227,251
5929262,1587,460300,new-1.0,completed,267.0,7.6,174,93,40,35,192,267,2,0,265,267,50,0,217,267,0,5,262,267,53,0,214,267
5929262,1587,309704,base,completed,263.0,6.9,208,55,45,0,218,263,20,0,243,263,55,0,208,263,41,0,222,263,0,0,263,263
5929262,1587,309704,base+,completed,254.0,6.9,193,61,0,0,254,254,61,0,193,254,29,0,225,254,20,0,234,254,16,0,238,254
5929262,1587,309704,dpv1,completed,252.0,7.35,204,48,48,0,204,252,22,0,230,252,0,0,252,252,34,0,218,252,23,0,229,252
5929262,1587,309704,dpv2,completed,261.0,7.3,179,82,39,10,212,261,0,0,261,261,18,0,243,261,72,0,189,261,22,0,239,261
5929262,1587,309704,new-0.0,completed,266.0,7.25,202,64,42,0,224,266,0,15,251,266,64,0,202,266,50,0,216,266,33,0,233,266
5929262,1587,309704,new-0.5,completed,261.0,7.45,197,64,5,8,248,261,52,0,209,261,0,0,261,261,47,4,210,261,26,0,235,261
5929262,1587,309704,new-1.0,completed,264.0,7.7,182,82,48,25,191,264,52,0,212,264,0,0,264,264,9,0,255,264,51,5,208,264
5929262,1587,247588,base,completed,285.0,6.65,204,81,64,0,221,285,0,0,285,285,47,0,238,285,69,0,216,285,81,0,204,285
5929262,1587,247588,base+,completed,248.0,7.0,191,57,20,2,226,248,19,0,229,248,0,0,248,248,55,0,193,248,12,0,236,248
5929262,1587,247588,dpv1,completed,247.0,7.2,206,41,28,0,219,247,0,0,247,247,41,0,206,247,17,0,230,247,7,0,240,247
5929262,1587,247588,dpv2,completed,251.0,7.65,173,78,38,0,213,251,12,0,239,251,0,18,233,251,58,20,173,251,21,0,230,251
5929262,1587,247588,new-0.0,completed,257.0,7.35,195,62,43,0,214,257,54,0,203,257,0,19,238,257,43,0,214,257,37,0,220,257
5929262,1587,247588,new-0.5,completed,254.0,7.55,193,61,0,0,254,254,30,0,224,254,20,3,231,254,42,0,212,254,58,0,196,254
5929262,1587,247588,new-1.0,completed,257.0,7.55,179,78,16,0,241,257,20,13,224,257,54,0,203,257,0,15,242,257,50,0,207,257
5929262,1587,203195,base,completed,253.0,7.2,183,70,23,8,222,253,0,0,253,253,5,0,248,253,62,0,191,253,32,0,221,253
5929262,1587,203195,base+,completed,266.0,7.0,208,58,8,0,258,266,0,0,266,266,58,0,208,266,30,0,236,266,58,0,208,266
5929262,1587,203195,dpv1,completed,248.0,7.2,195,53,24,0,224,248,0,0,248,248,12,0,236,248,53,0,195,248,14,0,234,248
5929262,1587,203195,dpv2,completed,255.0,7.4,180,75,25,23,207,255,0,0,255,255,52,0,203,255,0,0,255,255,40,0,215,255
5929262,1587,203195,new-0.0,completed,257.0,7.4,193,64,8,0,249,257,53,0,204,257,0,11,246,257,53,0,204,257,14,0,243,257
5929262,1587,203195,new-0.5,completed,258.0,7.35,208,50,48,0,210,258,31,0,227,258,0,0,258,258,50,0,208,258,37,0,221,258
5929262,1587,203195,new-1.0,completed,268.0,7.65,163,105,50,33,185,268,26,0,242,268,51,0,217,268,0,6,262,268,11,15,242,268
5929262,1587,178029,base,completed,242.0,6.95,192,50,0,0,242,242,4,0,238,242,7,0,235,242,50,0,192,242,19,0,223,242
5929262,1587,178029,base+,completed,264.0,7.2,194,70,47,0,217,264,0,0,264,264,21,0,243,264,26,0,238,264,70,0,194,264
5929262,1587,178029,dpv1,completed,257.0,7.25,207,50,46,0,211,257,37,0,220,257,19,0,238,257,13,0,244,257,0,9,248,257
5929262,1587,178029,dpv2,completed,262.0,7.3,176,86,40,9,213,262,14,0,248,262,56,0,206,262,0,0,262,262,41,21,200,262
5929262,1587,178029,new-0.0,completed,243.0,7.3,189,54,46,0,197,243,2,14,227,243,0,0,243,243,40,0,203,243,3,0,240,243
5929262,1587,178029,new-0.5,completed,269.0,7.45,196,73,41,1,227,269,0,0,269,269,49,0,220,269,71,0,198,269,56,1,212,269
5929262,1587,178029,new-1.0,completed,279.0,7.65,186,93,55,17,207,279,26,0,253,279,68,0,211,279,0,6,273,279,69,1,209,279
5929262,1587,239735,base,completed,268.0,7.15,202,66,66,0,202,268,33,0,235,268,40,0,228,268,0,0,268,268,61,0,207,268
5929262,1587,239735,base+,completed,248.0,6.9,181,67,0,0,248,248,23,0,225,248,21,0,227,248,67,0,181,248,14,0,234,248
5929262,1587,239735,dpv1,completed,253.0,7.35,189,64,49,0,204,253,40,0,213,253,0,22,231,253,19,0,234,253,17,0,236,253
5929262,1587,239735,dpv2,completed,241.0,7.5,174,67,27,15,199,241,0,0,241,241,3,0,238,241,52,0,189,241,33,0,208,241
5929262,1587,239735,new-0.0,completed,257.0,7.35,184,73,43,0,214,257,63,9,185,257,0,22,235,257,42,0,215,257,22,0,235,257
5929262,1587,239735,new-0.5,completed,240.0,7.5,201,39,17,4,219,240,0,0,240,240,20,0,220,240,35,0,205,240,16,0,224,240
5929262,1587,239735,new-1.0,completed,271.0,7.55,171,100,56,30,185,271,20,0,251,271,56,0,215,271,67,3,201,271,0,0,271,271
5929262,1587,675528,base,completed,259.0,7.1,194,65,18,0,241,259,25,0,234,259,0,0,259,259,65,0,194,259,39,0,220,259
5929262,1587,675528,base+,completed,267.0,7.1,201,66,60,0,207,267,66,0,201,267,37,0,230,267,21,0,246,267,0,0,267,267
5929262,1587,675528,dpv1,completed,261.0,7.15,214,47,47,0,214,261,43,0,218,261,35,0,226,261,0,0,261,261,22,0,239,261
5929262,1587,675528,dpv2,completed,252.0,7.5,189,63,15,0,237,252,0,0,252,252,63,0,189,252,5,0,247,252,32,0,220,252
5929262,1587,675528,new-0.0,completed,254.0,7.35,198,56,27,0,227,254,56,0,198,254,0,12,242,254,39,0,215,254,4,0,250,254
5929262,1587,675528,new-0.5,completed,253.0,7.5,194,59,23,0,230,253,29,0,224,253,0,0,253,253,57,0,196,253,36,2,215,253
5929262,1587,675528,new-1.0,completed,271.0,7.65,161,110,0,0,271,271,24,0,247,271,11,31,229,271,66,9,196,271,38,15,218,271
5929262,1587,380692,base,completed,261.0,7.3,200,61,26,0,235,261,13,1,247,261,54,0,207,261,0,0,261,261,61,0,200,261
5929262,1587,380692,base+,completed,246.0,6.8,198,48,3,0,243,246,48,0,198,246,31,0,215,246,1,0,245,246,0,0,246,246
5929262,1587,380692,dpv1,completed,268.0,7.3,215,53,26,0,242,268,53,0,215,268,0,0,268,268,49,0,219,268,52,0,216,268
5929262,1587,380692,dpv2,completed,260.0,7.45,186,74,46,9,205,260,65,0,195,260,0,0,260,260,24,0,236,260,18,0,242,260
5929262,1587,380692,new-0.0,completed,257.0,7.15,183,74,0,26,231,257,74,0,183,257,16,0,241,257,45,0,212,257,2,0,255,257
5929262,1587,380692,new-0.5,completed,236.0,7.6,197,39,4,0,232,236,8,0,228,236,11,0,225,236,39,0,197,236,0,0,236,236
5929262,1587,380692,new-1.0,completed,272.0,7.65,169,103,46,0,226,272,58,0,214,272,54,0,218,272,0,15,257,272,17,30,225,272
7309270,1844,310811,base,completed,341.0,7.3,176,165,41,0,300,341,0,53,288,341,40,56,245,341,66,43,232,341,54,15,272,341
7309270,1844,310811,base+,completed,328.0,7.15,203,125,0,21,307,328,75,0,253,328,52,29,247,328,59,2,267,328,8,36,284,328
7309270,1844,310811,dpv1,completed,329.0,7.15,163,166,76,0,253,329,52,22,255,329,61,0,268,329,10,28,291,329,0,68,261,329
7309270,1844,310811,dpv2,completed,332.0,7.2,168,164,63,0,269,332,70,60,202,332,0,0,332,332,65,0,267,332,24,44,264,332
7309270,1844,310811,new-0.0,completed,300.0,7.15,234,66,42,0,258,300,60,2,238,300,0,0,300,300,58,0,242,300,20,4,276,300
7309270,1844,310811,new-0.5,completed,306.0,7.55,215,91,55,0,251,306,0,0,306,306,73,13,220,306,60,5,241,306,18,0,288,306
7309270,1844,310811,new-1.0,completed,310.0,7.55,169,141,31,13,266,310,41,0,269,310,0,65,245,310,6,0,304,310,13,40,257,310
7309270,1844,208428,base,completed,330.0,7.0,190,140,45,0,285,330,44,20,266,330,68,0,262,330,0,0,330,330,56,69,205,330
7309270,1844,208428,base+,completed,376.0,7.05,162,214,44,0,332,376,85,0,291,376,0,84,292,376,44,78,254,376,87,75,214,376
7309270,1844,208428,dpv1,completed,340.0,7.3,140,200,58,54,228,340,5,20,315,340,46,51,243,340,43,15,282,340,0,47,293,340
7309270,1844,208428,dpv2,completed,322.0,7.5,185,137,54,28,240,322,39,14,269,322,6,30,286,322,0,40,282,322,66,6,250,322
7309270,1844,208428,new-0.0,completed,297.0,7.05,217,80,50,0,247,297,9,3,285,297,0,11,286,297,34,0,263,297,74,0,223,297
7309270,1844,208428,new-0.5,completed,300.0,7.55,225,75,49,0,251,300,75,0,225,300,0,0,300,300,42,0,258,300,0,0,300,300
7309270,1844,208428,new-1.0,completed,309.0,7.6,168,141,19,29,261,309,25,0,284,309,0,0,309,309,28,0,281,309,46,66,197,309
7309270,1844,460300,base,completed,352.0,6.9,190,162,48,83,221,352,2,11,339,352,71,13,268,352,0,89,263,352,58,0,294,352
7309270,1844,460300,base+,completed,316.0,6.95,252,64,13,15,288,316,48,0,268,316,0,0,316,316,49,0,267,316,48,0,268,316
7309270,1844,460300,dpv1,completed,347.0,7.1,156,191,77,59,211,347,53,37,257,347,0,30,317,347,15,33,299,347,61,15,271,347
7309270,1844,460300,dpv2,completed,333.0,7.4,182,151,63,21,249,333,77,0,256,333,0,27,306,333,1,39,293,333,54,44,235,333
7309270,1844,460300,new-0.0,completed,302.0,7.0,240,62,19,0,283,302,0,0,302,302,50,0,252,302,47,0,255,302,62,0,240,302
7309270,1844,460300,new-0.5,completed,304.0,7.55,229,75,49,0,255,304,72,0,232,304,3,0,301,304,48,3,253,304,0,2,302,304
7309270,1844,460300,new-1.0,completed,310.0,7.5,216,94,46,40,224,310,2,0,308,310,0,36,274,310,34,0,276,310,45,0,265,310
7309270,1844,309704,base,completed,352.0,6.95,158,194,40,73,239,352,0,92,260,352,59,0,293,352,54,7,291,352,79,0,273,352
7309270,1844,309704,base+,completed,306.0,6.65,216,90,53,0,253,306,56,11,239,306,11,22,273,306,41,4,261,306,0,0,306,306
7309270,1844,309704,dpv1,completed,348.0,7.1,116,232,0,0,348,348,52,52,244,348,74,115,159,348,11,32,305,348,58,20,270,348
7309270,1844,309704,dpv2,completed,312.0,7.55,199,113,0,35,277,312,47,8,257,312,8,25,279,312,61,0,251,312,41,0,271,312
7309270,1844,309704,new-0.0,completed,297.0,7.2,224,73,68,0,229,297,38,0,259,297,2,0,295,297,0,0,297,297,73,0,224,297
7309270,1844,309704,new-0.5,completed,316.0,7.55,203,113,57,27,232,316,80,0,236,316,68,5,243,316,25,0,291,316,0,6,310,316
7309270,1844,309704,new-1.0,completed,320.0,7.55,177,143,39,12,269,320,48,0,272,320,0,59,261,320,23,0,297,320,28,27,265,320
7309270,1844,247588,base,completed,301.0,6.75,204,97,57,24,220,301,40,16,245,301,1,0,300,301,0,0,301,301,46,0,255,301
7309270,1844,247588,base+,completed,360.0,7.1,189,171,50,18,292,360,47,78,235,360,75,0,285,360,0,77,283,360,104,35,221,360
7309270,1844,247588,dpv1,completed,337.0,7.4,140,197,73,41,223,337,15,26,296,337,0,0,337,337,56,8,273,337,57,97,183,337
7309270,1844,247588,dpv2,completed,295.0,7.3,176,119,35,0,260,295,1,33,261,295,0,40,255,295,50,0,245,295,27,0,268,295
7309270,1844,247588,new-0.0,completed,284.0,7.0,222,62,43,0,241,284,61,0,223,284,5,1,278,284,27,0,257,284,0,3,281,284
7309270,1844,247588,new-0.5,completed,299.0,7.5,225,74,70,0,229,299,0,9,290,299,69,0,230,299,18,0,281,299,51,4,244,299
7309270,1844,247588,new-1.0,completed,302.0,7.6,188,114,44,37,221,302,7,0,295,302,0,46,256,302,20,0,282,302,36,11,255,302
7309270,1844,203195,base,completed,313.0,7.25,185,128,0,32,281,313,57,0,256,313,35,4,274,313,13,47,253,313,30,23,260,313
7309270,1844,203195,base+,completed,308.0,6.75,204,104,65,15,228,308,0,39,269,308,10,0,298,308,36,0,272,308,29,0,279,308
7309270,1844,203195,dpv1,completed,342.0,6.95,116,226,0,0,342,342,65,123,154,342,49,48,245,342,8,18,316,342,50,15,277,342
7309270,1844,203195,dpv2,completed,313.0,7.4,165,148,38,23,252,313,38,0,275,313,0,44,269,313,2,23,288,313,51,28,234,313
7309270,1844,203195,new-0.0,completed,303.0,7.15,216,87,58,0,245,303,0,4,299,303,4,0,299,303,42,10,251,303,73,0,230,303
7309270,1844,203195,new-0.5,completed,299.0,7.45,223,76,46,9,244,299,67,0,232,299,0,1,298,299,39,0,260,299,15,0,284,299
7309270,1844,203195,new-1.0,completed,322.0,7.45,165,157,0,50,272,322,23,0,299,322,78,29,215,322,59,0,263,322,25,0,297,322
7309270,1844,178029,base,completed,339.0,7.05,162,177,40,37,262,339,43,20,276,339,20,33,286,339,0,93,246,339,66,28,245,339
7309270,1844,178029,base+,completed,329.0,7.05,156,173,8,33,288,329,24,19,286,329,0,34,295,329,41,63,225,329,63,38,228,329
7309270,1844,178029,dpv1,completed,341.0,7.35,138,203,0,0,341,341,15,32,294,341,53,44,244,341,64,2,275,341,79,85,177,341
7309270,1844,178029,dpv2,completed,320.0,7.35,170,150,43,25,252,320,11,12,297,320,51,0,269,320,56,69,195,320,0,5,315,320
7309270,1844,178029,new-0.0,completed,288.0,7.0,236,52,52,0,236,288,9,0,279,288,0,0,288,288,35,0,253,288,51,0,237,288
7309270,1844,178029,new-0.5,completed,293.0,7.6,238,55,16,4,273,293,32,0,261,293,51,0,242,293,47,0,246,293,0,0,293,293
7309270,1844,178029,new-1.0,completed,334.0,7.65,154,180,29,29,276,334,0,0,334,334,64,39,231,334,59,0,275,334,52,66,216,334
7309270,1844,239735,base,completed,312.0,7.0,206,106,42,25,245,312,50,0,262,312,63,33,216,312,53,0,259,312,0,0,312,312
7309270,1844,239735,base+,completed,315.0,6.9,189,126,42,46,227,315,66,0,249,315,25,0,290,315,0,0,315,315,26,57,232,315
7309270,1844,239735,dpv1,completed,314.0,7.25,151,163,0,0,314,314,9,15,290,314,46,9,259,314,36,5,273,314,50,86,178,314
7309270,1844,239735,dpv2,completed,307.0,7.35,196,111,21,42,244,307,24,0,283,307,55,0,252,307,75,0,232,307,0,0,307,307
7309270,1844,239735,new-0.0,completed,282.0,7.1,214,68,0,3,279,282,27,3,252,282,65,0,217,282,39,0,243,282,4,0,278,282
7309270,1844,239735,new-0.5,completed,278.0,7.5,229,49,40,0,238,278,0,0,278,278,49,0,229,278,25,0,253,278,6,0,272,278
7309270,1844,239735,new-1.0,completed,289.0,7.6,187,102,18,23,248,289,37,0,252,289,61,0,228,289,0,0,289,289,3,18,268,289
7309270,1844,675528,base,completed,307.0,6.8,226,81,44,18,245,307,0,5,302,307,62,0,245,307,5,1,301,307,66,0,241,307
7309270,1844,675528,base+,completed,332.0,7.25,158,174,39,55,238,332,1,41,290,332,0,35,297,332,55,9,268,332,58,35,239,332
7309270,1844,675528,dpv1,completed,313.0,7.15,153,160,0,0,313,313,48,15,250,313,0,0,313,313,40,105,168,313,24,8,281,313
7309270,1844,675528,dpv2,completed,343.0,7.3,148,195,39,0,304,343,0,63,280,343,36,0,307,343,68,89,186,343,55,36,252,343
7309270,1844,675528,new-0.0,completed,305.0,7.15,220,85,0,11,294,305,56,2,247,305,67,0,238,305,40,6,259,305,19,0,286,305
7309270,1844,675528,new-0.5,completed,296.0,7.6,239,57,46,0,250,296,0,3,293,296,57,0,239,296,0,0,296,296,43,0,253,296
7309270,1844,675528,new-1.0,completed,314.0,7.6,179,135,27,38,249,314,32,0,282,314,70,27,217,314,21,0,293,314,0,0,314,314
7309270,1844,380692,base,completed,328.0,6.95,181,147,0,44,284,328,32,44,252,328,57,0,271,328,11,18,299,328,71,63,194,328
7309270,1844,380692,base+,completed,304.0,6.85,209,95,49,34,221,304,61,0,243,304,40,0,264,304,0,0,304,304,19,0,285,304
7309270,1844,380692,dpv1,completed,349.0,7.15,156,193,60,74,215,349,0,0,349,349,60,6,283,349,15,28,306,349,76,76,197,349
7309270,1844,380692,dpv2,completed,302.0,7.15,190,112,56,0,246,302,0,27,275,302,13,0,289,302,36,0,266,302,27,34,241,302
7309270,1844,380692,new-0.0,completed,291.0,7.0,228,63,42,0,249,291,15,2,274,291,0,0,291,291,61,0,230,291,19,0,272,291
7309270,1844,380692,new-0.5,completed,296.0,7.3,216,80,75,0,221,296,5,5,286,296,55,0,241,296,30,0,266,296,0,0,296,296
7309270,1844,380692,new-1.0,completed,321.0,7.55,199,122,0,13,308,321,63,0,258,321,73,22,226,321,37,0,284,321,42,16,263,321
8687401,1835,310811,base,completed,307.0,6.95,168,139,19,0,288,307,3,23,281,307,45,0,262,307,0,83,224,307,23,0,284,307
8687401,1835,310811,base+,completed,286.0,6.9,235,51,0,0,286,286,17,0,269,286,11,9,266,286,28,0,258,286,42,0,244,286
8687401,1835,310811,dpv1,completed,316.0,7.5,171,145,47,0,269,316,79,0,237,316,0,50,266,316,40,11,265,316,42,18,256,316
8687401,1835,310811,dpv2,completed,274.0,7.2,227,47,2,16,256,274,16,0,258,274,0,0,274,274,3,16,255,274,11,0,263,274
8687401,1835,310811,new-0.0,completed,283.0,7.35,233,50,0,0,283,283,47,0,236,283,28,3,252,283,29,0,254,283,40,0,243,283
8687401,1835,310811,new-0.5,completed,278.0,7.55,238,40,36,0,242,278,33,0,245,278,0,0,278,278,20,4,254,278,18,0,260,278
8687401,1835,310811,new-1.0,completed,299.0,7.9,202,97,69,0,230,299,13,0,286,299,0,0,299,299,35,0,264,299,60,28,211,299
8687401,1835,208428,base,completed,297.0,6.95,210,87,44,26,227,297,0,0,297,297,27,0,270,297,16,0,281,297,24,43,230,297
8687401,1835,208428,base+,completed,294.0,7.0,216,78,14,7,273,294,14,0,280,294,0,0,294,294,29,0,265,294,57,19,218,294
8687401,1835,208428,dpv1,completed,295.0,7.35,216,79,37,0,258,295,45,0,250,295,0,0,295,295,39,13,243,295,40,21,234,295
8687401,1835,208428,dpv2,completed,283.0,7.45,231,52,10,0,273,283,27,21,235,283,0,0,283,283,29,0,254,283,26,2,255,283
8687401,1835,208428,new-0.0,completed,298.0,7.45,230,68,0,0,298,298,52,0,246,298,34,0,264,298,68,0,230,298,57,0,241,298
8687401,1835,208428,new-0.5,completed,274.0,7.75,235,39,3,0,271,274,39,0,235,274,0,0,274,274,26,0,248,274,26,0,248,274
8687401,1835,208428,new-1.0,completed,292.0,7.9,209,83,66,0,226,292,0,0,292,292,0,0,292,292,29,0,263,292,61,17,214,292
8687401,1835,460300,base,completed,300.0,6.8,174,126,24,0,276,300,20,16,264,300,21,81,198,300,32,0,268,300,0,0,300,300
8687401,1835,460300,base+,completed,275.0,7.15,248,27,9,0,266,275,27,0,248,275,11,0,264,275,0,0,275,275,19,0,256,275
8687401,1835,460300,dpv1,completed,299.0,7.3,228,71,55,0,244,299,0,0,299,299,53,0,246,299,24,0,275,299,71,0,228,299
8687401,1835,460300,dpv2,completed,272.0,7.35,233,39,0,0,272,272,18,0,254,272,1,0,271,272,22,0,250,272,3,17,252,272
8687401,1835,460300,new-0.0,completed,298.0,7.55,224,74,0,0,298,298,74,0,224,298,28,0,270,298,60,0,238,298,63,0,235,298
8687401,1835,460300,new-0.5,completed,304.0,7.75,240,64,59,0,245,304,22,0,282,304,0,0,304,304,56,0,248,304,59,5,240,304
8687401,1835,460300,new-1.0,completed,311.0,7.8,208,103,87,0,224,311,80,16,215,311,0,0,311,311,57,0,254,311,10,0,301,311
8687401,1835,309704,base,completed,322.0,7.2,159,163,5,27,290,322,14,0,308,322,0,126,196,322,49,11,262,322,43,25,254,322
8687401,1835,309704,base+,completed,282.0,6.8,255,27,25,0,257,282,27,0,255,282,13,0,269,282,0,0,282,282,21,0,261,282
8687401,1835,309704,dpv1,completed,311.0,7.3,175,136,26,23,262,311,61,0,250,311,26,11,274,311,35,0,276,311,0,46,265,311
8687401,1835,309704,dpv2,completed,284.0,7.25,209,75,39,0,245,284,13,0,271,284,0,36,248,284,5,9,270,284,12,0,272,284
8687401,1835,309704,new-0.0,completed,269.0,7.3,228,41,0,7,262,269,31,0,238,269,5,3,261,269,10,0,259,269,11,0,258,269
8687401,1835,309704,new-0.5,completed,274.0,7.7,230,44,2,0,272,274,31,0,243,274,4,0,270,274,44,0,230,274,0,0,274,274
8687401,1835,309704,new-1.0,completed,307.0,7.9,198,109,0,0,307,307,20,0,287,307,83,0,224,307,43,0,264,307,78,26,203,307
8687401,1835,247588,base,completed,303.0,6.6,233,70,64,0,239,303,0,0,303,303,43,0,260,303,70,0,233,303,32,0,271,303
8687401,1835,247588,base+,completed,281.0,7.05,206,75,0,7,274,281,14,19,248,281,0,19,262,281,23,0,258,281,31,0,250,281
8687401,1835,247588,dpv1,completed,299.0,7.3,174,125,40,0,259,299,66,0,233,299,27,24,248,299,0,0,299,299,17,47,235,299
8687401,1835,247588,dpv2,completed,280.0,7.5,211,69,0,0,280,280,22,0,258,280,9,20,251,280,40,0,240,280,29,9,242,280
8687401,1835,247588,new-0.0,completed,276.0,7.35,227,49,49,0,227,276,41,0,235,276,0,0,276,276,39,0,237,276,11,0,265,276
8687401,1835,247588,new-0.5,completed,272.0,7.8,224,48,2,0,270,272,35,1,236,272,0,0,272,272,14,0,258,272,47,0,225,272
8687401,1835,247588,new-1.0,completed,306.0,7.9,200,106,0,0,306,306,34,0,272,306,79,0,227,306,38,0,268,306,75,27,204,306
8687401,1835,203195,base,completed,306.0,7.15,174,132,17,0,289,306,34,0,272,306,9,83,214,306,0,0,306,306,5,60,241,306
8687401,1835,203195,base+,completed,291.0,7.2,231,60,60,0,231,291,20,0,271,291,0,0,291,291,16,0,275,291,48,0,243,291
8687401,1835,203195,dpv1,completed,320.0,7.3,179,141,46,0,274,320,40,29,251,320,34,16,270,320,59,0,261,320,0,56,264,320
8687401,1835,203195,dpv2,completed,276.0,7.4,221,55,3,0,273,276,19,0,257,276,0,25,251,276,30,0,246,276,2,0,274,276
8687401,1835,203195,new-0.0,completed,282.0,7.4,225,57,57,0,225,282,0,0,282,282,39,0,243,282,24,0,258,282,42,0,240,282
8687401,1835,203195,new-0.5,completed,309.0,7.75,232,77,77,0,232,309,42,0,267,309,0,0,309,309,58,0,251,309,71,0,238,309
8687401,1835,203195,new-1.0,completed,294.0,7.8,200,94,62,0,232,294,48,32,214,294,0,0,294,294,26,0,268,294,16,0,278,294
8687401,1835,178029,base,completed,283.0,7.45,219,64,30,0,253,283,32,0,251,283,0,0,283,283,37,0,246,283,23,27,233,283
8687401,1835,178029,base+,completed,290.0,6.9,236,54,0,0,290,290,21,0,269,290,26,0,264,290,16,0,274,290,33,21,236,290
8687401,1835,178029,dpv1,completed,304.0,7.4,184,120,47,0,257,304,61,0,243,304,32,21,251,304,0,46,258,304,31,2,271,304
8687401,1835,178029,dpv2,completed,271.0,7.4,214,57,1,3,267,271,13,0,258,271,5,28,238,271,29,0,242,271,0,0,271,271
8687401,1835,178029,new-0.0,completed,278.0,7.4,229,49,0,0,278,278,39,0,239,278,30,0,248,278,30,0,248,278,49,0,229,278
8687401,1835,178029,new-0.5,completed,290.0,7.55,235,55,31,0,259,290,22,0,268,290,0,0,290,290,46,0,244,290,45,9,236,290
8687401,1835,178029,new-1.0,completed,300.0,7.9,205,95,0,0,300,300,6,0,294,300,73,0,227,300,23,0,277,300,77,18,205,300
8687401,1835,239735,base,completed,297.0,7.05,197,100,13,0,284,297,0,71,226,297,29,0,268,297,4,31,262,297,14,0,283,297
8687401,1835,239735,base+,completed,294.0,6.95,221,73,11,0,283,294,0,32,262,294,49,0,245,294,13,1,280,294,19,0,275,294
8687401,1835,239735,dpv1,completed,285.0,7.15,220,65,25,7,253,285,40,0,245,285,14,18,253,285,21,0,264,285,0,0,285,285
8687401,1835,239735,dpv2,completed,263.0,7.5,207,56,2,0,261,263,8,0,255,263,0,24,239,263,24,0,239,263,9,14,240,263
8687401,1835,239735,new-0.0,completed,258.0,7.35,223,35,0,0,258,258,35,0,223,258,1,0,257,258,1,0,257,258,28,0,230,258
8687401,1835,239735,new-0.5,completed,264.0,7.55,238,26,23,0,241,264,18,0,246,264,0,0,264,264,11,3,250,264,7,0,257,264
8687401,1835,239735,new-1.0,completed,286.0,7.8,189,97,61,0,225,286,51,36,199,286,0,0,286,286,5,0,281,286,24,0,262,286
8687401,1835,675528,base,completed,312.0,6.9,218,94,77,17,218,312,0,0,312,312,70,0,242,312,29,0,283,312,65,0,247,312
8687401,1835,675528,base+,completed,277.0,6.75,235,42,10,0,267,277,42,0,235,277,37,0,240,277,6,0,271,277,0,0,277,277
8687401,1835,675528,dpv1,completed,296.0,7.2,213,83,30,2,264,296,50,0,246,296,8,0,288,296,24,0,272,296,0,31,265,296
8687401,1835,675528,dpv2,completed,280.0,7.5,229,51,24,0,256,280,15,13,252,280,5,0,275,280,0,7,273,280,16,7,257,280
8687401,1835,675528,new-0.0,completed,300.0,7.55,233,67,32,0,268,300,67,0,233,300,0,0,300,300,61,0,239,300,62,0,238,300
8687401,1835,675528,new-0.5,completed,284.0,7.75,235,49,0,0,284,284,2,0,282,284,49,0,235,284,6,0,278,284,39,0,245,284
8687401,1835,675528,new-1.0,completed,315.0,7.8,207,108,84,0,231,315,23,0,292,315,87,0,228,315,55,0,260,315,0,21,294,315
8687401,1835,380692,base,completed,290.0,7.05,179,111,5,74,211,290,37,0,253,290,9,0,281,290,0,37,253,290,18,0,272,290
8687401,1835,380692,base+,completed,289.0,6.95,210,79,23,0,266,289,25,17,247,289,0,0,289,289,27,30,232,289,36,0,253,289
8687401,1835,380692,dpv1,completed,309.0,7.35,174,135,28,35,246,309,72,0,237,309,0,0,309,309,40,0,269,309,15,47,247,309
8687401,1835,380692,dpv2,completed,273.0,7.6,222,51,0,0,273,273,15,0,258,273,1,20,252,273,17,0,256,273,10,17,246,273
8687401,1835,380692,new-0.0,completed,295.0,7.55,227,68,0,0,295,295,68,0,227,295,41,0,254,295,56,0,239,295,53,0,242,295
8687401,1835,380692,new-0.5,completed,275.0,7.75,232,43,2,0,273,275,0,0,275,275,43,0,232,275,2,0,273,275,31,0,244,275
8687401,1835,380692,new-1.0,completed,312.0,7.9,206,106,67,0,245,312,45,0,267,312,0,0,312,312,45,0,267,312,69,37,206,312
7146438,1693,310811,base,completed,342.0,7.1,98,244,56,95,191,342,48,55,239,342,0,51,291,342,58,73,211,342,57,10,275,342
7146438,1693,310811,base+,completed,365.0,7.05,86,279,12,0,353,365,0,201,164,365,16,119,230,365,61,202,102,365,9,0,356,365
7146438,1693,310811,dpv1,completed,371.0,7.5,86,285,0,26,345,371,52,81,238,371,51,189,131,371,25,164,182,371,64,0,307,371
7146438,1693,310811,dpv2,completed,336.0,7.55,90,246,49,138,149,336,0,8,328,336,56,130,150,336,18,35,283,336,65,0,271,336
7146438,1693,310811,new-0.0,completed,307.0,7.55,131,176,67,18,222,307,0,42,265,307,54,15,238,307,91,43,173,307,14,19,274,307
7146438,1693,310811,new-0.5,completed,302.0,7.55,144,158,0,49,253,302,16,13,273,302,78,0,224,302,27,43,232,302,84,19,199,302
7146438,1693,310811,new-1.0,completed,313.0,7.75,135,178,39,35,239,313,89,24,200,313,16,8,289,313,0,65,248,313,92,19,202,313
7146438,1693,208428,base,completed,370.0,7.2,130,240,60,0,310,370,58,0,312,370,54,152,164,370,0,144,226,370,44,121,205,370
7146438,1693,208428,base+,completed,328.0,7.0,110,218,30,0,298,328,60,20,248,328,43,158,127,328,0,0,328,328,40,84,204,328
7146438,1693,208428,dpv1,completed,352.0,7.3,79,273,31,6,315,352,41,57,254,352,14,163,175,352,27,192,133,352,0,19,333,352
7146438,1693,208428,dpv2,completed,320.0,7.75,124,196,0,95,225,320,40,5,275,320,46,93,181,320,44,30,246,320,50,0,270,320
7146438,1693,208428,new-0.0,completed,297.0,7.45,151,146,0,34,263,297,19,5,273,297,83,0,214,297,62,37,198,297,63,15,219,297
7146438,1693,208428,new-0.5,completed,300.0,7.55,149,151,0,38,262,300,22,5,273,300,88,0,212,300,39,37,224,300,83,15,202,300
7146438,1693,208428,new-1.0,completed,297.0,7.65,153,144,64,34,199,297,39,25,233,297,11,17,269,297,0,25,272,297,73,10,214,297
7146438,1693,460300,base,completed,447.0,7.4,72,375,0,177,270,447,30,0,417,447,30,212,205,447,7,258,182,447,1,332,114,447
7146438,1693,460300,base+,completed,343.0,7.05,99,244,33,189,121,343,0,43,300,343,45,29,269,343,44,0,299,343,11,98,234,343
7146438,1693,460300,dpv1,completed,386.0,7.35,73,313,0,0,386,386,69,92,225,386,50,208,128,386,60,171,155,386,61,4,321,386
7146438,1693,460300,dpv2,completed,320.0,7.75,111,209,40,121,159,320,44,6,270,320,8,119,193,320,35,51,234,320,0,0,320,320
7146438,1693,460300,new-0.0,completed,281.0,7.45,171,110,74,0,207,281,0,6,275,281,15,19,247,281,41,16,224,281,54,2,225,281
7146438,1693,460300,new-0.5,completed,287.0,7.75,164,123,17,0,270,287,0,19,268,287,82,24,181,287,27,16,244,287,77,2,208,287
7146438,1693,460300,new-1.0,completed,289.0,7.65,190,99,0,24,265,289,81,0,208,289,9,3,277,289,80,14,195,289,30,0,259,289
7146438,1693,309704,base,completed,341.0,7.2,136,205,23,98,220,341,57,29,255,341,34,66,241,341,0,0,341,341,56,121,164,341
7146438,1693,309704,base+,completed,349.0,7.35,107,242,33,145,171,349,48,26,275,349,44,1,304,349,21,143,185,349,0,78,271,349
7146438,1693,309704,dpv1,completed,365.0,7.6,82,283,68,0,297,365,60,76,229,365,45,182,138,365,45,146,174,365,0,0,365,365
7146438,1693,309704,dpv2,completed,351.0,7.6,87,264,60,144,147,351,0,22,329,351,66,124,161,351,35,31,285,351,70,0,281,351
7146438,1693,309704,new-0.0,completed,295.0,7.6,150,145,55,18,222,295,7,12,276,295,83,8,204,295,0,63,232,295,41,6,248,295
7146438,1693,309704,new-0.5,completed,301.0,7.7,141,160,14,42,245,301,41,22,238,301,53,8,240,301,78,46,177,301,0,19,282,301
7146438,1693,309704,new-1.0,completed,308.0,7.7,160,148,50,20,238,308,89,17,202,308,0,20,288,308,92,34,182,308,20,5,283,308
7146438,1693,247588,base,completed,420.0,7.2,66,354,51,23,346,420,37,241,142,420,0,281,139,420,92,110,218,420,44,0,376,420
7146438,1693,247588,base+,completed,380.0,7.1,89,291,43,90,247,380,0,205,175,380,21,196,163,380,46,0,334,380,42,98,240,380
7146438,1693,247588,dpv1,completed,348.0,7.45,84,264,0,17,331,348,55,44,249,348,37,176,135,348,23,159,166,348,55,15,278,348
7146438,1693,247588,dpv2,completed,327.0,7.75,105,222,44,123,160,327,45,12,270,327,20,123,184,327,41,56,230,327,0,0,327,327
7146438,1693,247588,new-0.0,completed,299.0,7.65,139,160,68,48,183,299,17,12,270,299,43,23,233,299,0,39,260,299,79,13,207,299
7146438,1693,247588,new-0.5,completed,310.0,7.7,136,174,64,48,198,310,50,20,240,310,0,34,276,310,16,27,267,310,84,13,213,310
7146438,1693,247588,new-1.0,completed,282.0,7.75,157,125,24,29,229,282,69,3,210,282,0,1,281,282,69,31,182,282,23,0,259,282
7146438,1693,203195,base,completed,387.0,6.85,72,315,36,92,259,387,11,200,176,387,28,195,164,387,28,77,282,387,0,57,330,387
7146438,1693,203195,base+,completed,341.0,7.25,132,209,51,141,149,341,0,0,341,341,26,0,315,341,59,101,181,341,51,73,217,341
7146438,1693,203195,dpv1,completed,355.0,7.35,75,280,0,20,335,355,20,69,266,355,47,156,152,355,42,177,136,355,59,0,296,355
7146438,1693,203195,dpv2,completed,348.0,7.7,92,256,50,139,159,348,66,54,228,348,30,109,209,348,0,0,348,348,14,99,235,348
7146438,1693,203195,new-0.0,completed,280.0,7.65,160,120,53,8,219,280,42,0,238,280,13,5,262,280,0,35,245,280,79,14,187,280
7146438,1693,203195,new-0.5,completed,300.0,7.55,156,144,0,32,268,300,72,0,228,300,96,5,199,300,22,22,256,300,43,14,243,300
7146438,1693,203195,new-1.0,completed,281.0,7.7,165,116,18,12,251,281,65,0,216,281,39,6,236,281,0,39,242,281,36,0,245,281
7146438,1693,178029,base,completed,347.0,7.05,97,250,0,182,165,347,32,111,204,347,28,151,168,347,25,0,322,347,18,6,323,347
7146438,1693,178029,base+,completed,343.0,6.95,104,239,61,121,161,343,35,24,284,343,69,0,274,343,0,0,343,343,44,137,162,343
7146438,1693,178029,dpv1,completed,363.0,7.55,95,268,44,220,99,363,0,0,363,363,46,167,150,363,48,47,268,363,43,0,320,363
7146438,1693,178029,dpv2,completed,335.0,7.7,93,242,45,127,163,335,0,19,316,335,19,128,188,335,50,44,241,335,56,0,279,335
7146438,1693,178029,new-0.0,completed,279.0,7.8,163,116,10,6,263,279,49,0,230,279,36,12,231,279,70,28,181,279,0,24,255,279
7146438,1693,178029,new-0.5,completed,296.0,7.75,165,131,34,7,255,296,78,0,218,296,13,12,271,296,0,47,249,296,84,6,206,296
7146438,1693,178029,new-1.0,completed,299.0,7.7,182,117,23,0,276,299,84,17,198,299,0,16,283,299,38,13,248,299,87,6,206,299
7146438,1693,239735,base,completed,333.0,6.95,76,257,36,194,103,333,57,75,201,333,2,0,331,333,0,19,314,333,59,6,268,333
7146438,1693,239735,base+,completed,381.0,7.3,113,268,0,14,367,381,54,200,127,381,51,100,230,381,65,0,316,381,58,139,184,381
7146438,1693,239735,dpv1,completed,348.0,7.4,94,254,48,193,107,348,0,20,328,348,61,23,264,348,16,151,181,348,50,10,288,348
7146438,1693,239735,dpv2,completed,315.0,7.8,97,218,39,126,150,315,49,10,256,315,8,120,187,315,41,37,237,315,0,4,311,315
7146438,1693,239735,new-0.0,completed,279.0,7.6,161,118,62,0,217,279,79,16,184,279,12,8,259,279,0,37,242,279,33,0,246,279
7146438,1693,239735,new-0.5,completed,271.0,7.7,161,110,12,17,242,271,12,13,246,271,59,0,212,271,0,35,236,271,63,2,206,271
7146438,1693,239735,new-1.0,completed,277.0,7.6,178,99,63,28,186,277,0,20,257,277,10,0,267,277,71,0,206,277,56,0,221,277
7146438,1693,675528,base,completed,467.0,7.0,87,380,19,241,207,467,50,226,191,467,28,0,439,467,0,236,231,467,63,260,144,467
7146438,1693,675528,base+,completed,410.0,7.15,100,310,39,163,208,410,8,0,402,410,18,203,189,410,0,230,180,410,29,90,291,410
7146438,1693,675528,dpv1,completed,356.0,7.45,93,263,36,216,104,356,47,29,280,356,45,15,296,356,14,156,186,356,0,41,315,356
7146438,1693,675528,dpv2,completed,349.0,7.75,101,248,45,150,154,349,59,8,282,349,21,137,191,349,55,75,219,349,0,0,349,349
7146438,1693,675528,new-0.0,completed,297.0,7.65,152,145,61,12,224,297,17,14,266,297,50,22,225,297,0,56,241,297,85,0,212,297
7146438,1693,675528,new-0.5,completed,290.0,7.8,152,138,26,28,236,290,68,11,211,290,11,21,258,290,0,45,245,290,72,0,218,290
7146438,1693,675528,new-1.0,completed,293.0,7.75,148,145,20,17,256,293,70,49,174,293,48,0,245,293,41,24,228,293,0,13,280,293
7146438,1693,380692,base,completed,319.0,7.2,92,227,0,132,187,319,22,61,236,319,54,62,203,319,9,49,261,319,60,0,259,319
7146438,1693,380692,base+,completed,389.0,7.1,90,299,62,34,293,389,0,0,389,389,68,95,226,389,40,146,203,389,54,217,118,389
7146438,1693,380692,dpv1,completed,349.0,7.55,79,270,48,0,301,349,16,47,286,349,35,174,140,349,55,157,137,349,0,0,349,349
7146438,1693,380692,dpv2,completed,326.0,7.75,115,211,47,119,160,326,49,13,264,326,26,107,193,326,37,54,235,326,0,0,326,326
7146438,1693,380692,new-0.0,completed,287.0,7.65,153,134,61,38,188,287,9,7,271,287,38,1,248,287,75,3,209,287,0,36,251,287
7146438,1693,380692,new-0.5,completed,287.0,7.65,165,122,59,38,190,287,26,9,252,287,14,0,273,287,61,6,220,287,0,26,261,287
7146438,1693,380692,new-1.0,completed,287.0,7.85,149,138,17,15,255,287,60,0,227,287,19,12,256,287,80,32,175,287,0,23,264,287
9136610,1744,310811,base,completed,304.0,6.8,222,82,0,0,304,304,41,0,263,304,30,17,257,304,65,0,239,304,76,0,228,304
9136610,1744,310811,base+,completed,319.0,6.85,170,149,60,0,259,319,35,27,257,319,63,59,197,319,0,21,298,319,50,0,269,319
9136610,1744,310811,dpv1,completed,281.0,6.9,207,74,38,0,243,281,0,0,281,281,40,0,241,281,58,0,223,281,29,16,236,281
9136610,1744,310811,dpv2,completed,291.0,7.45,214,77,58,0,233,291,27,0,264,291,68,7,216,291,41,2,248,291,0,0,291,291
9136610,1744,310811,new-0.0,completed,255.0,7.1,228,27,3,0,252,255,20,0,235,255,24,0,231,255,11,0,244,255,0,11,244,255
9136610,1744,310811,new-0.5,completed,259.0,7.4,229,30,30,0,229,259,22,0,237,259,20,0,239,259,8,0,251,259,0,0,259,259
9136610,1744,310811,new-1.0,completed,327.0,7.45,159,168,0,0,327,327,74,59,194,327,68,40,219,327,73,0,254,327,74,0,253,327
9136610,1744,208428,base,completed,290.0,6.85,204,86,54,6,230,290,16,7,267,290,46,0,244,290,0,0,290,290,27,27,236,290
9136610,1744,208428,base+,completed,285.0,7.15,189,96,0,56,229,285,20,0,265,285,6,0,279,285,41,0,244,285,40,0,245,285
9136610,1744,208428,dpv1,completed,280.0,7.0,203,77,19,0,261,280,0,0,280,280,30,6,244,280,42,15,223,280,57,0,223,280
9136610,1744,208428,dpv2,completed,273.0,7.35,223,50,30,0,243,273,27,0,246,273,38,12,223,273,16,0,257,273,0,0,273,273
9136610,1744,208428,new-0.0,completed,282.0,6.85,205,77,0,11,271,282,75,0,207,282,10,0,272,282,44,0,238,282,41,2,239,282
9136610,1744,208428,new-0.5,completed,287.0,7.55,207,80,52,5,230,287,34,0,253,287,0,0,287,287,60,15,212,287,34,0,253,287
9136610,1744,208428,new-1.0,completed,312.0,7.6,158,154,53,0,259,312,39,60,213,312,0,47,265,312,49,0,263,312,54,0,258,312
9136610,1744,460300,base,completed,313.0,6.9,173,140,0,27,286,313,0,61,252,313,35,0,278,313,53,61,199,313,37,4,272,313
9136610,1744,460300,base+,completed,299.0,7.15,203,96,8,9,282,299,43,29,227,299,0,0,299,299,33,0,266,299,66,0,233,299
9136610,1744,460300,dpv1,completed,285.0,6.95,198,87,57,0,228,285,0,0,285,285,23,0,262,285,29,16,240,285,36,14,235,285
9136610,1744,460300,dpv2,completed,282.0,7.35,213,69,40,0,242,282,25,0,257,282,51,18,213,282,20,0,262,282,0,0,282,282
9136610,1744,460300,new-0.0,completed,283.0,6.85,212,71,0,5,278,283,70,0,213,283,16,1,266,283,44,0,239,283,27,0,256,283
9136610,1744,460300,new-0.5,completed,271.0,7.55,219,52,44,0,227,271,46,0,225,271,0,0,271,271,5,6,260,271,15,0,256,271
9136610,1744,460300,new-1.0,completed,308.0,7.45,162,146,46,0,262,308,49,56,203,308,43,36,229,308,60,0,248,308,0,0,308,308
9136610,1744,309704,base,completed,295.0,6.55,177,118,34,0,261,295,41,17,237,295,16,62,217,295,50,10,235,295,0,0,295,295
9136610,1744,309704,base+,completed,278.0,7.0,189,89,28,0,250,278,9,0,269,278,0,0,278,278,41,13,224,278,76,0,202,278
9136610,1744,309704,dpv1,completed,292.0,7.05,189,103,35,0,257,292,0,0,292,292,46,29,217,292,28,0,264,292,74,0,218,292
9136610,1744,309704,dpv2,completed,287.0,7.45,222,65,55,0,232,287,34,0,253,287,62,3,222,287,32,0,255,287,0,0,287,287
9136610,1744,309704,new-0.0,completed,264.0,7.1,204,60,22,0,242,264,7,0,257,264,60,0,204,264,0,0,264,264,18,0,246,264
9136610,1744,309704,new-0.5,completed,284.0,7.55,207,77,77,0,207,284,30,0,254,284,0,0,284,284,39,0,245,284,45,0,239,284
9136610,1744,309704,new-1.0,completed,325.0,7.45,156,169,55,0,270,325,59,78,188,325,60,40,225,325,0,0,325,325,77,0,248,325
9136610,1744,247588,base,completed,289.0,6.8,207,82,39,0,250,289,44,27,218,289,7,0,282,289,1,37,251,289,0,16,273,289
9136610,1744,247588,base+,completed,285.0,6.9,189,96,32,24,229,285,30,0,255,285,69,0,216,285,0,6,279,285,65,6,214,285
9136610,1744,247588,dpv1,completed,290.0,7.15,182,108,0,0,290,290,41,56,193,290,34,0,256,290,52,0,238,290,27,0,263,290
9136610,1744,247588,dpv2,completed,271.0,7.45,229,42,40,0,231,271,13,0,258,271,41,1,229,271,9,0,262,271,0,5,266,271
9136610,1744,247588,new-0.0,completed,274.0,7.0,208,66,0,0,274,274,56,0,218,274,25,9,240,274,15,1,258,274,34,0,240,274
9136610,1744,247588,new-0.5,completed,259.0,7.55,225,34,32,0,227,259,29,0,230,259,0,2,257,259,2,0,257,259,15,0,244,259
9136610,1744,247588,new-1.0,completed,303.0,7.45,160,143,48,0,255,303,52,61,190,303,44,39,220,303,54,0,249,303,0,0,303,303
9136610,1744,203195,base,completed,296.0,6.8,215,81,4,40,252,296,40,0,256,296,28,21,247,296,71,0,225,296,0,20,276,296
9136610,1744,203195,base+,completed,316.0,6.75,170,146,54,0,262,316,47,0,269,316,33,56,227,316,0,0,316,316,70,30,216,316
9136610,1744,203195,dpv1,completed,274.0,7.1,201,73,13,0,261,274,0,0,274,274,16,11,247,274,30,17,227,274,52,0,222,274
9136610,1744,203195,dpv2,completed,297.0,7.35,220,77,0,0,297,297,41,0,256,297,66,11,220,297,30,0,267,297,56,0,241,297
9136610,1744,203195,new-0.0,completed,278.0,6.95,229,49,44,0,234,278,49,0,229,278,0,0,278,278,21,0,257,278,46,0,232,278
9136610,1744,203195,new-0.5,completed,259.0,7.4,237,22,22,0,237,259,15,0,244,259,15,0,244,259,0,0,259,259,18,0,241,259
9136610,1744,203195,new-1.0,completed,303.0,7.45,165,138,45,0,258,303,43,71,189,303,45,36,222,303,49,0,254,303,0,0,303,303
9136610,1744,178029,base,completed,296.0,7.05,149,147,42,20,234,296,0,10,286,296,16,105,175,296,13,0,283,296,48,0,248,296
9136610,1744,178029,base+,completed,300.0,6.7,167,133,45,28,227,300,19,49,232,300,35,0,265,300,0,0,300,300,48,30,222,300
9136610,1744,178029,dpv1,completed,285.0,6.95,209,76,24,0,261,285,0,0,285,285,35,16,234,285,24,0,261,285,60,0,225,285
9136610,1744,178029,dpv2,completed,279.0,7.3,207,72,31,0,248,279,44,0,235,279,12,0,267,279,19,28,232,279,0,0,279,279
9136610,1744,178029,new-0.0,completed,277.0,7.15,233,44,0,0,277,277,23,0,254,277,44,0,233,277,38,0,239,277,36,0,241,277
9136610,1744,178029,new-0.5,completed,273.0,7.3,231,42,9,0,264,273,32,0,241,273,30,0,243,273,0,0,273,273,42,0,231,273
9136610,1744,178029,new-1.0,completed,313.0,7.45,160,153,57,0,256,313,45,69,199,313,53,38,222,313,64,0,249,313,0,0,313,313
9136610,1744,239735,base,completed,299.0,7.05,159,140,34,61,204,299,5,0,294,299,32,34,233,299,0,81,218,299,4,12,283,299
9136610,1744,239735,base+,completed,316.0,6.7,154,162,0,0,316,316,42,50,224,316,62,46,208,316,1,69,246,316,41,0,275,316
9136610,1744,239735,dpv1,completed,267.0,7.05,196,71,22,0,245,267,63,0,204,267,32,8,227,267,3,0,264,267,0,8,259,267
9136610,1744,239735,dpv2,completed,267.0,7.45,221,46,29,0,238,267,17,0,250,267,46,0,221,267,34,0,233,267,0,0,267,267
9136610,1744,239735,new-0.0,completed,274.0,7.1,206,68,26,0,248,274,34,0,240,274,0,0,274,274,68,0,206,274,44,0,230,274
9136610,1744,239735,new-0.5,completed,265.0,7.35,201,64,29,0,236,265,18,0,247,265,64,0,201,265,0,0,265,265,29,0,236,265
9136610,1744,239735,new-1.0,completed,294.0,7.45,155,139,43,0,251,294,40,61,193,294,34,38,222,294,47,0,247,294,0,0,294,294
9136610,1744,675528,base,completed,325.0,7.1,151,174,33,81,211,325,43,2,280,325,4,14,307,325,0,75,250,325,58,46,221,325
9136610,1744,675528,base+,completed,310.0,6.8,159,151,52,33,225,310,20,57,233,310,66,34,210,310,41,0,269,310,0,0,310,310
9136610,1744,675528,dpv1,completed,276.0,7.05,190,86,7,39,230,276,47,0,229,276,21,0,255,276,14,0,262,276,0,0,276,276
9136610,1744,675528,dpv2,completed,284.0,7.45,221,63,46,0,238,284,24,0,260,284,62,0,222,284,31,1,252,284,0,0,284,284
9136610,1744,675528,new-0.0,completed,285.0,7.0,224,61,0,0,285,285,61,0,224,285,26,0,259,285,40,0,245,285,55,0,230,285
9136610,1744,675528,new-0.5,completed,284.0,7.5,228,56,26,0,258,284,44,0,240,284,39,0,245,284,0,12,272,284,38,0,246,284
9136610,1744,675528,new-1.0,completed,292.0,7.45,166,126,25,0,267,292,33,56,203,292,36,25,231,292,45,0,247,292,0,0,292,292
9136610,1744,380692,base,completed,267.0,6.95,213,54,9,12,246,267,0,0,267,267,17,0,250,267,40,0,227,267,11,2,254,267
9136610,1744,380692,base+,completed,297.0,7.05,168,129,51,37,209,297,0,12,285,297,49,7,241,297,18,43,236,297,48,0,249,297
9136610,1744,380692,dpv1,completed,288.0,6.9,191,97,25,24,239,288,58,0,230,288,23,0,265,288,0,0,288,288,45,15,228,288
9136610,1744,380692,dpv2,completed,286.0,7.45,215,71,54,0,232,286,32,0,254,286,64,7,215,286,38,0,248,286,0,0,286,286
9136610,1744,380692,new-0.0,completed,287.0,7.2,220,67,35,0,252,287,65,0,222,287,67,0,220,287,67,0,220,287,0,0,287,287
9136610,1744,380692,new-0.5,completed,277.0,7.55,216,61,49,0,228,277,34,0,243,277,0,0,277,277,60,1,216,277,42,0,235,277
9136610,1744,380692,new-1.0,completed,317.0,7.45,161,156,63,0,254,317,61,67,189,317,61,34,222,317,70,0,247,317,0,0,317,317
5704134,1768,310811,base,completed,448.0,7.05,131,317,78,203,167,448,71,0,377,448,10,110,328,448,25,217,206,448,0,271,177,448
5704134,1768,310811,base+,completed,410.0,6.9,70,340,0,81,329,410,12,201,197,410,37,126,247,410,86,163,161,410,71,10,329,410
5704134,1768,310811,dpv1,completed,357.0,7.15,55,302,107,0,250,357,26,155,176,357,45,8,304,357,0,85,272,357,73,65,219,357
5704134,1768,310811,dpv2,completed,314.0,7.35,124,190,70,0,244,314,23,104,187,314,47,0,267,314,0,3,311,314,39,40,235,314
5704134,1768,310811,new-0.0,completed,327.0,6.75,173,154,19,34,274,327,46,38,243,327,84,0,243,327,99,0,228,327,0,44,283,327
5704134,1768,310811,new-0.5,completed,316.0,7.2,189,127,28,19,269,316,82,0,234,316,0,38,278,316,92,0,224,316,41,29,246,316
5704134,1768,310811,new-1.0,completed,282.0,7.5,177,105,41,2,239,282,0,27,255,282,30,1,251,282,2,29,251,282,4,7,271,282
5704134,1768,208428,base,completed,506.0,6.75,98,408,70,0,436,506,42,283,181,506,18,331,157,506,97,124,285,506,0,282,224,506
5704134,1768,208428,base+,completed,337.0,7.05,155,182,21,80,236,337,0,58,279,337,45,32,260,337,78,5,254,337,90,0,247,337
5704134,1768,208428,dpv1,completed,362.0,7.15,58,304,65,69,228,362,0,6,356,362,17,102,243,362,86,11,265,362,40,156,166,362
5704134,1768,208428,dpv2,completed,372.0,7.35,117,255,100,0,272,372,42,83,247,372,97,69,206,372,36,89,247,372,0,52,320,372
5704134,1768,208428,new-0.0,completed,322.0,6.9,169,153,27,42,253,322,0,31,291,322,46,35,241,322,84,0,238,322,80,0,242,322
5704134,1768,208428,new-0.5,completed,298.0,7.2,194,104,10,0,288,298,60,0,238,298,0,24,274,298,64,0,234,298,36,31,231,298
5704134,1768,208428,new-1.0,completed,297.0,7.45,145,152,54,0,243,297,0,46,251,297,37,0,260,297,4,17,276,297,16,35,246,297
5704134,1768,460300,base,completed,480.0,6.85,58,422,22,64,394,480,110,236,134,480,75,84,321,480,44,234,202,480,0,255,225,480
5704134,1768,460300,base+,completed,380.0,7.25,120,260,0,109,271,380,55,0,325,380,44,119,217,380,23,181,176,380,79,0,301,380
5704134,1768,460300,dpv1,completed,391.0,7.0,57,334,21,152,218,391,104,0,287,391,75,0,316,391,43,107,241,391,0,172,219,391
5704134,1768,460300,dpv2,completed,379.0,7.3,101,278,36,0,343,379,90,151,138,379,13,103,263,379,0,39,340,379,92,101,186,379
5704134,1768,460300,new-0.0,completed,311.0,6.7,168,143,82,20,209,311,0,23,288,311,42,31,238,311,76,0,235,311,15,9,287,311
5704134,1768,460300,new-0.5,completed,317.0,7.2,182,135,17,36,264,317,0,38,279,317,46,24,247,317,83,0,234,317,86,0,231,317
5704134,1768,460300,new-1.0,completed,291.0,7.4,167,124,10,0,281,291,0,36,255,291,44,0,247,291,12,40,239,291,30,4,257,291
5704134,1768,309704,base,completed,362.0,7.05,71,291,58,0,304,362,7,174,181,362,0,85,277,362,24,86,252,362,94,11,257,362
5704134,1768,309704,base+,completed,379.0,6.9,113,266,78,0,301,379,25,145,209,379,47,45,287,379,0,163,216,379,96,2,281,379
5704134,1768,309704,dpv1,completed,347.0,7.15,72,275,47,0,300,347,19,141,187,347,100,0,247,347,89,0,258,347,0,69,278,347
5704134,1768,309704,dpv2,completed,384.0,7.35,91,293,0,115,269,384,43,142,199,384,27,103,254,384,123,10,251,384,80,0,304,384
5704134,1768,309704,new-0.0,completed,323.0,6.8,179,144,25,41,257,323,44,29,250,323,83,0,240,323,99,0,224,323,0,46,277,323
5704134,1768,309704,new-0.5,completed,306.0,7.2,183,123,10,8,288,306,80,6,220,306,0,20,286,306,35,15,256,306,78,1,227,306
5704134,1768,309704,new-1.0,completed,286.0,7.45,174,112,5,0,281,286,3,39,244,286,43,5,238,286,23,0,263,286,0,25,261,286
5704134,1768,247588,base,completed,562.0,7.0,118,444,72,240,250,562,21,371,170,562,114,285,163,562,35,59,468,562,0,346,216,562
5704134,1768,247588,base+,completed,389.0,6.75,82,307,34,108,247,389,77,60,252,389,0,89,300,389,20,60,309,389,121,141,127,389
5704134,1768,247588,dpv1,completed,373.0,7.05,56,317,45,90,238,373,76,64,233,373,0,42,331,373,35,164,174,373,97,0,276,373
5704134,1768,247588,dpv2,completed,354.0,7.35,89,265,91,28,235,354,33,141,180,354,0,44,310,354,68,27,259,354,18,105,231,354
5704134,1768,247588,new-0.0,completed,309.0,6.95,153,156,40,45,224,309,86,0,223,309,67,5,237,309,0,39,270,309,19,33,257,309
5704134,1768,247588,new-0.5,completed,294.0,7.25,199,95,0,16,278,294,19,20,255,294,36,8,250,294,76,0,218,294,75,0,219,294
5704134,1768,247588,new-1.0,completed,283.0,7.45,191,92,38,0,245,283,4,20,259,283,34,0,249,283,0,1,282,283,0,33,250,283
5704134,1768,203195,base,completed,473.0,6.7,106,367,69,151,253,473,120,0,353,473,0,277,196,473,11,296,166,473,36,120,317,473
5704134,1768,203195,base+,completed,443.0,6.95,119,324,3,186,254,443,72,0,371,443,20,183,240,443,35,208,200,443,0,175,268,443
5704134,1768,203195,dpv1,completed,349.0,7.05,62,287,0,86,263,349,73,0,276,349,23,95,231,349,92,1,256,349,39,80,230,349
5704134,1768,203195,dpv2,completed,365.0,7.4,99,266,88,0,277,365,89,101,175,365,17,55,293,365,0,92,273,365,39,82,244,365
5704134,1768,203195,new-0.0,completed,327.0,6.75,154,173,30,42,255,327,0,24,303,327,50,48,229,327,82,0,245,327,87,0,240,327
5704134,1768,203195,new-0.5,completed,305.0,7.2,194,111,0,17,288,305,21,10,274,305,41,24,240,305,86,0,219,305,74,0,231,305
5704134,1768,203195,new-1.0,completed,288.0,7.5,163,125,37,0,251,288,0,31,257,288,41,7,240,288,23,40,225,288,0,6,282,288
5704134,1768,178029,base,completed,495.0,6.95,61,434,0,175,320,495,69,0,426,495,77,243,175,495,45,261,189,495,27,342,126,495
5704134,1768,178029,base+,completed,314.0,6.9,134,180,66,0,248,314,67,0,247,314,0,31,283,314,19,87,208,314,36,33,245,314
5704134,1768,178029,dpv1,completed,379.0,7.25,53,326,68,0,311,379,31,87,261,379,13,120,246,379,74,72,233,379,0,171,208,379
5704134,1768,178029,dpv2,completed,376.0,7.4,125,251,0,93,283,376,138,4,234,376,65,30,281,376,19,108,249,376,42,111,223,376
5704134,1768,178029,new-0.0,completed,323.0,6.85,174,149,41,27,255,323,0,35,288,323,21,54,248,323,97,0,226,323,80,0,243,323
5704134,1768,178029,new-0.5,completed,306.0,7.35,187,119,0,10,296,306,23,39,244,306,44,14,248,306,84,0,222,306,72,0,234,306
5704134,1768,178029,new-1.0,completed,291.0,7.35,188,103,15,7,269,291,23,0,268,291,29,31,231,291,36,0,255,291,0,29,262,291
5704134,1768,239735,base,completed,366.0,6.85,153,213,73,0,293,366,14,127,225,366,109,13,244,366,36,101,229,366,0,86,280,366
5704134,1768,239735,base+,completed,355.0,6.95,93,262,45,20,290,355,23,150,182,355,78,84,193,355,77,9,269,355,0,40,315,355
5704134,1768,239735,dpv1,completed,373.0,7.15,53,320,59,0,314,373,16,168,189,373,81,50,242,373,0,66,307,373,34,176,163,373
5704134,1768,239735,dpv2,completed,391.0,7.4,91,300,0,55,336,391,70,126,195,391,93,82,216,391,25,117,249,391,36,126,229,391
5704134,1768,239735,new-0.0,completed,302.0,6.75,162,140,17,43,242,302,69,0,233,302,71,0,231,302,38,36,228,302,0,11,291,302
5704134,1768,239735,new-0.5,completed,315.0,7.3,148,167,0,20,295,315,71,0,244,315,23,40,252,315,75,0,240,315,38,63,214,315
5704134,1768,239735,new-1.0,completed,282.0,7.4,172,110,36,0,246,282,0,33,249,282,31,30,221,282,43,4,235,282,15,0,267,282
5704134,1768,675528,base,completed,357.0,6.75,137,220,78,21,258,357,83,108,166,357,34,80,243,357,12,54,291,357,0,71,286,357
5704134,1768,675528,base+,completed,367.0,6.95,110,257,82,0,285,367,0,131,236,367,50,5,312,367,30,165,172,367,104,15,248,367
5704134,1768,675528,dpv1,completed,351.0,7.1,65,286,86,0,265,351,0,75,276,351,23,89,239,351,90,6,255,351,46,74,231,351
5704134,1768,675528,dpv2,completed,372.0,7.25,98,274,32,51,289,372,69,0,303,372,110,90,172,372,0,98,274,372,12,104,256,372
5704134,1768,675528,new-0.0,completed,316.0,6.65,164,152,21,35,260,316,72,0,244,316,42,34,240,316,85,0,231,316,0,33,283,316
5704134,1768,675528,new-0.5,completed,329.0,7.3,178,151,46,45,238,329,0,41,288,329,25,25,279,329,82,0,247,329,82,0,247,329
5704134,1768,675528,new-1.0,completed,303.0,7.45,175,128,45,0,258,303,19,16,268,303,47,0,256,303,0,49,254,303,9,22,272,303
5704134,1768,380692,base,completed,394.0,6.75,96,298,0,252,142,394,37,20,337,394,8,135,251,394,94,114,186,394,61,0,333,394
5704134,1768,380692,base+,completed,311.0,7.05,143,168,18,72,221,311,86,0,225,311,0,49,262,311,38,0,273,311,84,0,227,311
5704134,1768,380692,dpv1,completed,366.0,7.15,60,306,0,28,338,366,100,60,206,366,48,23,295,366,25,149,192,366,72,67,227,366
5704134,1768,380692,dpv2,completed,382.0,7.35,98,284,43,0,339,382,0,48,334,382,24,119,239,382,104,112,166,382,103,82,197,382
5704134,1768,380692,new-0.0,completed,313.0,6.75,172,141,26,25,262,313,0,24,289,313,44,35,234,313,77,0,236,313,90,0,223,313
5704134,1768,380692,new-0.5,completed,315.0,7.3,187,128,26,16,273,315,79,2,234,315,0,7,308,315,89,0,226,315,46,38,231,315
5704134,1768,380692,new-1.0,completed,300.0,7.4,165,135,21,0,279,300,0,37,263,300,54,31,215,300,19,2,279,300,39,15,246,300
8905084,1757,310811,base,completed,281.0,6.75,189,92,27,0,254,281,53,4,224,281,0,12,269,281,22,34,225,281,8,0,273,281
8905084,1757,310811,base+,completed,290.0,6.85,220,70,0,0,290,290,53,0,237,290,62,8,220,290,24,0,266,290,30,0,260,290
8905084,1757,310811,dpv1,completed,261.0,7.35,227,34,11,0,250,261,6,9,246,261,0,0,261,261,0,0,261,261,34,0,227,261
8905084,1757,310811,dpv2,completed,271.0,7.2,219,52,0,0,271,271,22,0,249,271,27,0,244,271,19,0,252,271,52,0,219,271
8905084,1757,310811,new-0.0,completed,272.0,7.3,224,48,48,0,224,272,16,0,256,272,0,0,272,272,48,0,224,272,31,0,241,272
8905084,1757,310811,new-0.5,completed,266.0,7.5,228,38,0,0,266,266,38,0,228,266,14,0,252,266,4,0,262,266,36,0,230,266
8905084,1757,310811,new-1.0,completed,283.0,7.45,223,60,0,0,283,283,33,0,250,283,40,0,243,283,50,10,223,283,22,0,261,283
8905084,1757,208428,base,completed,275.0,7.3,216,59,34,0,241,275,22,0,253,275,59,0,216,275,0,0,275,275,18,1,256,275
8905084,1757,208428,base+,completed,277.0,7.0,234,43,9,0,268,277,0,28,249,277,7,0,270,277,35,0,242,277,22,0,255,277
8905084,1757,208428,dpv1,completed,294.0,7.35,225,69,43,0,251,294,0,0,294,294,41,0,253,294,69,0,225,294,29,10,255,294
8905084,1757,208428,dpv2,completed,262.0,7.4,228,34,34,0,228,262,12,0,250,262,0,0,262,262,29,0,233,262,13,0,249,262
8905084,1757,208428,new-0.0,completed,279.0,7.2,218,61,58,0,221,279,7,0,272,279,0,0,279,279,45,0,234,279,61,0,218,279
8905084,1757,208428,new-0.5,completed,263.0,7.45,221,42,6,0,257,263,42,0,221,263,12,0,251,263,19,0,244,263,0,0,263,263
8905084,1757,208428,new-1.0,completed,276.0,7.5,226,50,37,0,239,276,0,0,276,276,1,0,275,276,30,13,233,276,22,0,254,276
8905084,1757,460300,base,completed,275.0,6.85,229,46,33,0,242,275,11,0,264,275,6,0,269,275,0,31,244,275,16,0,259,275
8905084,1757,460300,base+,completed,283.0,7.2,225,58,58,0,225,283,46,0,237,283,0,0,283,283,32,0,251,283,11,0,272,283
8905084,1757,460300,dpv1,completed,287.0,7.05,228,59,12,0,275,287,40,0,247,287,46,0,241,287,59,0,228,287,0,0,287,287
8905084,1757,460300,dpv2,completed,286.0,7.25,222,64,64,0,222,286,37,0,249,286,28,0,258,286,0,0,286,286,17,6,263,286
8905084,1757,460300,new-0.0,completed,265.0,7.3,225,40,10,0,255,265,28,0,237,265,0,0,265,265,40,0,225,265,26,0,239,265
8905084,1757,460300,new-0.5,completed,276.0,7.45,227,49,13,0,263,276,49,0,227,276,27,0,249,276,39,0,237,276,0,0,276,276
8905084,1757,460300,new-1.0,completed,287.0,7.5,231,56,47,0,240,287,17,0,270,287,0,0,287,287,52,4,231,287,44,0,243,287
8905084,1757,309704,base,completed,286.0,7.05,203,83,0,39,247,286,51,0,235,286,7,1,278,286,58,0,228,286,19,24,243,286
8905084,1757,309704,base+,completed,267.0,6.95,219,48,5,0,262,267,11,0,256,267,0,0,267,267,48,0,219,267,36,0,231,267
8905084,1757,309704,dpv1,completed,303.0,7.15,222,81,0,0,303,303,43,21,239,303,50,0,253,303,64,0,239,303,52,0,251,303
8905084,1757,309704,dpv2,completed,275.0,7.2,219,56,0,0,275,275,26,0,249,275,30,0,245,275,13,0,262,275,56,0,219,275
8905084,1757,309704,new-0.0,completed,259.0,7.3,224,35,17,0,242,259,5,0,254,259,0,0,259,259,35,0,224,259,33,0,226,259
8905084,1757,309704,new-0.5,completed,265.0,7.45,222,43,5,0,260,265,43,0,222,265,11,0,254,265,39,0,226,265,0,0,265,265
8905084,1757,309704,new-1.0,completed,273.0,7.6,224,49,37,0,236,273,43,0,230,273,20,0,253,273,0,6,267,273,18,0,255,273
8905084,1757,247588,base,completed,283.0,7.1,206,77,24,0,259,283,0,0,283,283,71,0,212,283,22,0,261,283,18,44,221,283
8905084,1757,247588,base+,completed,277.0,7.05,210,67,0,0,277,277,67,0,210,277,39,0,238,277,14,6,257,277,22,0,255,277
8905084,1757,247588,dpv1,completed,288.0,7.25,225,63,60,0,228,288,48,0,240,288,44,0,244,288,0,0,288,288,48,3,237,288
8905084,1757,247588,dpv2,completed,264.0,7.45,201,63,43,0,221,264,28,0,236,264,19,0,245,264,3,0,261,264,0,20,244,264
8905084,1757,247588,new-0.0,completed,267.0,7.3,207,60,40,0,227,267,26,8,233,267,0,0,267,267,52,0,215,267,41,0,226,267
8905084,1757,247588,new-0.5,completed,270.0,7.55,215,55,0,0,270,270,26,0,244,270,10,0,260,270,38,0,232,270,55,0,215,270
8905084,1757,247588,new-1.0,completed,264.0,7.55,228,36,21,0,243,264,31,0,233,264,0,0,264,264,28,0,236,264,7,5,252,264
8905084,1757,203195,base,completed,308.0,7.0,195,113,38,0,270,308,0,98,210,308,27,0,281,308,68,0,240,308,7,0,301,308
8905084,1757,203195,base+,completed,288.0,6.9,216,72,11,13,264,288,72,0,216,288,16,0,272,288,42,0,246,288,0,0,288,288
8905084,1757,203195,dpv1,completed,304.0,7.1,151,153,0,69,235,304,4,36,264,304,21,0,283,304,41,53,210,304,50,0,254,304
8905084,1757,203195,dpv2,completed,281.0,7.2,214,67,0,0,281,281,27,0,254,281,20,0,261,281,67,0,214,281,43,0,238,281
8905084,1757,203195,new-0.0,completed,277.0,7.3,220,57,27,0,250,277,29,0,248,277,0,0,277,277,57,0,220,277,55,0,222,277
8905084,1757,203195,new-0.5,completed,257.0,7.55,217,40,2,0,255,257,0,0,257,257,13,0,244,257,40,0,217,257,19,0,238,257
8905084,1757,203195,new-1.0,completed,279.0,7.55,212,67,38,0,241,279,48,0,231,279,20,0,259,279,16,8,255,279,0,11,268,279
8905084,1757,178029,base,completed,275.0,7.0,218,57,15,0,260,275,32,0,243,275,0,0,275,275,57,0,218,275,46,0,229,275
8905084,1757,178029,base+,completed,306.0,6.85,224,82,61,0,245,306,60,0,246,306,61,0,245,306,50,21,235,306,0,0,306,306
8905084,1757,178029,dpv1,completed,281.0,7.25,220,61,29,0,252,281,61,0,220,281,22,11,248,281,23,0,258,281,0,0,281,281
8905084,1757,178029,dpv2,completed,275.0,7.5,211,64,8,0,267,275,0,0,275,275,64,0,211,275,2,17,256,275,45,0,230,275
8905084,1757,178029,new-0.0,completed,267.0,7.3,213,54,28,0,239,267,29,0,238,267,0,0,267,267,54,0,213,267,27,0,240,267
8905084,1757,178029,new-0.5,completed,273.0,7.45,232,41,0,0,273,273,39,0,234,273,23,0,250,273,41,0,232,273,18,0,255,273
8905084,1757,178029,new-1.0,completed,278.0,7.45,223,55,31,0,247,278,23,0,255,278,19,0,259,278,53,0,225,278,0,2,276,278
8905084,1757,239735,base,completed,279.0,6.75,207,72,41,0,238,279,0,0,279,279,15,39,225,279,22,0,257,279,1,0,278,279
8905084,1757,239735,base+,completed,286.0,7.05,183,103,38,8,240,286,0,58,228,286,51,0,235,286,1,22,263,286,6,0,280,286
8905084,1757,239735,dpv1,completed,285.0,7.15,180,105,21,0,264,285,44,26,215,285,54,0,231,285,10,25,250,285,0,24,261,285
8905084,1757,239735,dpv2,completed,274.0,7.2,216,58,18,0,256,274,0,0,274,274,58,0,216,274,58,0,216,274,14,3,257,274
8905084,1757,239735,new-0.0,completed,265.0,7.3,220,45,23,0,242,265,45,0,220,265,0,0,265,265,42,0,223,265,24,0,241,265
8905084,1757,239735,new-0.5,completed,255.0,7.45,217,38,11,0,244,255,38,0,217,255,18,0,237,255,32,0,223,255,0,0,255,255
8905084,1757,239735,new-1.0,completed,263.0,7.55,210,53,40,0,223,263,12,2,249,263,21,0,242,263,19,0,244,263,0,11,252,263
8905084,1757,675528,base,completed,286.0,7.1,212,74,0,0,286,286,25,0,261,286,74,0,212,286,34,1,251,286,41,0,245,286
8905084,1757,675528,base+,completed,271.0,6.9,230,41,0,0,271,271,19,0,252,271,33,0,238,271,28,0,243,271,34,7,230,271
8905084,1757,675528,dpv1,completed,292.0,7.35,217,75,45,0,247,292,41,4,247,292,75,0,217,292,35,0,257,292,0,0,292,292
8905084,1757,675528,dpv2,completed,283.0,7.3,245,38,0,0,283,283,30,0,253,283,35,0,248,283,38,0,245,283,21,0,262,283
8905084,1757,675528,new-0.0,completed,267.0,7.3,237,30,30,0,237,267,20,0,247,267,0,0,267,267,27,0,240,267,21,0,246,267
8905084,1757,675528,new-0.5,completed,282.0,7.45,236,46,46,0,236,282,43,0,239,282,27,0,255,282,37,0,245,282,0,0,282,282
8905084,1757,675528,new-1.0,completed,270.0,7.55,209,61,45,0,225,270,15,0,255,270,0,0,270,270,29,7,234,270,4,9,257,270
8905084,1757,380692,base,completed,298.0,6.9,180,118,23,0,275,298,8,0,290,298,34,45,219,298,0,95,203,298,43,0,255,298
8905084,1757,380692,base+,completed,263.0,7.0,209,54,13,0,250,263,0,0,263,263,54,0,209,263,15,0,248,263,26,0,237,263
8905084,1757,380692,dpv1,completed,274.0,7.25,230,44,39,0,235,274,0,0,274,274,24,0,250,274,0,0,274,274,44,0,230,274
8905084,1757,380692,dpv2,completed,292.0,7.15,226,66,21,0,271,292,44,0,248,292,54,0,238,292,0,0,292,292,66,0,226,292
8905084,1757,380692,new-0.0,completed,264.0,7.3,229,35,28,0,236,264,24,4,236,264,0,0,264,264,31,0,233,264,28,0,236,264
8905084,1757,380692,new-0.5,completed,257.0,7.55,213,44,0,0,257,257,8,0,249,257,14,8,235,257,23,0,234,257,36,0,221,257
8905084,1757,380692,new-1.0,completed,270.0,7.5,230,40,38,0,232,270,8,0,262,270,0,0,270,270,33,0,237,270,22,2,246,270
6518981,1763,310811,base,completed,340.0,6.75,98,242,23,0,317,340,23,0,317,340,19,55,266,340,0,126,214,340,34,117,189,340
6518981,1763,310811,base+,completed,316.0,6.9,158,158,14,0,302,316,51,21,244,316,0,17,299,316,57,43,216,316,50,54,212,316
6518981,1763,310811,dpv1,completed,332.0,7.1,104,228,5,49,278,332,26,125,181,332,40,0,292,332,25,19,288,332,0,118,214,332
6518981,1763,310811,dpv2,completed,328.0,7.25,115,213,32,0,296,328,21,49,258,328,14,77,237,328,0,148,180,328,21,4,303,328
6518981,1763,310811,new-0.0,completed,314.0,6.85,153,161,32,38,244,314,0,57,257,314,40,19,255,314,43,11,260,314,71,8,235,314
6518981,1763,310811,new-0.5,completed,305.0,7.2,215,90,25,0,280,305,0,45,260,305,32,19,254,305,69,0,236,305,46,5,254,305
6518981,1763,310811,new-1.0,completed,327.0,7.4,102,225,47,63,217,327,12,8,307,327,0,80,247,327,74,0,253,327,62,33,232,327
6518981,1763,208428,base,completed,388.0,6.85,134,254,38,169,181,388,25,0,363,388,0,160,228,388,3,7,378,388,46,198,144,388
6518981,1763,208428,base+,completed,314.0,7.2,123,191,40,94,180,314,25,25,264,314,4,64,246,314,40,0,274,314,0,0,314,314
6518981,1763,208428,dpv1,completed,324.0,7.2,127,197,26,42,256,324,22,109,193,324,0,86,238,324,40,0,284,324,25,26,273,324
6518981,1763,208428,dpv2,completed,336.0,7.2,118,218,24,0,312,336,34,64,238,336,26,62,248,336,0,156,180,336,57,7,272,336
6518981,1763,208428,new-0.0,completed,320.0,6.85,147,173,32,39,249,320,0,61,259,320,37,22,261,320,48,7,265,320,72,13,235,320
6518981,1763,208428,new-0.5,completed,287.0,7.2,216,71,49,2,236,287,19,13,255,287,26,0,261,287,0,30,257,287,32,0,255,287
6518981,1763,208428,new-1.0,completed,321.0,7.45,134,187,45,45,231,321,56,5,260,321,0,54,267,321,13,10,298,321,71,22,228,321
6518981,1763,460300,base,completed,394.0,6.9,90,304,31,241,122,394,47,64,283,394,27,6,361,394,65,0,329,394,0,202,192,394
6518981,1763,460300,base+,completed,297.0,6.95,190,107,39,0,258,297,14,54,229,297,42,0,255,297,49,14,234,297,0,0,297,297
6518981,1763,460300,dpv1,completed,339.0,7.15,118,221,19,37,283,339,0,134,205,339,31,72,236,339,33,22,284,339,3,77,259,339
6518981,1763,460300,dpv2,completed,314.0,7.15,154,160,41,0,273,314,23,3,288,314,0,51,263,314,30,116,168,314,25,30,259,314
6518981,1763,460300,new-0.0,completed,318.0,6.9,162,156,71,0,247,318,0,56,262,318,30,37,251,318,34,35,249,318,47,0,271,318
6518981,1763,460300,new-0.5,completed,305.0,7.3,205,100,0,50,255,305,63,0,242,305,49,5,251,305,34,29,242,305,27,6,272,305
6518981,1763,460300,new-1.0,completed,301.0,7.35,156,145,31,54,216,301,22,0,279,301,4,0,297,301,34,28,239,301,0,32,269,301
6518981,1763,309704,base,completed,288.0,6.85,130,158,3,0,285,288,22,104,162,288,11,0,277,288,0,32,256,288,15,0,273,288
6518981,1763,309704,base+,completed,298.0,6.85,192,106,38,3,257,298,10,0,288,298,28,55,215,298,48,0,250,298,0,40,258,298
6518981,1763,309704,dpv1,completed,351.0,7.15,99,252,0,78,273,351,7,152,192,351,29,52,270,351,31,80,240,351,25,35,291,351
6518981,1763,309704,dpv2,completed,300.0,7.2,141,159,36,32,232,300,41,50,209,300,0,0,300,300,6,0,294,300,7,67,226,300
6518981,1763,309704,new-0.0,completed,326.0,7.05,159,167,0,68,258,326,84,0,242,326,27,43,256,326,58,7,261,326,25,51,250,326
6518981,1763,309704,new-0.5,completed,297.0,7.05,222,75,65,0,232,297,0,22,275,297,28,0,269,297,38,0,259,297,31,12,254,297
6518981,1763,309704,new-1.0,completed,351.0,7.4,131,220,88,43,220,351,108,0,243,351,0,77,274,351,12,74,265,351,60,12,279,351
6518981,1763,247588,base,completed,391.0,7.0,107,284,0,91,300,391,28,191,172,391,40,44,307,391,26,173,192,391,31,60,300,391
6518981,1763,247588,base+,completed,299.0,7.15,184,115,22,0,277,299,28,7,264,299,68,26,205,299,0,28,271,299,25,42,232,299
6518981,1763,247588,dpv1,completed,336.0,7.15,115,221,21,36,279,336,6,145,185,336,0,95,241,336,26,28,282,336,30,61,245,336
6518981,1763,247588,dpv2,completed,307.0,7.25,164,143,18,0,289,307,0,107,200,307,24,34,249,307,14,45,248,307,38,10,259,307
6518981,1763,247588,new-0.0,completed,301.0,7.15,155,146,23,37,241,301,58,0,243,301,34,19,248,301,0,68,233,301,31,5,265,301
6518981,1763,247588,new-0.5,completed,291.0,7.3,211,80,24,0,267,291,58,0,233,291,44,8,239,291,25,23,243,291,0,32,259,291
6518981,1763,247588,new-1.0,completed,280.0,7.35,192,88,35,32,213,280,38,10,232,280,0,0,280,280,29,0,251,280,25,8,247,280
6518981,1763,203195,base,completed,398.0,7.05,117,281,7,225,166,398,22,207,169,398,0,18,380,398,33,0,365,398,22,190,186,398
6518981,1763,203195,base+,completed,307.0,6.8,178,129,40,4,263,307,42,33,232,307,32,0,275,307,46,46,215,307,0,0,307,307
6518981,1763,203195,dpv1,completed,370.0,7.0,95,275,36,77,257,370,49,136,185,370,25,61,284,370,0,122,248,370,70,0,300,370
6518981,1763,203195,dpv2,completed,324.0,7.2,114,210,35,0,289,324,18,89,217,324,14,0,310,324,0,135,189,324,26,45,253,324
6518981,1763,203195,new-0.0,completed,313.0,7.0,152,161,28,27,258,313,79,38,196,313,0,33,280,313,24,39,250,313,62,5,246,313
6518981,1763,203195,new-0.5,completed,294.0,7.3,209,85,29,1,264,294,32,7,255,294,52,0,242,294,36,19,239,294,0,37,257,294
6518981,1763,203195,new-1.0,completed,297.0,7.3,192,105,32,23,242,297,2,0,295,297,0,42,255,297,39,16,242,297,39,0,258,297
6518981,1763,178029,base,completed,303.0,7.05,165,138,36,0,267,303,0,0,303,303,20,55,228,303,2,105,196,303,25,0,278,303
6518981,1763,178029,base+,completed,304.0,6.95,180,124,0,0,304,304,19,35,250,304,38,0,266,304,44,33,227,304,33,31,240,304
6518981,1763,178029,dpv1,completed,329.0,7.15,119,210,42,43,244,329,23,114,192,329,0,121,208,329,6,0,323,329,25,22,282,329
6518981,1763,178029,dpv2,completed,334.0,6.9,115,219,0,11,323,334,51,0,283,334,19,109,206,334,38,169,127,334,12,0,322,334
6518981,1763,178029,new-0.0,completed,312.0,7.1,158,154,26,41,245,312,57,0,255,312,26,28,258,312,0,70,242,312,43,10,259,312
6518981,1763,178029,new-0.5,completed,287.0,7.2,217,70,48,0,239,287,25,0,262,287,0,20,267,287,26,22,239,287,25,0,262,287
6518981,1763,178029,new-1.0,completed,333.0,7.4,128,205,51,51,231,333,0,12,321,333,3,73,257,333,62,0,271,333,85,21,227,333
6518981,1763,239735,base,completed,337.0,7.1,102,235,0,64,273,337,24,104,209,337,58,47,232,337,34,25,278,337,25,61,251,337
6518981,1763,239735,base+,completed,327.0,6.95,109,218,16,113,198,327,22,60,245,327,9,25,293,327,38,41,248,327,0,84,243,327
6518981,1763,239735,dpv1,completed,340.0,7.05,100,240,13,65,262,340,0,147,193,340,19,48,273,340,38,32,270,340,39,74,227,340
6518981,1763,239735,dpv2,completed,319.0,7.2,159,160,26,59,234,319,42,0,277,319,74,17,228,319,38,41,240,319,0,47,272,319
6518981,1763,239735,new-0.0,completed,299.0,7.05,164,135,22,33,244,299,57,0,242,299,30,14,255,299,36,2,261,299,0,66,233,299
6518981,1763,239735,new-0.5,completed,291.0,7.3,206,85,25,4,262,291,40,0,251,291,64,0,227,291,0,41,250,291,39,16,236,291
6518981,1763,239735,new-1.0,completed,311.0,7.4,126,185,43,39,229,311,68,0,243,311,0,53,258,311,74,0,237,311,15,27,269,311
6518981,1763,675528,base,completed,328.0,6.9,150,178,18,102,208,328,2,25,301,328,0,113,215,328,48,1,279,328,54,0,274,328
6518981,1763,675528,base+,completed,341.0,6.95,134,207,18,92,231,341,40,0,301,341,24,79,238,341,0,101,240,341,27,52,262,341
6518981,1763,675528,dpv1,completed,318.0,7.2,127,191,30,41,247,318,14,106,198,318,0,87,231,318,24,12,282,318,22,18,278,318
6518981,1763,675528,dpv2,completed,333.0,7.05,110,223,22,24,287,333,53,0,280,333,49,0,284,333,13,195,125,333,0,29,304,333
6518981,1763,675528,new-0.0,completed,303.0,7.0,174,129,0,62,241,303,26,26,251,303,23,26,254,303,36,0,267,303,57,0,246,303
6518981,1763,675528,new-0.5,completed,291.0,7.2,208,83,34,0,257,291,18,31,242,291,21,0,270,291,0,45,246,291,59,2,230,291
6518981,1763,675528,new-1.0,completed,289.0,7.3,182,107,0,26,263,289,4,0,285,289,37,43,209,289,34,18,237,289,29,0,260,289
6518981,1763,380692,base,completed,295.0,6.95,138,157,0,109,186,295,31,21,243,295,16,0,279,295,23,0,272,295,50,0,245,295
6518981,1763,380692,base+,completed,356.0,6.9,119,237,29,63,264,356,29,129,198,356,49,74,233,356,0,88,268,356,24,32,300,356
6518981,1763,380692,dpv1,completed,336.0,7.0,140,196,29,31,276,336,26,109,201,336,47,0,289,336,37,58,241,336,0,80,256,336
6518981,1763,380692,dpv2,completed,292.0,6.95,145,147,35,50,207,292,23,0,269,292,14,0,278,292,0,47,245,292,43,7,242,292
6518981,1763,380692,new-0.0,completed,314.0,7.1,151,163,24,37,253,314,67,0,247,314,47,16,251,314,0,89,225,314,25,18,271,314
6518981,1763,380692,new-0.5,completed,300.0,7.05,207,93,65,0,235,300,0,38,262,300,30,0,270,300,39,0,261,300,37,26,237,300
6518981,1763,380692,new-1.0,completed,332.0,7.4,135,197,85,31,216,332,81,0,251,332,0,66,266,332,86,0,246,332,10,42,280,332
1200389,1608,310811,base,completed,304.0,7.35,170,134,104,3,197,304,73,0,231,304,0,45,259,304,46,0,258,304,77,30,197,304
1200389,1608,310811,base+,completed,291.0,7.4,195,96,0,35,256,291,92,0,199,291,39,0,252,291,52,0,239,291,76,4,211,291
1200389,1608,310811,dpv1,completed,290.0,7.6,193,97,0,43,247,290,34,0,256,290,91,0,199,290,97,0,193,290,43,0,247,290
1200389,1608,310811,dpv2,completed,281.0,7.85,160,121,0,31,250,281,63,43,175,281,70,0,211,281,43,15,223,281,34,0,247,281
1200389,1608,310811,new-0.0,completed,237.0,7.4,198,39,8,0,229,237,0,0,237,237,31,0,206,237,6,0,231,237,39,0,198,237
1200389,1608,310811,new-0.5,completed,256.0,7.85,179,77,25,0,231,256,17,0,239,256,41,10,205,256,0,19,237,256,41,7,208,256
1200389,1608,310811,new-1.0,completed,278.0,7.95,190,88,38,0,240,278,59,22,197,278,0,0,278,278,63,0,215,278,65,1,212,278
1200389,1608,208428,base,completed,300.0,7.25,169,131,0,82,218,300,87,0,213,300,51,19,230,300,20,0,280,300,85,0,215,300
1200389,1608,208428,base+,completed,284.0,7.25,147,137,16,0,268,284,0,46,238,284,36,56,192,284,64,18,202,284,37,0,247,284
1200389,1608,208428,dpv1,completed,280.0,7.65,198,82,74,0,206,280,0,26,254,280,44,0,236,280,37,0,243,280,82,0,198,280
1200389,1608,208428,dpv2,completed,281.0,7.85,168,113,0,33,248,281,61,40,180,281,54,0,227,281,37,13,231,281,32,0,249,281
1200389,1608,208428,new-0.0,completed,251.0,7.25,189,62,30,0,221,251,34,0,217,251,23,0,228,251,62,0,189,251,0,6,245,251
1200389,1608,208428,new-0.5,completed,272.0,8.0,201,71,46,0,226,272,54,7,211,272,0,1,271,272,63,0,209,272,48,0,224,272
1200389,1608,208428,new-1.0,completed,265.0,7.95,169,96,0,22,243,265,48,10,207,265,16,0,249,265,62,3,200,265,1,35,229,265
1200389,1608,460300,base,completed,303.0,7.45,164,139,69,1,233,303,0,59,244,303,92,0,211,303,40,23,240,303,55,13,235,303
1200389,1608,460300,base+,completed,298.0,7.15,183,115,0,55,243,298,35,7,256,298,50,0,248,298,61,13,224,298,95,0,203,298
1200389,1608,460300,dpv1,completed,283.0,7.75,194,89,42,0,241,283,38,0,245,283,89,0,194,283,82,0,201,283,0,32,251,283
1200389,1608,460300,dpv2,completed,304.0,7.75,165,139,82,0,222,304,62,0,242,304,0,63,241,304,72,44,188,304,46,0,258,304
1200389,1608,460300,new-0.0,completed,248.0,7.4,189,59,0,14,234,248,21,2,225,248,17,0,231,248,23,0,225,248,52,0,196,248
1200389,1608,460300,new-0.5,completed,259.0,8.0,208,51,35,0,224,259,48,0,211,259,22,0,237,259,47,3,209,259,0,0,259,259
1200389,1608,460300,new-1.0,completed,276.0,7.95,180,96,36,0,240,276,41,29,206,276,0,0,276,276,43,0,233,276,67,0,209,276
1200389,1608,309704,base,completed,316.0,7.15,160,156,34,39,243,316,66,42,208,316,0,90,226,316,83,0,233,316,54,39,223,316
1200389,1608,309704,base+,completed,289.0,7.5,163,126,59,0,230,289,49,22,218,289,86,0,203,289,0,51,238,289,37,10,242,289
1200389,1608,309704,dpv1,completed,295.0,7.65,192,103,89,0,206,295,0,49,246,295,43,0,252,295,43,0,252,295,103,0,192,295
1200389,1608,309704,dpv2,completed,289.0,7.75,172,117,74,0,215,289,39,0,250,289,0,34,255,289,69,36,184,289,42,16,231,289
1200389,1608,309704,new-0.0,completed,247.0,7.4,191,56,30,0,217,247,0,0,247,247,31,0,216,247,35,0,212,247,56,0,191,247
1200389,1608,309704,new-0.5,completed,266.0,7.9,200,66,39,0,227,266,56,0,210,266,46,0,220,266,0,11,255,266,50,0,216,266
1200389,1608,309704,new-1.0,completed,280.0,7.8,191,89,0,31,249,280,68,8,204,280,65,0,215,280,59,0,221,280,28,0,252,280
1200389,1608,247588,base,completed,286.0,7.45,171,115,40,28,218,286,49,0,237,286,27,0,259,286,0,28,258,286,87,0,199,286
1200389,1608,247588,base+,completed,288.0,7.2,158,130,57,45,186,288,85,0,203,288,0,56,232,288,32,0,256,288,43,0,245,288
1200389,1608,247588,dpv1,completed,284.0,7.65,195,89,78,0,206,284,0,44,240,284,37,0,247,284,54,0,230,284,76,0,208,284
1200389,1608,247588,dpv2,completed,281.0,7.7,161,120,51,48,182,281,31,0,250,281,67,0,214,281,0,32,249,281,40,10,231,281
1200389,1608,247588,new-0.0,completed,257.0,7.45,187,70,41,0,216,257,46,0,211,257,31,0,226,257,0,19,238,257,62,0,195,257
1200389,1608,247588,new-0.5,completed,263.0,8.0,197,66,40,0,223,263,55,0,208,263,39,0,224,263,35,0,228,263,0,20,243,263
1200389,1608,247588,new-1.0,completed,261.0,7.95,194,67,33,0,228,261,46,13,202,261,44,0,217,261,0,0,261,261,54,0,207,261
1200389,1608,203195,base,completed,283.0,7.2,154,129,0,45,238,283,20,0,263,283,60,41,182,283,41,0,242,283,88,0,195,283
1200389,1608,203195,base+,completed,299.0,7.4,189,110,84,0,215,299,42,0,257,299,50,15,234,299,80,0,219,299,0,46,253,299
1200389,1608,203195,dpv1,completed,292.0,7.5,176,116,86,0,206,292,43,0,249,292,62,0,230,292,56,0,236,292,0,67,225,292
1200389,1608,203195,dpv2,completed,293.0,7.75,165,128,49,0,244,293,68,0,225,293,63,39,191,293,39,22,232,293,0,45,248,293
1200389,1608,203195,new-0.0,completed,233.0,7.45,193,40,13,0,220,233,9,0,224,233,16,0,217,233,0,0,233,233,40,0,193,233
1200389,1608,203195,new-0.5,completed,283.0,7.8,202,81,39,0,244,283,57,0,226,283,79,0,204,283,0,35,248,283,74,1,208,283
1200389,1608,203195,new-1.0,completed,293.0,7.85,168,125,30,0,263,293,79,46,168,293,72,0,221,293,76,0,217,293,0,32,261,293
1200389,1608,178029,base,completed,278.0,7.45,166,112,0,51,227,278,36,8,234,278,44,10,224,278,42,0,236,278,78,0,200,278
1200389,1608,178029,base+,completed,290.0,7.25,165,125,66,0,224,290,0,62,228,290,40,0,250,290,99,0,191,290,32,17,241,290
1200389,1608,178029,dpv1,completed,287.0,7.7,179,108,67,21,199,287,54,0,233,287,87,0,200,287,42,4,241,287,0,38,249,287
1200389,1608,178029,dpv2,completed,289.0,7.7,170,119,64,0,225,289,40,0,249,289,53,49,187,289,0,39,250,289,38,8,243,289
1200389,1608,178029,new-0.0,completed,248.0,7.25,194,54,0,7,241,248,20,0,228,248,18,0,230,248,14,5,229,248,46,0,202,248
1200389,1608,178029,new-0.5,completed,264.0,7.85,190,74,32,0,232,264,29,0,235,264,42,6,216,264,0,9,255,264,47,12,205,264
1200389,1608,178029,new-1.0,completed,273.0,7.9,150,123,0,11,262,273,10,61,202,273,18,2,253,273,60,0,213,273,58,0,215,273
1200389,1608,239735,base,completed,300.0,7.35,193,107,69,10,221,300,0,53,247,300,70,0,230,300,107,0,193,300,35,0,265,300
1200389,1608,239735,base+,completed,295.0,7.3,196,99,94,0,201,295,0,50,245,295,88,0,207,295,44,0,251,295,48,0,247,295
1200389,1608,239735,dpv1,completed,283.0,7.65,187,96,79,0,204,283,40,0,243,283,95,0,188,283,0,49,234,283,44,0,239,283
1200389,1608,239735,dpv2,completed,257.0,7.85,181,76,26,0,231,257,63,0,194,257,0,23,234,257,44,3,210,257,35,0,222,257
1200389,1608,239735,new-0.0,completed,246.0,7.45,193,53,37,0,209,246,30,0,216,246,21,0,225,246,0,7,239,246,46,0,200,246
1200389,1608,239735,new-0.5,completed,281.0,7.8,186,95,38,0,243,281,37,0,244,281,86,0,195,281,0,46,235,281,74,4,203,281
1200389,1608,239735,new-1.0,completed,258.0,7.95,190,68,17,0,241,258,43,23,192,258,38,0,220,258,45,0,213,258,0,0,258,258
1200389,1608,675528,base,completed,284.0,7.05,165,119,23,0,261,284,69,4,211,284,43,0,241,284,86,0,198,284,0,74,210,284
1200389,1608,675528,base+,completed,293.0,7.2,173,120,0,46,247,293,98,0,195,293,43,5,245,293,67,17,209,293,36,0,257,293
1200389,1608,675528,dpv1,completed,294.0,7.7,199,95,92,0,202,294,51,0,243,294,0,38,256,294,85,0,209,294,47,0,247,294
1200389,1608,675528,dpv2,completed,293.0,7.75,167,126,65,0,228,293,54,0,239,293,0,39,254,293,65,42,186,293,40,9,244,293
1200389,1608,675528,new-0.0,completed,242.0,7.4,189,53,14,0,228,242,0,6,236,242,22,0,220,242,10,0,232,242,47,0,195,242
1200389,1608,675528,new-0.5,completed,261.0,7.9,203,58,28,0,233,261,45,0,216,261,42,0,219,261,0,13,248,261,33,0,228,261
1200389,1608,675528,new-1.0,completed,277.0,7.8,181,96,0,32,245,277,62,12,203,277,63,3,211,277,65,0,212,277,30,0,247,277
1200389,1608,380692,base,completed,272.0,7.35,159,113,46,0,226,272,0,55,217,272,30,0,242,272,73,0,199,272,44,6,222,272
1200389,1608,380692,base+,completed,282.0,7.2,185,97,27,8,247,282,38,0,244,282,0,38,244,282,89,0,193,282,59,0,223,282
1200389,1608,380692,dpv1,completed,293.0,7.55,197,96,85,0,208,293,57,0,236,293,37,0,256,293,82,0,211,293,0,52,241,293
1200389,1608,380692,dpv2,completed,274.0,7.9,178,96,35,0,239,274,44,0,230,274,60,0,214,274,46,9,219,274,0,37,237,274
1200389,1608,380692,new-0.0,completed,246.0,7.4,186,60,24,0,222,246,0,8,238,246,24,0,222,246,17,0,229,246,60,0,186,246
1200389,1608,380692,new-0.5,completed,265.0,7.9,206,59,50,0,215,265,59,0,206,265,54,0,211,265,0,0,265,265,40,0,225,265
1200389,1608,380692,new-1.0,completed,281.0,7.7,151,130,24,0,257,281,12,53,216,281,0,21,260,281,60,13,208,281,57,0,224,281
1917015,1643,310811,base,completed,296.0,6.8,171,125,20,74,202,296,51,13,232,296,0,0,296,296,34,0,262,296,48,44,204,296
1917015,1643,310811,base+,completed,265.0,6.85,178,87,5,17,243,265,41,0,224,265,0,30,235,265,11,0,254,265,11,0,254,265
1917015,1643,310811,dpv1,completed,281.0,7.1,115,166,36,0,245,281,39,0,242,281,57,0,224,281,3,0,278,281,0,110,171,281
1917015,1643,310811,dpv2,completed,329.0,7.4,124,205,68,95,166,329,0,157,172,329,32,42,255,329,12,0,317,329,72,0,257,329
1917015,1643,310811,new-0.0,completed,262.0,7.05,211,51,48,0,214,262,41,0,221,262,0,0,262,262,31,0,231,262,51,0,211,262
1917015,1643,310811,new-0.5,completed,253.0,7.55,210,43,33,0,220,253,0,3,250,253,19,0,234,253,12,0,241,253,34,6,213,253
1917015,1643,310811,new-1.0,completed,285.0,7.4,150,135,62,21,202,285,75,0,210,285,23,0,262,285,0,0,285,285,28,39,218,285
1917015,1643,208428,base,completed,331.0,6.85,132,199,61,23,247,331,89,0,242,331,0,59,272,331,35,20,276,331,74,95,162,331
1917015,1643,208428,base+,completed,378.0,6.95,135,243,27,8,343,378,34,68,276,378,66,136,176,378,102,42,234,378,0,191,187,378
1917015,1643,208428,dpv1,completed,279.0,7.2,158,121,0,2,277,279,52,0,227,279,32,0,247,279,28,59,192,279,62,0,217,279
1917015,1643,208428,dpv2,completed,309.0,7.5,138,171,26,54,229,309,0,124,185,309,59,8,242,309,30,18,261,309,14,23,272,309
1917015,1643,208428,new-0.0,completed,274.0,7.1,203,71,0,24,250,274,33,0,241,274,12,0,262,274,64,0,210,274,34,7,233,274
1917015,1643,208428,new-0.5,completed,272.0,7.5,194,78,35,0,237,272,0,23,249,272,60,0,212,272,33,0,239,272,60,6,206,272
1917015,1643,208428,new-1.0,completed,281.0,7.55,153,128,25,0,256,281,34,15,232,281,58,26,197,281,35,0,246,281,0,37,244,281
1917015,1643,460300,base,completed,345.0,7.1,145,200,39,117,189,345,78,74,193,345,66,92,187,345,0,30,315,345,34,0,311,345
1917015,1643,460300,base+,completed,296.0,6.8,123,173,3,74,219,296,58,0,238,296,12,44,240,296,33,2,261,296,0,46,250,296
1917015,1643,460300,dpv1,completed,299.0,7.15,114,185,62,0,237,299,8,0,291,299,77,0,222,299,31,0,268,299,0,137,162,299
1917015,1643,460300,dpv2,completed,308.0,7.4,144,164,0,125,183,308,0,0,308,308,38,27,243,308,49,13,246,308,27,50,231,308
1917015,1643,460300,new-0.0,completed,257.0,7.05,187,70,5,0,252,257,47,0,210,257,33,1,223,257,25,0,232,257,0,25,232,257
1917015,1643,460300,new-0.5,completed,250.0,7.55,217,33,0,1,249,250,12,0,238,250,19,0,231,250,8,0,242,250,32,0,218,250
1917015,1643,460300,new-1.0,completed,298.0,7.55,127,171,17,0,281,298,63,47,188,298,64,0,234,298,0,0,298,298,27,60,211,298
1917015,1643,309704,base,completed,345.0,6.65,103,242,70,86,189,345,85,91,169,345,0,101,244,345,42,12,291,345,42,21,282,345
1917015,1643,309704,base+,completed,301.0,7.1,170,131,45,25,231,301,33,23,245,301,64,0,237,301,0,30,271,301,64,33,204,301
1917015,1643,309704,dpv1,completed,304.0,7.35,140,164,63,61,180,304,33,0,271,304,0,112,192,304,66,0,238,304,8,0,296,304
1917015,1643,309704,dpv2,completed,307.0,7.5,132,175,38,69,200,307,0,115,192,307,39,21,247,307,69,0,238,307,8,15,284,307
1917015,1643,309704,new-0.0,completed,272.0,7.05,198,74,59,0,213,272,22,0,250,272,44,0,228,272,0,19,253,272,72,0,200,272
1917015,1643,309704,new-0.5,completed,277.0,7.5,205,72,61,0,216,277,0,17,260,277,64,0,213,277,46,1,230,277,39,1,237,277
1917015,1643,309704,new-1.0,completed,282.0,7.45,146,136,57,19,206,282,14,0,268,282,62,0,220,282,0,0,282,282,21,55,206,282
1917015,1643,247588,base,completed,303.0,7.05,165,138,33,0,270,303,40,66,197,303,0,36,267,303,38,55,210,303,27,35,241,303
1917015,1643,247588,base+,completed,319.0,6.9,135,184,39,34,246,319,75,47,197,319,65,0,254,319,58,60,201,319,0,57,262,319
1917015,1643,247588,dpv1,completed,284.0,7.2,132,152,0,113,171,284,45,0,239,284,72,0,212,284,10,0,274,284,29,0,255,284
1917015,1643,247588,dpv2,completed,325.0,7.35,142,183,83,68,174,325,63,22,240,325,47,23,255,325,0,55,270,325,98,17,210,325
1917015,1643,247588,new-0.0,completed,258.0,7.1,203,55,24,0,234,258,24,0,234,258,42,0,216,258,0,0,258,258,55,0,203,258
1917015,1643,247588,new-0.5,completed,244.0,7.5,207,37,25,0,219,244,0,10,234,244,19,0,225,244,19,0,225,244,27,0,217,244
1917015,1643,247588,new-1.0,completed,264.0,7.5,158,106,48,16,200,264,16,11,237,264,0,0,264,264,26,0,238,264,59,20,185,264
1917015,1643,203195,base,completed,292.0,6.85,144,148,21,0,271,292,6,115,171,292,33,0,259,292,33,57,202,292,0,27,265,292
1917015,1643,203195,base+,completed,290.0,7.0,187,103,59,0,231,290,23,40,227,290,63,0,227,290,0,0,290,290,59,0,231,290
1917015,1643,203195,dpv1,completed,282.0,7.4,133,149,32,0,250,282,0,111,171,282,16,0,266,282,2,0,280,282,38,0,244,282
1917015,1643,203195,dpv2,completed,298.0,7.45,129,169,33,49,216,298,0,123,175,298,5,1,292,298,56,0,242,298,50,0,248,298
1917015,1643,203195,new-0.0,completed,267.0,7.0,199,68,40,0,227,267,0,28,239,267,24,0,243,267,30,0,237,267,39,0,228,267
1917015,1643,203195,new-0.5,completed,278.0,7.5,191,87,60,0,218,278,0,36,242,278,67,0,211,278,34,0,244,278,40,0,238,278
1917015,1643,203195,new-1.0,completed,267.0,7.45,175,92,38,19,210,267,13,0,254,267,7,0,260,267,0,9,258,267,26,26,215,267
1917015,1643,178029,base,completed,288.0,7.2,161,127,34,51,203,288,0,19,269,288,16,41,231,288,13,67,208,288,14,13,261,288
1917015,1643,178029,base+,completed,274.0,7.0,192,82,61,1,212,274,34,12,228,274,5,0,269,274,31,0,243,274,0,22,252,274
1917015,1643,178029,dpv1,completed,286.0,7.35,176,110,0,13,273,286,62,0,224,286,66,0,220,286,39,0,247,286,4,43,239,286
1917015,1643,178029,dpv2,completed,299.0,7.45,132,167,27,48,224,299,0,121,178,299,60,0,239,299,31,12,256,299,9,10,280,299
1917015,1643,178029,new-0.0,completed,264.0,6.95,203,61,0,10,254,264,25,0,239,264,30,0,234,264,51,0,213,264,48,0,216,264
1917015,1643,178029,new-0.5,completed,257.0,7.5,207,50,40,0,217,257,0,7,250,257,25,0,232,257,25,3,229,257,39,0,218,257
1917015,1643,178029,new-1.0,completed,277.0,7.6,127,150,0,0,277,277,26,0,251,277,16,40,221,277,1,15,261,277,43,53,181,277
1917015,1643,239735,base,completed,299.0,7.0,162,137,27,0,272,299,68,66,165,299,39,37,223,299,38,0,261,299,0,20,279,299
1917015,1643,239735,base+,completed,270.0,6.85,188,82,0,31,239,270,48,0,222,270,40,0,230,270,16,4,250,270,38,22,210,270
1917015,1643,239735,dpv1,completed,287.0,7.35,135,152,0,16,271,287,12,89,186,287,68,0,219,287,34,0,253,287,54,0,233,287
1917015,1643,239735,dpv2,completed,339.0,7.35,124,215,76,103,160,339,71,18,250,339,45,45,249,339,0,63,276,339,98,23,218,339
1917015,1643,239735,new-0.0,completed,259.0,7.05,183,76,61,0,198,259,16,0,243,259,28,1,230,259,0,20,239,259,46,0,213,259
1917015,1643,239735,new-0.5,completed,261.0,7.55,192,69,30,0,231,261,0,24,237,261,55,0,206,261,28,0,233,261,60,0,201,261
1917015,1643,239735,new-1.0,completed,293.0,7.4,126,167,64,26,203,293,78,0,215,293,31,0,262,293,0,2,291,293,32,64,197,293
1917015,1643,675528,base,completed,287.0,7.1,169,118,0,37,250,287,29,6,252,287,75,0,212,287,27,0,260,287,61,45,181,287
1917015,1643,675528,base+,completed,288.0,6.75,148,140,57,0,231,288,67,0,221,288,0,88,200,288,22,0,266,288,40,0,248,288
1917015,1643,675528,dpv1,completed,290.0,7.35,124,166,54,0,236,290,13,0,277,290,33,0,257,290,53,0,237,290,0,117,173,290
1917015,1643,675528,dpv2,completed,312.0,7.5,118,194,37,22,253,312,0,143,169,312,7,46,259,312,67,0,245,312,43,38,231,312
1917015,1643,675528,new-0.0,completed,265.0,7.05,204,61,52,0,213,265,0,9,256,265,24,0,241,265,39,0,226,265,40,0,225,265
1917015,1643,675528,new-0.5,completed,273.0,7.55,208,65,14,0,259,273,0,19,254,273,64,0,209,273,32,0,241,273,62,0,211,273
1917015,1643,675528,new-1.0,completed,287.0,7.55,186,101,0,0,287,287,65,3,219,287,43,0,244,287,26,22,239,287,73,6,208,287
1917015,1643,380692,base,completed,292.0,7.1,152,140,0,73,219,292,27,9,256,292,21,7,264,292,62,29,201,292,76,16,200,292
1917015,1643,380692,base+,completed,302.0,7.1,129,173,29,1,272,302,42,16,244,302,34,42,226,302,0,73,229,302,68,38,196,302
1917015,1643,380692,dpv1,completed,296.0,7.15,128,168,48,0,248,296,49,7,240,296,78,0,218,296,29,0,267,296,0,107,189,296
1917015,1643,380692,dpv2,completed,310.0,7.5,126,184,40,17,253,310,0,132,178,310,25,39,246,310,65,0,245,310,31,23,256,310
1917015,1643,380692,new-0.0,completed,261.0,7.0,197,64,33,0,228,261,12,0,249,261,0,15,246,261,30,0,231,261,60,0,201,261
1917015,1643,380692,new-0.5,completed,258.0,7.5,201,57,25,0,233,258,0,22,236,258,28,0,230,258,32,3,223,258,31,0,227,258
1917015,1643,380692,new-1.0,completed,269.0,7.5,157,112,30,30,209,269,7,0,262,269,23,0,246,269,0,14,255,269,43,25,201,269
3397477,1647,310811,base,completed,382.0,6.85,88,294,85,46,251,382,8,152,222,382,0,229,153,382,112,0,270,382,43,58,281,382
3397477,1647,310811,base+,completed,279.0,6.75,179,100,0,0,279,279,8,27,244,279,28,16,235,279,57,0,222,279,50,0,229,279
3397477,1647,310811,dpv1,completed,313.0,7.25,159,154,91,0,222,313,0,30,283,313,70,40,203,313,37,51,225,313,1,80,232,313
3397477,1647,310811,dpv2,completed,352.0,7.4,86,266,86,150,116,352,43,0,309,352,13,27,312,352,55,131,166,352,0,62,290,352
3397477,1647,310811,new-0.0,completed,271.0,6.9,159,112,0,39,232,271,67,0,204,271,10,29,232,271,45,5,221,271,8,0,263,271
3397477,1647,310811,new-0.5,completed,267.0,7.4,142,125,39,35,193,267,16,15,236,267,0,0,267,267,64,2,201,267,8,13,246,267
3397477,1647,310811,new-1.0,completed,336.0,7.35,103,233,48,30,258,336,89,0,247,336,58,78,200,336,59,37,240,336,0,100,236,336
3397477,1647,208428,base,completed,347.0,6.7,169,178,10,87,250,347,46,42,259,347,114,18,215,347,80,35,232,347,0,58,289,347
3397477,1647,208428,base+,completed,342.0,6.85,94,248,45,32,265,342,0,100,242,342,82,120,140,342,3,50,289,342,64,19,259,342
3397477,1647,208428,dpv1,completed,336.0,7.25,163,173,84,60,192,336,108,0,228,336,19,31,286,336,49,26,261,336,0,106,230,336
3397477,1647,208428,dpv2,completed,339.0,7.4,84,255,62,157,120,339,34,0,305,339,14,11,314,339,39,145,155,339,0,43,296,339
3397477,1647,208428,new-0.0,completed,295.0,7.1,161,134,54,13,228,295,88,3,204,295,25,15,255,295,0,47,248,295,51,16,228,295
3397477,1647,208428,new-0.5,completed,267.0,7.1,170,97,35,0,232,267,0,35,232,267,4,22,241,267,61,0,206,267,4,0,263,267
3397477,1647,208428,new-1.0,completed,310.0,7.35,122,188,50,71,189,310,0,7,303,310,44,28,238,310,31,33,246,310,10,88,212,310
3397477,1647,460300,base,completed,321.0,6.7,118,203,30,36,255,321,50,0,271,321,0,117,204,321,10,46,265,321,91,14,216,321
3397477,1647,460300,base+,completed,277.0,6.95,130,147,41,0,236,277,0,52,225,277,34,0,243,277,0,14,263,277,32,48,197,277
3397477,1647,460300,dpv1,completed,293.0,7.1,157,136,56,15,222,293,1,47,245,293,41,0,252,293,0,31,262,293,71,0,222,293
3397477,1647,460300,dpv2,completed,348.0,7.4,92,256,78,144,126,348,30,0,318,348,0,35,313,348,50,141,157,348,2,61,285,348
3397477,1647,460300,new-0.0,completed,277.0,6.95,165,112,0,30,247,277,9,3,265,277,26,15,236,277,51,0,226,277,83,0,194,277
3397477,1647,460300,new-0.5,completed,304.0,7.25,160,144,0,51,253,304,53,3,248,304,95,10,199,304,15,24,265,304,45,26,233,304
3397477,1647,460300,new-1.0,completed,327.0,7.25,122,205,34,23,270,327,0,9,318,327,53,25,249,327,69,72,186,327,33,113,181,327
3397477,1647,309704,base,completed,314.0,7.0,141,173,63,67,184,314,91,15,208,314,35,47,232,314,0,42,272,314,3,30,281,314
3397477,1647,309704,base+,completed,322.0,6.95,141,181,6,28,288,322,103,0,219,322,76,20,226,322,0,111,211,322,36,35,251,322
3397477,1647,309704,dpv1,completed,315.0,7.15,155,160,40,44,231,315,8,32,275,315,99,0,216,315,71,45,199,315,0,63,252,315
3397477,1647,309704,dpv2,completed,353.0,7.4,80,273,81,144,128,353,40,0,313,353,10,40,303,353,58,154,141,353,0,61,292,353
3397477,1647,309704,new-0.0,completed,256.0,6.9,165,91,11,16,229,256,63,0,193,256,42,0,214,256,0,29,227,256,3,0,253,256
3397477,1647,309704,new-0.5,completed,261.0,7.25,172,89,0,31,230,261,20,4,237,261,53,0,208,261,58,0,203,261,6,0,255,261
3397477,1647,309704,new-1.0,completed,316.0,7.25,114,202,23,21,272,316,0,0,316,316,55,36,225,316,58,79,179,316,24,110,182,316
3397477,1647,247588,base,completed,373.0,6.7,84,289,0,61,312,373,12,52,309,373,76,144,153,373,93,19,261,373,47,144,182,373
3397477,1647,247588,base+,completed,324.0,6.75,121,203,4,36,284,324,42,33,249,324,0,142,182,324,72,14,238,324,105,0,219,324
3397477,1647,247588,dpv1,completed,306.0,7.2,157,149,77,0,229,306,22,24,260,306,77,42,187,306,44,38,224,306,0,51,255,306
3397477,1647,247588,dpv2,completed,322.0,7.4,81,241,57,156,109,322,25,0,297,322,1,17,304,322,24,155,143,322,0,56,266,322
3397477,1647,247588,new-0.0,completed,253.0,7.0,172,81,0,16,237,253,6,0,247,253,38,0,215,253,16,6,231,253,69,0,184,253
3397477,1647,247588,new-0.5,completed,261.0,7.25,181,80,0,30,231,261,8,15,238,261,44,0,217,261,49,0,212,261,0,0,261,261
3397477,1647,247588,new-1.0,completed,300.0,7.3,106,194,0,66,234,300,25,0,275,300,58,16,226,300,27,37,236,300,21,90,189,300
3397477,1647,203195,base,completed,359.0,6.85,123,236,0,70,289,359,88,49,222,359,114,34,211,359,13,157,189,359,51,32,276,359
3397477,1647,203195,base+,completed,342.0,6.85,85,257,0,112,230,342,40,40,262,342,62,0,280,342,1,39,302,342,82,140,120,342
3397477,1647,203195,dpv1,completed,315.0,7.15,158,157,71,51,193,315,6,30,279,315,102,0,213,315,39,47,229,315,0,66,249,315
3397477,1647,203195,dpv2,completed,350.0,7.4,81,269,81,146,123,350,45,0,305,350,10,30,310,350,47,154,149,350,0,54,296,350
3397477,1647,203195,new-0.0,completed,270.0,6.95,165,105,37,0,233,270,10,5,255,270,19,12,239,270,0,45,225,270,80,0,190,270
3397477,1647,203195,new-0.5,completed,284.0,7.25,156,128,0,52,232,284,24,29,231,284,15,1,268,284,76,0,208,284,48,10,226,284
3397477,1647,203195,new-1.0,completed,282.0,7.35,123,159,5,39,238,282,29,0,253,282,0,53,229,282,5,2,275,282,36,68,178,282
3397477,1647,178029,base,completed,332.0,6.65,107,225,90,64,178,332,49,0,283,332,0,70,262,332,8,138,186,332,100,0,232,332
3397477,1647,178029,base+,completed,308.0,6.75,132,176,58,41,209,308,74,0,234,308,23,30,255,308,0,59,249,308,48,28,232,308
3397477,1647,178029,dpv1,completed,314.0,7.15,149,165,42,32,240,314,0,47,267,314,84,50,180,314,84,9,221,314,12,27,275,314
3397477,1647,178029,dpv2,completed,332.0,7.3,110,222,68,16,248,332,5,33,294,332,0,106,226,332,38,68,226,332,87,49,196,332
3397477,1647,178029,new-0.0,completed,262.0,6.9,163,99,0,30,232,262,10,22,230,262,38,3,221,262,61,0,201,262,10,0,252,262
3397477,1647,178029,new-0.5,completed,275.0,7.15,160,115,58,0,217,275,12,22,241,275,1,52,222,275,39,6,230,275,0,1,274,275
3397477,1647,178029,new-1.0,completed,328.0,7.25,123,205,40,18,270,328,0,16,312,328,55,37,236,328,69,71,188,328,26,105,197,328
3397477,1647,239735,base,completed,370.0,7.0,91,279,92,0,278,370,29,28,313,370,0,224,146,370,1,48,321,370,65,187,118,370
3397477,1647,239735,base+,completed,324.0,6.8,135,189,0,97,227,324,109,0,215,324,45,34,245,324,11,36,277,324,84,46,194,324
3397477,1647,239735,dpv1,completed,313.0,7.25,150,163,89,0,224,313,81,53,179,313,17,26,270,313,42,39,232,313,0,60,253,313
3397477,1647,239735,dpv2,completed,341.0,7.4,91,250,86,141,114,341,44,0,297,341,18,19,304,341,63,125,153,341,0,58,283,341
3397477,1647,239735,new-0.0,completed,256.0,6.95,169,87,0,22,234,256,62,0,194,256,40,2,214,256,6,11,239,256,5,6,245,256
3397477,1647,239735,new-0.5,completed,256.0,7.0,162,94,57,0,199,256,0,23,233,256,40,6,210,256,5,28,223,256,2,0,254,256
3397477,1647,239735,new-1.0,completed,301.0,7.35,119,182,55,33,213,301,56,0,245,301,0,64,237,301,33,32,236,301,25,65,211,301
3397477,1647,675528,base,completed,312.0,6.7,107,205,47,0,265,312,37,42,233,312,0,50,262,312,0,162,150,312,58,0,254,312
3397477,1647,675528,base+,completed,313.0,7.0,165,148,70,14,229,313,0,53,260,313,19,25,269,313,79,32,202,313,43,33,237,313
3397477,1647,675528,dpv1,completed,325.0,7.3,147,178,36,55,234,325,73,67,185,325,103,0,222,325,0,39,286,325,5,76,244,325
3397477,1647,675528,dpv2,completed,342.0,7.4,87,255,72,140,130,342,37,0,305,342,4,19,319,342,34,154,154,342,0,47,295,342
3397477,1647,675528,new-0.0,completed,261.0,6.95,168,93,0,13,248,261,67,0,194,261,42,0,219,261,12,16,233,261,8,0,253,261
3397477,1647,675528,new-0.5,completed,268.0,7.15,168,100,34,0,234,268,1,36,231,268,65,0,203,268,20,16,232,268,0,3,265,268
3397477,1647,675528,new-1.0,completed,299.0,7.45,127,172,0,36,263,299,52,0,247,299,30,25,244,299,57,51,191,299,17,85,197,299
3397477,1647,380692,base,completed,333.0,6.85,136,197,23,41,269,333,85,18,230,333,116,16,201,333,0,62,271,333,48,65,220,333
3397477,1647,380692,base+,completed,287.0,6.7,151,136,0,44,243,287,11,18,258,287,42,0,245,287,75,28,184,287,76,0,211,287
3397477,1647,380692,dpv1,completed,321.0,7.25,154,167,39,53,229,321,10,36,275,321,89,52,180,321,98,0,223,321,0,68,253,321
3397477,1647,380692,dpv2,completed,337.0,7.3,79,258,8,144,185,337,41,0,296,337,74,6,257,337,17,173,147,337,0,42,295,337
3397477,1647,380692,new-0.0,completed,261.0,7.0,169,92,0,18,243,261,10,0,251,261,38,0,223,261,13,12,236,261,68,0,193,261
3397477,1647,380692,new-0.5,completed,276.0,7.1,168,108,41,4,231,276,0,44,232,276,61,0,215,276,37,5,234,276,6,21,249,276
3397477,1647,380692,new-1.0,completed,313.0,7.35,114,199,58,31,224,313,0,0,313,313,26,84,203,313,33,29,251,313,63,67,183,313
8546042,1608,310811,base,completed,268.0,6.9,155,113,39,48,181,268,65,0,203,268,17,0,251,268,0,0,268,268,45,0,223,268
8546042,1608,310811,base+,completed,269.0,7.0,191,78,7,0,262,269,78,0,191,269,39,0,230,269,0,0,269,269,45,1,223,269
8546042,1608,310811,dpv1,completed,259.0,7.2,171,88,25,0,234,259,0,0,259,259,20,0,239,259,35,9,215,259,64,15,180,259
8546042,1608,310811,dpv2,completed,256.0,7.15,149,107,0,52,204,256,39,0,217,256,3,0,253,256,27,16,213,256,10,0,246,256
8546042,1608,310811,new-0.0,completed,269.0,7.1,165,104,71,0,198,269,21,0,248,269,29,28,212,269,50,0,219,269,0,15,254,269
8546042,1608,310811,new-0.5,completed,244.0,7.75,201,43,22,0,222,244,16,0,228,244,5,0,239,244,0,0,244,244,43,0,201,244
8546042,1608,310811,new-1.0,completed,260.0,7.55,173,87,28,0,232,260,0,6,254,260,60,0,200,260,17,27,216,260,14,0,246,260
8546042,1608,208428,base,completed,261.0,7.1,183,78,40,0,221,261,35,0,226,261,0,0,261,261,12,54,195,261,24,0,237,261
8546042,1608,208428,base+,completed,248.0,7.1,214,34,34,0,214,248,23,0,225,248,31,0,217,248,16,0,232,248,0,0,248,248
8546042,1608,208428,dpv1,completed,259.0,7.25,185,74,20,0,239,259,31,9,219,259,30,2,227,259,0,0,259,259,63,0,196,259
8546042,1608,208428,dpv2,completed,248.0,7.4,178,70,27,4,217,248,9,0,239,248,19,0,229,248,0,33,215,248,33,0,215,248
8546042,1608,208428,new-0.0,completed,238.0,7.35,200,38,11,0,227,238,38,0,200,238,0,0,238,238,4,0,234,238,2,0,236,238
8546042,1608,208428,new-0.5,completed,240.0,7.75,199,41,26,0,214,240,4,0,236,240,20,0,220,240,0,0,240,240,41,0,199,240
8546042,1608,208428,new-1.0,completed,256.0,7.7,189,67,0,4,252,256,26,0,230,256,13,0,243,256,41,26,189,256,17,0,239,256
8546042,1608,460300,base,completed,279.0,6.8,168,111,65,0,214,279,29,0,250,279,43,40,196,279,44,0,235,279,0,18,261,279
8546042,1608,460300,base+,completed,260.0,7.1,207,53,34,0,226,260,8,0,252,260,0,0,260,260,53,0,207,260,51,0,209,260
8546042,1608,460300,dpv1,completed,270.0,6.85,183,87,43,0,227,270,65,0,205,270,26,10,234,270,34,14,222,270,0,0,270,270
8546042,1608,460300,dpv2,completed,254.0,7.2,203,51,45,0,209,254,0,0,254,254,27,0,227,254,31,5,218,254,33,1,220,254
8546042,1608,460300,new-0.0,completed,243.0,7.4,186,57,7,0,236,243,21,0,222,243,57,0,186,243,0,0,243,243,31,0,212,243
8546042,1608,460300,new-0.5,completed,246.0,7.75,192,54,30,12,204,246,3,0,243,246,2,0,244,246,0,1,245,246,41,0,205,246
8546042,1608,460300,new-1.0,completed,265.0,7.5,192,73,59,0,206,265,29,14,222,265,17,0,248,265,0,15,250,265,26,0,239,265
8546042,1608,309704,base,completed,275.0,7.2,156,119,68,0,207,275,6,0,269,275,0,0,275,275,35,51,189,275,65,0,210,275
8546042,1608,309704,base+,completed,260.0,7.2,180,80,41,0,219,260,5,0,255,260,15,0,245,260,0,33,227,260,38,6,216,260
8546042,1608,309704,dpv1,completed,256.0,7.35,186,70,37,0,219,256,16,0,240,256,0,0,256,256,70,0,186,256,32,0,224,256
8546042,1608,309704,dpv2,completed,255.0,7.2,176,79,0,28,227,255,36,0,219,255,12,0,243,255,51,0,204,255,10,0,245,255
8546042,1608,309704,new-0.0,completed,271.0,7.25,165,106,70,0,201,271,32,0,239,271,0,18,253,271,57,0,214,271,38,18,215,271
8546042,1608,309704,new-0.5,completed,244.0,7.65,189,55,36,0,208,244,0,19,225,244,0,0,244,244,32,0,212,244,7,0,237,244
8546042,1608,309704,new-1.0,completed,251.0,7.45,182,69,26,0,225,251,20,0,231,251,48,0,203,251,12,21,218,251,0,0,251,251
8546042,1608,247588,base,completed,256.0,7.05,187,69,25,4,227,256,67,0,189,256,0,0,256,256,6,0,250,256,34,0,222,256
8546042,1608,247588,base+,completed,238.0,6.95,203,35,1,0,237,238,35,0,203,238,17,0,221,238,0,0,238,238,10,0,228,238
8546042,1608,247588,dpv1,completed,254.0,7.15,188,66,64,0,190,254,29,0,225,254,16,0,238,254,0,0,254,254,31,2,221,254
8546042,1608,247588,dpv2,completed,254.0,7.35,199,55,0,1,253,254,25,0,229,254,9,0,245,254,18,0,236,254,54,0,200,254
8546042,1608,247588,new-0.0,completed,268.0,7.1,163,105,57,0,211,268,27,0,241,268,21,31,216,268,44,0,224,268,0,25,243,268
8546042,1608,247588,new-0.5,completed,255.0,7.7,193,62,0,0,255,255,44,0,211,255,21,0,234,255,19,0,236,255,62,0,193,255
8546042,1608,247588,new-1.0,completed,238.0,7.4,190,48,1,0,237,238,3,25,210,238,23,0,215,238,5,0,233,238,0,0,238,238
8546042,1608,203195,base,completed,263.0,7.15,203,60,37,0,226,263,39,13,211,263,19,10,234,263,32,0,231,263,0,0,263,263
8546042,1608,203195,base+,completed,248.0,6.8,216,32,10,0,238,248,28,0,220,248,0,0,248,248,32,0,216,248,13,0,235,248
8546042,1608,203195,dpv1,completed,259.0,7.15,172,87,29,3,227,259,25,0,234,259,0,0,259,259,71,0,188,259,29,16,214,259
8546042,1608,203195,dpv2,completed,257.0,7.45,176,81,29,0,228,257,5,29,223,257,45,0,212,257,0,0,257,257,38,7,212,257
8546042,1608,203195,new-0.0,completed,236.0,7.5,210,26,7,0,229,236,26,0,210,236,10,0,226,236,13,0,223,236,0,0,236,236
8546042,1608,203195,new-0.5,completed,239.0,7.7,186,53,2,0,237,239,8,15,216,239,0,0,239,239,9,0,230,239,38,0,201,239
8546042,1608,203195,new-1.0,completed,263.0,7.5,194,69,68,0,195,263,18,0,245,263,36,0,227,263,40,1,222,263,0,20,243,263
8546042,1608,178029,base,completed,249.0,7.0,191,58,0,0,249,249,10,0,239,249,49,0,200,249,11,0,238,249,32,9,208,249
8546042,1608,178029,base+,completed,269.0,7.15,176,93,0,31,238,269,32,6,231,269,56,0,213,269,50,0,219,269,31,0,238,269
8546042,1608,178029,dpv1,completed,259.0,7.05,163,96,0,0,259,259,3,30,226,259,54,0,205,259,37,7,215,259,27,5,227,259
8546042,1608,178029,dpv2,completed,253.0,7.45,183,70,23,0,230,253,15,4,234,253,22,0,231,253,0,2,251,253,64,0,189,253
8546042,1608,178029,new-0.0,completed,267.0,7.15,167,100,75,0,192,267,41,0,226,267,0,19,248,267,24,0,243,267,34,18,215,267
8546042,1608,178029,new-0.5,completed,238.0,7.65,198,40,2,0,236,238,14,0,224,238,0,0,238,238,28,0,210,238,40,0,198,238
8546042,1608,178029,new-1.0,completed,262.0,7.65,197,65,0,7,255,262,24,3,235,262,55,1,206,262,45,0,217,262,22,0,240,262
8546042,1608,239735,base,completed,248.0,7.4,213,35,3,0,245,248,35,0,213,248,17,0,231,248,0,0,248,248,22,0,226,248
8546042,1608,239735,base+,completed,246.0,7.0,195,51,37,0,209,246,19,0,227,246,0,13,233,246,9,0,237,246,33,1,212,246
8546042,1608,239735,dpv1,completed,252.0,7.2,183,69,0,0,252,252,28,0,224,252,69,0,183,252,36,0,216,252,31,0,221,252
8546042,1608,239735,dpv2,completed,247.0,7.2,170,77,0,19,228,247,50,0,197,247,25,0,222,247,33,8,206,247,24,0,223,247
8546042,1608,239735,new-0.0,completed,243.0,7.5,190,53,26,0,217,243,0,0,243,243,29,0,214,243,25,0,218,243,53,0,190,243
8546042,1608,239735,new-0.5,completed,227.0,7.65,176,51,34,0,193,227,1,17,209,227,3,0,224,227,0,0,227,227,6,0,221,227
8546042,1608,239735,new-1.0,completed,265.0,7.5,195,70,37,0,228,265,0,17,248,265,21,0,244,265,58,0,207,265,70,0,195,265
8546042,1608,675528,base,completed,244.0,7.1,188,56,14,0,230,244,56,0,188,244,0,0,244,244,7,0,237,244,18,0,226,244
8546042,1608,675528,base+,completed,255.0,7.05,168,87,0,0,255,255,23,20,212,255,27,9,219,255,58,0,197,255,10,0,245,255
8546042,1608,675528,dpv1,completed,285.0,7.35,154,131,36,0,249,285,0,0,285,285,65,0,220,285,22,66,197,285,57,3,225,285
8546042,1608,675528,dpv2,completed,270.0,7.4,142,128,36,0,234,270,22,0,248,270,20,0,250,270,0,83,187,270,28,9,233,270
8546042,1608,675528,new-0.0,completed,255.0,7.15,188,67,25,0,230,255,0,9,246,255,28,9,218,255,49,0,206,255,36,0,219,255
8546042,1608,675528,new-0.5,completed,241.0,7.7,197,44,2,0,239,241,15,1,225,241,14,0,227,241,0,0,241,241,43,0,198,241
8546042,1608,675528,new-1.0,completed,276.0,7.5,185,91,17,0,259,276,67,0,209,276,0,20,256,276,54,24,198,276,47,0,229,276
8546042,1608,380692,base,completed,271.0,6.75,164,107,0,0,271,271,49,0,222,271,62,0,209,271,37,45,189,271,6,0,265,271
8546042,1608,380692,base+,completed,256.0,7.1,196,60,60,0,196,256,12,0,244,256,0,0,256,256,53,0,203,256,27,0,229,256
8546042,1608,380692,dpv1,completed,265.0,7.05,189,76,40,0,225,265,42,0,223,265,41,0,224,265,76,0,189,265,0,0,265,265
8546042,1608,380692,dpv2,completed,252.0,7.3,179,73,0,0,252,252,18,0,234,252,15,27,210,252,46,0,206,252,26,0,226,252
8546042,1608,380692,new-0.0,completed,264.0,7.25,166,98,73,0,191,264,16,0,248,264,0,11,253,264,45,0,219,264,36,22,206,264
8546042,1608,380692,new-0.5,completed,242.0,7.7,211,31,0,0,242,242,30,0,212,242,28,0,214,242,5,0,237,242,31,0,211,242
8546042,1608,380692,new-1.0,completed,276.0,7.5,186,90,21,0,255,276,0,24,252,276,57,0,219,276,81,9,186,276,61,0,215,276
2258176,1699,310811,base,completed,282.0,6.6,165,117,45,39,198,282,38,0,244,282,0,46,236,282,44,0,238,282,0,10,272,282
2258176,1699,310811,base+,completed,287.0,6.9,222,65,41,0,246,287,37,6,244,287,0,6,281,287,59,0,228,287,44,0,243,287
2258176,1699,310811,dpv1,completed,273.0,7.15,215,58,19,0,254,273,24,6,243,273,52,0,221,273,0,0,273,273,50,0,223,273
2258176,1699,310811,dpv2,completed,311.0,7.05,143,168,63,0,248,311,24,67,220,311,41,0,270,311,60,0,251,311,0,127,184,311
2258176,1699,310811,new-0.0,completed,261.0,6.9,194,67,19,14,228,261,53,0,208,261,11,0,250,261,33,0,228,261,0,0,261,261
2258176,1699,310811,new-0.5,completed,265.0,7.35,215,50,0,0,265,265,50,0,215,265,43,0,222,265,41,0,224,265,11,0,254,265
2258176,1699,310811,new-1.0,completed,261.0,7.5,228,33,31,0,230,261,11,0,250,261,33,0,228,261,28,0,233,261,0,0,261,261
2258176,1699,208428,base,completed,290.0,6.8,202,88,46,0,244,290,0,42,248,290,17,20,253,290,49,0,241,290,11,0,279,290
2258176,1699,208428,base+,completed,282.0,6.8,210,72,0,0,282,282,54,0,228,282,45,0,237,282,37,0,245,282,72,0,210,282
2258176,1699,208428,dpv1,completed,271.0,6.95,217,54,12,0,259,271,35,0,236,271,54,0,217,271,0,0,271,271,45,0,226,271
2258176,1699,208428,dpv2,completed,270.0,6.95,221,49,43,0,227,270,32,0,238,270,0,0,270,270,49,0,221,270,27,0,243,270
2258176,1699,208428,new-0.0,completed,266.0,6.9,209,57,2,4,260,266,53,0,213,266,41,0,225,266,51,0,215,266,0,0,266,266
2258176,1699,208428,new-0.5,completed,269.0,7.45,213,56,0,0,269,269,56,0,213,269,37,0,232,269,14,0,255,269,8,0,261,269
2258176,1699,208428,new-1.0,completed,277.0,7.5,174,103,18,0,259,277,0,58,219,277,45,0,232,277,40,0,237,277,3,0,274,277
2258176,1699,460300,base,completed,281.0,6.65,186,95,26,0,255,281,45,0,236,281,49,25,207,281,10,21,250,281,0,0,281,281
2258176,1699,460300,base+,completed,287.0,6.65,227,60,59,0,228,287,33,0,254,287,60,0,227,287,0,11,276,287,49,0,238,287
2258176,1699,460300,dpv1,completed,275.0,7.15,209,66,17,0,258,275,22,0,253,275,0,0,275,275,50,0,225,275,66,0,209,275
2258176,1699,460300,dpv2,completed,290.0,7.1,203,87,37,0,253,290,0,37,253,290,15,34,241,290,46,0,244,290,53,0,237,290
2258176,1699,460300,new-0.0,completed,271.0,6.95,215,56,35,0,236,271,54,0,217,271,9,0,262,271,56,0,215,271,0,0,271,271
2258176,1699,460300,new-0.5,completed,276.0,7.55,205,71,71,0,205,276,9,0,267,276,68,0,208,276,0,0,276,276,6,0,270,276
2258176,1699,460300,new-1.0,completed,285.0,7.55,181,104,0,0,285,285,12,54,219,285,50,0,235,285,47,0,238,285,26,0,259,285
2258176,1699,309704,base,completed,259.0,7.0,207,52,42,0,217,259,18,0,241,259,4,10,245,259,10,0,249,259,0,0,259,259
2258176,1699,309704,base+,completed,266.0,6.9,198,68,14,19,233,266,0,11,255,266,7,0,259,266,34,0,232,266,49,0,217,266
2258176,1699,309704,dpv1,completed,273.0,7.2,225,48,43,0,230,273,25,0,248,273,0,0,273,273,48,0,225,273,14,0,259,273
2258176,1699,309704,dpv2,completed,275.0,7.15,147,128,0,0,275,275,29,0,246,275,1,0,274,275,45,0,230,275,2,83,190,275
2258176,1699,309704,new-0.0,completed,261.0,6.75,189,72,1,0,260,261,0,0,261,261,40,0,221,261,38,7,216,261,4,25,232,261
2258176,1699,309704,new-0.5,completed,261.0,7.35,208,53,0,0,261,261,53,0,208,261,22,0,239,261,19,0,242,261,10,0,251,261
2258176,1699,309704,new-1.0,completed,282.0,7.55,217,65,0,3,279,282,45,0,237,282,42,0,240,282,62,0,220,282,29,0,253,282
2258176,1699,247588,base,completed,286.0,6.85,229,57,51,0,235,286,39,0,247,286,37,0,249,286,57,0,229,286,0,0,286,286
2258176,1699,247588,base+,completed,295.0,6.7,171,124,44,0,251,295,70,0,225,295,0,13,282,295,37,0,258,295,27,54,214,295
2258176,1699,247588,dpv1,completed,260.0,7.2,212,48,21,0,239,260,48,0,212,260,23,0,237,260,0,0,260,260,14,0,246,260
2258176,1699,247588,dpv2,completed,283.0,7.05,196,87,0,39,244,283,37,18,228,283,69,0,214,283,38,0,245,283,44,0,239,283
2258176,1699,247588,new-0.0,completed,267.0,7.0,215,52,39,0,228,267,0,0,267,267,42,0,225,267,52,0,215,267,50,0,217,267
2258176,1699,247588,new-0.5,completed,265.0,7.35,211,54,21,0,244,265,54,0,211,265,0,0,265,265,28,0,237,265,7,0,258,265
2258176,1699,247588,new-1.0,completed,280.0,7.5,191,89,0,0,280,280,36,33,211,280,48,0,232,280,56,0,224,280,11,0,269,280
2258176,1699,203195,base,completed,287.0,6.85,207,80,0,18,269,287,53,0,234,287,15,27,245,287,35,0,252,287,39,0,248,287
2258176,1699,203195,base+,completed,278.0,6.85,179,99,0,0,278,278,12,48,218,278,44,0,234,278,0,4,274,278,51,0,227,278
2258176,1699,203195,dpv1,completed,279.0,7.2,217,62,27,0,252,279,0,0,279,279,47,0,232,279,62,0,217,279,41,0,238,279
2258176,1699,203195,dpv2,completed,327.0,7.0,156,171,39,52,236,327,78,0,249,327,0,125,202,327,46,0,281,327,65,0,262,327
2258176,1699,203195,new-0.0,completed,267.0,7.0,212,55,0,3,264,267,50,0,217,267,40,0,227,267,52,0,215,267,4,0,263,267
2258176,1699,203195,new-0.5,completed,269.0,7.5,222,47,46,0,223,269,0,0,269,269,38,0,231,269,47,0,222,269,22,0,247,269
2258176,1699,203195,new-1.0,completed,294.0,7.55,172,122,0,0,294,294,39,53,202,294,69,0,225,294,56,0,238,294,24,0,270,294
2258176,1699,178029,base,completed,288.0,6.75,184,104,0,60,228,288,24,0,264,288,51,0,237,288,44,0,244,288,42,0,246,288
2258176,1699,178029,base+,completed,260.0,6.85,209,51,20,0,240,260,51,0,209,260,0,0,260,260,0,0,260,260,10,0,250,260
2258176,1699,178029,dpv1,completed,270.0,7.15,203,67,10,0,260,270,0,0,270,270,19,0,251,270,55,0,215,270,67,0,203,270
2258176,1699,178029,dpv2,completed,294.0,6.95,145,149,0,20,274,294,5,99,190,294,37,0,257,294,44,0,250,294,50,0,244,294
2258176,1699,178029,new-0.0,completed,274.0,7.05,219,55,45,0,229,274,30,0,244,274,55,0,219,274,54,0,220,274,0,0,274,274
2258176,1699,178029,new-0.5,completed,259.0,7.5,213,46,46,0,213,259,0,0,259,259,17,0,242,259,6,0,253,259,9,0,250,259
2258176,1699,178029,new-1.0,completed,294.0,7.5,223,71,71,0,223,294,46,0,248,294,58,0,236,294,66,0,228,294,0,0,294,294
2258176,1699,239735,base,completed,288.0,6.6,230,58,57,0,231,288,58,0,230,288,0,0,288,288,32,0,256,288,50,0,238,288
2258176,1699,239735,base+,completed,269.0,6.8,187,82,0,36,233,269,20,0,249,269,46,0,223,269,2,7,260,269,50,0,219,269
2258176,1699,239735,dpv1,completed,263.0,7.0,208,55,35,0,228,263,55,0,208,263,26,0,237,263,0,0,263,263,31,0,232,263
2258176,1699,239735,dpv2,completed,286.0,7.1,151,135,32,0,254,286,47,0,239,286,0,34,252,286,30,0,256,286,20,77,189,286
2258176,1699,239735,new-0.0,completed,266.0,6.9,205,61,0,0,266,266,47,0,219,266,46,0,220,266,61,0,205,266,14,0,252,266
2258176,1699,239735,new-0.5,completed,248.0,7.5,206,42,42,0,206,248,4,0,244,248,17,0,231,248,11,0,237,248,0,0,248,248
2258176,1699,239735,new-1.0,completed,269.0,7.5,161,108,11,0,258,269,5,54,210,269,34,0,235,269,54,0,215,269,0,0,269,269
2258176,1699,675528,base,completed,269.0,6.95,207,62,15,0,254,269,57,0,212,269,0,0,269,269,62,0,207,269,23,0,246,269
2258176,1699,675528,base+,completed,272.0,6.8,188,84,3,0,269,272,15,0,257,272,0,45,227,272,39,0,233,272,52,0,220,272
2258176,1699,675528,dpv1,completed,277.0,7.15,226,51,18,0,259,277,28,0,249,277,51,0,226,277,0,0,277,277,50,0,227,277
2258176,1699,675528,dpv2,completed,308.0,7.0,140,168,8,67,233,308,0,0,308,308,67,0,241,308,24,101,183,308,46,0,262,308
2258176,1699,675528,new-0.0,completed,272.0,7.05,216,56,56,0,216,272,37,0,235,272,29,0,243,272,50,0,222,272,0,0,272,272
2258176,1699,675528,new-0.5,completed,280.0,7.6,207,73,66,0,214,280,10,0,270,280,24,0,256,280,62,7,211,280,0,0,280,280
2258176,1699,675528,new-1.0,completed,282.0,7.55,178,104,0,0,282,282,5,52,225,282,50,0,232,282,52,0,230,282,15,0,267,282
2258176,1699,380692,base,completed,265.0,7.15,204,61,0,0,265,265,46,0,219,265,22,0,243,265,61,0,204,265,17,0,248,265
2258176,1699,380692,base+,completed,269.0,6.5,215,54,54,0,215,269,54,0,215,269,48,0,221,269,29,0,240,269,0,0,269,269
2258176,1699,380692,dpv1,completed,285.0,7.05,174,111,66,0,219,285,25,45,215,285,0,0,285,285,18,0,267,285,46,0,239,285
2258176,1699,380692,dpv2,completed,286.0,6.95,153,133,22,0,264,286,32,0,254,286,0,91,195,286,0,0,286,286,42,0,244,286
2258176,1699,380692,new-0.0,completed,260.0,6.9,199,61,19,8,233,260,53,0,207,260,8,0,252,260,31,0,229,260,0,0,260,260
2258176,1699,380692,new-0.5,completed,266.0,7.45,206,60,0,0,266,266,60,0,206,266,43,0,223,266,10,0,256,266,20,0,246,266
2258176,1699,380692,new-1.0,completed,297.0,7.5,173,124,55,0,242,297,24,61,212,297,53,0,244,297,63,0,234,297,0,0,297,297
4824742,1838,310811,base,completed,356.0,7.1,133,223,0,64,292,356,72,0,284,356,75,12,269,356,26,136,194,356,95,0,261,356
4824742,1838,310811,base+,completed,329.0,7.05,222,107,72,0,257,329,70,0,259,329,0,37,292,329,71,0,258,329,29,35,265,329
4824742,1838,310811,dpv1,completed,304.0,7.1,215,89,0,25,279,304,52,0,252,304,13,0,291,304,30,21,253,304,68,0,236,304
4824742,1838,310811,dpv2,completed,327.0,7.3,188,139,87,12,228,327,29,39,259,327,69,0,258,327,0,30,297,327,53,19,255,327
4824742,1838,310811,new-0.0,completed,303.0,7.0,187,116,73,0,230,303,51,0,252,303,50,0,253,303,0,13,290,303,34,43,226,303
4824742,1838,310811,new-0.5,completed,348.0,7.4,204,144,63,0,285,348,127,0,221,348,26,69,253,348,75,0,273,348,0,84,264,348
4824742,1838,310811,new-1.0,completed,325.0,7.6,185,140,76,29,220,325,30,33,262,325,37,0,288,325,84,12,229,325,0,22,303,325
4824742,1838,208428,base,completed,346.0,7.2,178,168,0,53,293,346,65,2,279,346,29,76,241,346,103,13,230,346,77,0,269,346
4824742,1838,208428,base+,completed,328.0,7.1,163,165,74,0,254,328,21,0,307,328,0,17,311,328,65,0,263,328,32,91,205,328
4824742,1838,208428,dpv1,completed,306.0,7.15,193,113,14,15,277,306,66,0,240,306,0,0,306,306,34,47,225,306,33,0,273,306
4824742,1838,208428,dpv2,completed,358.0,7.25,178,180,27,46,285,358,79,0,279,358,0,130,228,358,109,10,239,358,69,0,289,358
4824742,1838,208428,new-0.0,completed,353.0,7.15,200,153,0,83,270,353,99,0,254,353,85,0,268,353,30,66,257,353,113,0,240,353
4824742,1838,208428,new-0.5,completed,336.0,7.5,221,115,67,0,269,336,92,8,236,336,0,47,289,336,97,0,239,336,27,48,261,336
4824742,1838,208428,new-1.0,completed,329.0,7.45,185,144,73,42,214,329,0,34,295,329,26,0,303,329,80,9,240,329,29,29,271,329
4824742,1838,460300,base,completed,397.0,7.05,158,239,30,62,305,397,83,0,314,397,87,0,310,397,135,88,174,397,0,159,238,397
4824742,1838,460300,base+,completed,340.0,7.2,212,128,83,0,257,340,84,0,256,340,29,45,266,340,45,0,295,340,0,71,269,340
4824742,1838,460300,dpv1,completed,313.0,7.2,207,106,0,21,292,313,74,0,239,313,13,0,300,313,68,0,245,313,25,32,256,313
4824742,1838,460300,dpv2,completed,355.0,7.2,206,149,123,4,228,355,0,75,280,355,88,0,267,355,31,57,267,355,74,0,281,355
4824742,1838,460300,new-0.0,completed,317.0,7.05,200,117,33,38,246,317,68,0,249,317,61,0,256,317,79,0,238,317,0,9,308,317
4824742,1838,460300,new-0.5,completed,330.0,7.5,212,118,81,0,249,330,0,38,292,330,31,32,267,330,74,0,256,330,92,0,238,330
4824742,1838,460300,new-1.0,completed,326.0,7.7,161,165,21,17,288,326,52,54,220,326,84,0,242,326,83,11,232,326,0,0,326,326
4824742,1838,309704,base,completed,396.0,7.15,200,196,72,0,324,396,135,0,261,396,29,124,243,396,140,0,256,396,0,145,251,396
4824742,1838,309704,base+,completed,339.0,6.9,130,209,24,7,308,339,54,0,285,339,73,0,266,339,37,0,302,339,0,185,154,339
4824742,1838,309704,dpv1,completed,298.0,7.15,229,69,34,0,264,298,69,0,229,298,10,0,288,298,69,0,229,298,0,0,298,298
4824742,1838,309704,dpv2,completed,358.0,7.25,172,186,29,55,274,358,113,0,245,358,0,137,221,358,78,0,280,358,75,0,283,358
4824742,1838,309704,new-0.0,completed,362.0,7.1,190,172,90,8,264,362,0,90,272,362,96,0,266,362,32,82,248,362,116,0,246,362
4824742,1838,309704,new-0.5,completed,339.0,7.45,206,133,0,71,268,339,127,0,212,339,26,59,254,339,74,0,265,339,52,0,287,339
4824742,1838,309704,new-1.0,completed,328.0,7.6,186,142,81,31,216,328,33,30,265,328,29,0,299,328,0,31,297,328,94,0,234,328
4824742,1838,247588,base,completed,329.0,7.1,153,176,78,0,251,329,80,0,249,329,41,0,288,329,26,98,205,329,0,49,280,329
4824742,1838,247588,base+,completed,315.0,7.0,198,117,22,30,263,315,59,0,256,315,0,95,220,315,76,0,239,315,11,0,304,315
4824742,1838,247588,dpv1,completed,298.0,7.1,173,125,21,63,214,298,4,0,294,298,62,0,236,298,0,17,281,298,38,2,258,298
4824742,1838,247588,dpv2,completed,333.0,7.2,183,150,83,3,247,333,0,64,269,333,71,0,262,333,28,76,229,333,53,0,280,333
4824742,1838,247588,new-0.0,completed,331.0,7.0,202,129,87,0,244,331,0,61,270,331,88,0,243,331,68,0,263,331,27,61,243,331
4824742,1838,247588,new-0.5,completed,327.0,7.5,205,122,76,0,251,327,0,50,277,327,27,42,258,327,82,0,245,327,102,0,225,327
4824742,1838,247588,new-1.0,completed,319.0,7.65,146,173,73,28,218,319,33,72,214,319,73,0,246,319,10,14,295,319,0,0,319,319
4824742,1838,203195,base,completed,312.0,7.0,230,82,23,15,274,312,13,0,299,312,66,1,245,312,0,25,287,312,74,0,238,312
4824742,1838,203195,base+,completed,323.0,6.95,153,170,64,27,232,323,22,0,301,323,52,0,271,323,0,31,292,323,26,79,218,323
4824742,1838,203195,dpv1,completed,303.0,7.15,205,98,6,27,270,303,64,0,239,303,0,0,303,303,31,34,238,303,32,0,271,303
4824742,1838,203195,dpv2,completed,355.0,7.15,178,177,123,6,226,355,0,61,294,355,85,0,270,355,33,86,236,355,66,0,289,355
4824742,1838,203195,new-0.0,completed,310.0,7.15,190,120,50,0,260,310,28,48,234,310,59,0,251,310,72,0,238,310,0,16,294,310
4824742,1838,203195,new-0.5,completed,336.0,7.5,203,133,79,0,257,336,0,49,287,336,28,54,254,336,105,0,231,336,88,0,248,336
4824742,1838,203195,new-1.0,completed,327.0,7.45,177,150,74,32,221,327,0,37,290,327,23,0,304,327,88,0,239,327,30,42,255,327
4824742,1838,178029,base,completed,336.0,7.0,141,195,68,0,268,336,44,0,292,336,0,168,168,336,16,0,320,336,27,78,231,336
4824742,1838,178029,base+,completed,311.0,7.05,220,91,30,0,281,311,0,57,254,311,28,4,279,311,58,0,253,311,68,6,237,311
4824742,1838,178029,dpv1,completed,299.0,7.15,205,94,32,0,267,299,66,0,233,299,5,0,294,299,0,14,285,299,24,28,247,299
4824742,1838,178029,dpv2,completed,356.0,7.45,139,217,66,0,290,356,28,136,192,356,0,143,213,356,74,0,282,356,17,15,324,356
4824742,1838,178029,new-0.0,completed,317.0,7.0,205,112,28,31,258,317,78,0,239,317,78,0,239,317,0,22,295,317,81,0,236,317
4824742,1838,178029,new-0.5,completed,361.0,7.45,218,143,0,85,276,361,128,0,233,361,71,0,290,361,137,0,224,361,26,72,263,361
4824742,1838,178029,new-1.0,completed,314.0,7.65,152,162,65,30,219,314,30,67,217,314,56,0,258,314,1,15,298,314,0,0,314,314
4824742,1838,239735,base,completed,374.0,6.8,182,192,30,57,287,374,0,57,317,374,83,2,289,374,106,50,218,374,117,0,257,374
4824742,1838,239735,base+,completed,328.0,7.05,159,169,25,93,210,328,68,0,260,328,2,0,326,328,33,0,295,328,0,106,222,328
4824742,1838,239735,dpv1,completed,285.0,7.15,228,57,0,18,267,285,53,0,232,285,23,0,262,285,40,0,245,285,27,4,254,285
4824742,1838,239735,dpv2,completed,344.0,7.15,195,149,111,6,227,344,0,65,279,344,78,0,266,344,26,65,253,344,76,0,268,344
4824742,1838,239735,new-0.0,completed,344.0,7.1,194,150,78,11,255,344,0,78,266,344,97,0,247,344,26,72,246,344,105,0,239,344
4824742,1838,239735,new-0.5,completed,332.0,7.5,220,112,75,0,257,332,94,0,238,332,25,37,270,332,0,50,282,332,104,0,228,332
4824742,1838,239735,new-1.0,completed,307.0,7.7,177,130,0,0,307,307,49,58,200,307,24,23,260,307,72,0,235,307,22,0,285,307
4824742,1838,675528,base,completed,300.0,7.05,200,100,0,0,300,300,27,5,268,300,72,0,228,300,3,73,224,300,40,0,260,300
4824742,1838,675528,base+,completed,316.0,7.15,220,96,50,11,255,316,0,68,248,316,28,0,288,316,48,0,268,316,65,0,251,316
4824742,1838,675528,dpv1,completed,293.0,7.15,231,62,26,0,267,293,62,0,231,293,0,0,293,293,46,0,247,293,0,18,275,293
4824742,1838,675528,dpv2,completed,350.0,7.3,213,137,114,0,236,350,32,60,258,350,77,0,273,350,73,0,277,350,0,76,274,350
4824742,1838,675528,new-0.0,completed,277.0,7.0,231,46,31,0,246,277,45,0,232,277,15,0,262,277,37,1,239,277,0,0,277,277
4824742,1838,675528,new-0.5,completed,360.0,7.5,219,141,78,0,282,360,129,2,229,360,30,61,269,360,116,0,244,360,0,75,285,360
4824742,1838,675528,new-1.0,completed,321.0,7.65,154,167,78,27,216,321,27,62,232,321,61,0,260,321,0,28,293,321,2,0,319,321
4824742,1838,380692,base,completed,321.0,7.0,170,151,66,0,255,321,66,51,204,321,36,0,285,321,0,21,300,321,19,44,258,321
4824742,1838,380692,base+,completed,319.0,6.95,207,112,23,38,258,319,74,0,245,319,0,44,275,319,67,0,252,319,42,0,277,319
4824742,1838,380692,dpv1,completed,296.0,7.15,230,66,17,6,273,296,0,0,296,296,65,0,231,296,57,0,239,296,44,1,251,296
4824742,1838,380692,dpv2,completed,355.0,7.3,167,188,0,75,280,355,122,30,203,355,79,0,276,355,26,79,250,355,64,0,291,355
4824742,1838,380692,new-0.0,completed,343.0,7.05,195,148,103,0,240,343,0,75,268,343,93,0,250,343,27,69,247,343,79,0,264,343
4824742,1838,380692,new-0.5,completed,341.0,7.4,210,131,55,0,286,341,0,61,280,341,29,51,261,341,80,0,261,341,120,0,221,341
4824742,1838,380692,new-1.0,completed,305.0,7.7,188,117,6,0,299,305,49,51,205,305,26,7,272,305,64,0,241,305,0,2,303,305
5900267,1499,310811,base,completed,283.0,7.05,155,128,46,0,237,283,72,0,211,283,45,9,229,283,0,67,216,283,92,4,187,283
5900267,1499,310811,base+,completed,275.0,6.95,173,102,56,0,219,275,54,0,221,275,0,50,225,275,37,0,238,275,54,0,221,275
5900267,1499,310811,dpv1,completed,272.0,7.15,138,134,45,0,227,272,42,32,198,272,71,0,201,272,0,46,226,272,50,0,222,272
5900267,1499,310811,dpv2,completed,274.0,7.6,145,129,61,0,213,274,78,0,196,274,37,0,237,274,0,75,199,274,38,0,236,274
5900267,1499,310811,new-0.0,completed,249.0,7.0,189,60,25,0,224,249,56,4,189,249,51,0,198,249,27,0,222,249,0,0,249,249
5900267,1499,310811,new-0.5,completed,238.0,7.45,178,60,13,0,225,238,11,3,224,238,0,0,238,238,52,0,186,238,57,0,181,238
5900267,1499,310811,new-1.0,completed,263.0,7.45,164,99,25,0,238,263,49,31,183,263,17,5,241,263,55,38,170,263,0,0,263,263
5900267,1499,208428,base,completed,285.0,6.8,115,170,54,0,231,285,48,0,237,285,67,0,218,285,49,0,236,285,0,111,174,285
5900267,1499,208428,base+,completed,311.0,7.0,120,191,49,31,231,311,93,25,193,311,0,131,180,311,30,0,281,311,96,0,215,311
5900267,1499,208428,dpv1,completed,270.0,7.15,149,121,49,0,221,270,37,18,215,270,41,0,229,270,0,53,217,270,75,0,195,270
5900267,1499,208428,dpv2,completed,264.0,7.55,186,78,53,0,211,264,76,0,188,264,0,29,235,264,45,0,219,264,40,0,224,264
5900267,1499,208428,new-0.0,completed,238.0,7.0,200,38,32,0,206,238,38,0,200,238,26,0,212,238,35,0,203,238,0,0,238,238
5900267,1499,208428,new-0.5,completed,239.0,7.45,188,51,48,0,191,239,16,3,220,239,0,0,239,239,34,0,205,239,1,0,238,239
5900267,1499,208428,new-1.0,completed,255.0,7.45,160,95,0,0,255,255,50,35,170,255,8,7,240,255,48,31,176,255,3,2,250,255
5900267,1499,460300,base,completed,284.0,7.05,146,138,0,34,250,284,71,10,203,284,29,9,246,284,75,0,209,284,48,32,204,284
5900267,1499,460300,base+,completed,282.0,7.05,129,153,50,0,232,282,69,0,213,282,0,100,182,282,41,0,241,282,71,0,211,282
5900267,1499,460300,dpv1,completed,264.0,6.95,147,117,42,0,222,264,32,0,232,264,69,0,195,264,0,61,203,264,34,0,230,264
5900267,1499,460300,dpv2,completed,271.0,7.25,173,98,44,0,227,271,91,0,180,271,46,0,225,271,43,0,228,271,0,38,233,271
5900267,1499,460300,new-0.0,completed,275.0,7.0,170,105,51,0,224,275,93,0,182,275,38,0,237,275,0,45,230,275,92,0,183,275
5900267,1499,460300,new-0.5,completed,237.0,7.5,179,58,54,0,183,237,8,0,229,237,0,0,237,237,6,0,231,237,39,4,194,237
5900267,1499,460300,new-1.0,completed,238.0,7.55,193,45,1,0,237,238,3,4,231,238,0,0,238,238,41,0,197,238,35,0,203,238
5900267,1499,309704,base,completed,269.0,7.05,169,100,32,0,237,269,0,42,227,269,53,0,216,269,44,0,225,269,91,0,178,269
5900267,1499,309704,base+,completed,282.0,7.1,136,146,0,35,247,282,57,0,225,282,48,0,234,282,75,0,207,282,47,63,172,282
5900267,1499,309704,dpv1,completed,255.0,7.1,180,75,39,0,216,255,15,0,240,255,40,0,215,255,63,0,192,255,0,19,236,255
5900267,1499,309704,dpv2,completed,245.0,7.3,168,77,31,0,214,245,36,0,209,245,0,0,245,245,0,40,205,245,37,0,208,245
5900267,1499,309704,new-0.0,completed,238.0,7.0,177,61,30,0,208,238,59,2,177,238,5,0,233,238,41,0,197,238,0,0,238,238
5900267,1499,309704,new-0.5,completed,239.0,7.55,182,57,0,0,239,239,17,0,222,239,39,0,200,239,52,4,183,239,5,1,233,239
5900267,1499,309704,new-1.0,completed,252.0,7.6,148,104,0,0,252,252,20,37,195,252,36,0,216,252,3,11,238,252,51,5,196,252
5900267,1499,247588,base,completed,278.0,7.05,174,104,90,0,188,278,48,0,230,278,65,13,200,278,0,36,242,278,41,0,237,278
5900267,1499,247588,base+,completed,284.0,6.9,129,155,52,0,232,284,0,96,188,284,43,0,241,284,67,0,217,284,45,27,212,284
5900267,1499,247588,dpv1,completed,258.0,7.25,154,104,32,0,226,258,58,0,200,258,36,0,222,258,0,34,224,258,37,24,197,258
5900267,1499,247588,dpv2,completed,233.0,7.45,207,26,23,0,210,233,26,0,207,233,19,0,214,233,16,0,217,233,0,7,226,233
5900267,1499,247588,new-0.0,completed,234.0,6.95,168,66,3,12,219,234,0,0,234,234,26,0,208,234,46,0,188,234,54,0,180,234
5900267,1499,247588,new-0.5,completed,235.0,7.4,185,50,50,0,185,235,30,0,205,235,4,0,231,235,42,0,193,235,0,0,235,235
5900267,1499,247588,new-1.0,completed,252.0,7.5,165,87,16,0,236,252,46,30,176,252,48,0,204,252,3,38,211,252,0,0,252,252
5900267,1499,203195,base,completed,255.0,7.1,169,86,0,0,255,255,44,0,211,255,46,40,169,255,46,0,209,255,14,0,241,255
5900267,1499,203195,base+,completed,295.0,6.9,134,161,42,35,218,295,63,0,232,295,64,5,226,295,81,0,214,295,0,71,224,295
5900267,1499,203195,dpv1,completed,272.0,6.9,159,113,60,0,212,272,0,62,210,272,35,0,237,272,58,0,214,272,74,0,198,272
5900267,1499,203195,dpv2,completed,274.0,7.4,143,131,65,0,209,274,0,77,197,274,34,0,240,274,39,0,235,274,78,0,196,274
5900267,1499,203195,new-0.0,completed,253.0,7.0,191,62,30,0,223,253,62,0,191,253,49,0,204,253,40,0,213,253,0,0,253,253
5900267,1499,203195,new-0.5,completed,239.0,7.45,186,53,52,0,187,239,5,0,234,239,0,0,239,239,48,0,191,239,11,1,227,239
5900267,1499,203195,new-1.0,completed,240.0,7.45,188,52,48,0,192,240,6,2,232,240,0,0,240,240,50,0,190,240,3,0,237,240
5900267,1499,178029,base,completed,279.0,6.95,185,94,93,0,186,279,0,48,231,279,52,0,227,279,90,0,189,279,39,0,240,279
5900267,1499,178029,base+,completed,261.0,7.0,154,107,35,0,226,261,50,45,166,261,25,10,226,261,0,9,252,261,53,0,208,261
5900267,1499,178029,dpv1,completed,276.0,7.2,162,114,56,0,220,276,70,0,206,276,37,0,239,276,0,41,235,276,49,12,215,276
5900267,1499,178029,dpv2,completed,274.0,7.4,156,118,63,0,211,274,0,71,203,274,32,0,242,274,35,0,239,274,74,0,200,274
5900267,1499,178029,new-0.0,completed,262.0,7.1,184,78,39,0,223,262,0,26,236,262,59,0,203,262,44,0,218,262,66,0,196,262
5900267,1499,178029,new-0.5,completed,242.0,7.45,194,48,47,0,195,242,0,0,242,242,8,0,234,242,48,0,194,242,7,0,235,242
5900267,1499,178029,new-1.0,completed,261.0,7.55,167,94,12,0,249,261,43,39,179,261,48,0,213,261,27,36,198,261,0,0,261,261
5900267,1499,239735,base,completed,281.0,6.75,134,147,61,0,220,281,0,94,187,281,38,0,243,281,42,0,239,281,91,0,190,281
5900267,1499,239735,base+,completed,316.0,7.25,99,217,0,156,160,316,93,0,223,316,67,0,249,316,66,85,165,316,49,0,267,316
5900267,1499,239735,dpv1,completed,264.0,7.1,166,98,48,0,216,264,53,0,211,264,72,0,192,264,45,22,197,264,0,22,242,264
5900267,1499,239735,dpv2,completed,271.0,7.4,140,131,63,0,208,271,0,78,193,271,37,0,234,271,45,0,226,271,80,0,191,271
5900267,1499,239735,new-0.0,completed,246.0,7.05,171,75,27,0,219,246,52,0,194,246,48,0,198,246,43,0,203,246,0,24,222,246
5900267,1499,239735,new-0.5,completed,235.0,7.6,184,51,0,0,235,235,24,7,204,235,43,0,192,235,44,0,191,235,16,0,219,235
5900267,1499,239735,new-1.0,completed,259.0,7.55,148,111,22,0,237,259,57,44,158,259,51,0,208,259,0,39,220,259,4,8,247,259
5900267,1499,675528,base,completed,256.0,7.0,175,81,77,0,179,256,0,31,225,256,33,0,223,256,37,0,219,256,56,0,200,256
5900267,1499,675528,base+,completed,264.0,7.1,186,78,58,0,206,264,0,31,233,264,68,0,196,264,39,0,225,264,33,0,231,264
5900267,1499,675528,dpv1,completed,260.0,7.05,142,118,48,0,212,260,0,69,191,260,30,5,225,260,46,0,214,260,35,0,225,260
5900267,1499,675528,dpv2,completed,247.0,7.55,185,62,0,0,247,247,21,0,226,247,8,0,239,247,60,0,187,247,62,0,185,247
5900267,1499,675528,new-0.0,completed,252.0,7.05,187,65,17,0,235,252,55,0,197,252,57,0,195,252,48,0,204,252,0,8,244,252
5900267,1499,675528,new-0.5,completed,265.0,7.5,179,86,57,0,208,265,0,26,239,265,69,0,196,265,48,0,217,265,50,0,215,265
5900267,1499,675528,new-1.0,completed,266.0,7.4,145,121,6,0,260,266,0,33,233,266,23,18,225,266,57,37,172,266,58,0,208,266
5900267,1499,380692,base,completed,266.0,7.05,163,103,80,0,186,266,42,0,224,266,53,0,213,266,0,49,217,266,72,0,194,266
5900267,1499,380692,base+,completed,235.0,7.05,181,54,51,0,184,235,15,0,220,235,0,0,235,235,7,0,228,235,54,0,181,235
5900267,1499,380692,dpv1,completed,256.0,7.05,165,91,40,0,216,256,0,42,214,256,35,0,221,256,38,0,218,256,69,0,187,256
5900267,1499,380692,dpv2,completed,257.0,7.5,154,103,48,0,209,257,59,0,198,257,1,0,256,257,0,54,203,257,35,0,222,257
5900267,1499,380692,new-0.0,completed,250.0,7.0,184,66,0,16,234,250,49,0,201,250,43,0,207,250,35,0,215,250,50,0,200,250
5900267,1499,380692,new-0.5,completed,241.0,7.5,188,53,43,0,198,241,18,0,223,241,0,0,241,241,53,0,188,241,29,0,212,241
5900267,1499,380692,new-1.0,completed,262.0,7.55,143,119,15,0,247,262,68,34,160,262,48,0,214,262,17,35,210,262,0,10,252,262
1421890,1627,310811,base,completed,358.0,7.0,113,245,0,86,272,358,124,51,183,358,65,98,195,358,113,0,245,358,97,0,261,358
1421890,1627,310811,base+,completed,348.0,7.05,185,163,96,0,252,348,111,0,237,348,61,57,230,348,126,0,222,348,0,102,246,348
1421890,1627,310811,dpv1,completed,327.0,7.35,170,157,86,0,241,327,70,51,206,327,100,0,227,327,0,76,251,327,96,10,221,327
1421890,1627,310811,dpv2,completed,334.0,7.6,130,204,0,142,192,334,82,0,252,334,88,0,246,334,62,49,223,334,96,0,238,334
1421890,1627,310811,new-0.0,completed,277.0,7.3,185,92,22,8,247,277,0,18,259,277,84,0,193,277,73,0,204,277,69,0,208,277
1421890,1627,310811,new-0.5,completed,288.0,7.9,180,108,41,0,247,288,69,0,219,288,101,0,187,288,0,39,249,288,44,0,244,288
1421890,1627,310811,new-1.0,completed,267.0,7.95,149,118,11,12,244,267,14,0,253,267,59,33,175,267,50,0,217,267,0,14,253,267
1421890,1627,208428,base,completed,358.0,7.05,125,233,0,164,194,358,136,0,222,358,96,0,262,358,69,31,258,358,89,0,269,358
1421890,1627,208428,base+,completed,383.0,7.15,127,256,134,0,249,383,70,157,156,383,0,129,254,383,99,0,284,383,165,0,218,383
1421890,1627,208428,dpv1,completed,367.0,7.45,121,246,0,140,227,367,107,0,260,367,67,152,148,367,94,0,273,367,114,0,253,367
1421890,1627,208428,dpv2,completed,333.0,7.7,131,202,0,135,198,333,67,31,235,333,76,16,241,333,94,0,239,333,90,0,243,333
1421890,1627,208428,new-0.0,completed,315.0,7.55,183,132,0,66,249,315,102,0,213,315,93,0,222,315,95,0,220,315,63,37,215,315
1421890,1627,208428,new-0.5,completed,283.0,7.8,183,100,52,0,231,283,92,0,191,283,0,29,254,283,33,8,242,283,64,0,219,283
1421890,1627,208428,new-1.0,completed,265.0,7.95,153,112,17,6,242,265,0,51,214,265,55,0,210,265,10,0,255,265,41,0,224,265
1421890,1627,460300,base,completed,390.0,7.25,118,272,97,0,293,390,152,0,238,390,69,175,146,390,105,0,285,390,0,150,240,390
1421890,1627,460300,base+,completed,349.0,7.15,134,215,67,113,169,349,0,77,272,349,100,0,249,349,102,0,247,349,95,18,236,349
1421890,1627,460300,dpv1,completed,320.0,7.55,117,203,0,44,276,320,52,0,268,320,62,116,142,320,87,0,233,320,73,2,245,320
1421890,1627,460300,dpv2,completed,328.0,7.7,170,158,71,0,257,328,69,0,259,328,106,0,222,328,0,61,267,328,105,41,182,328
1421890,1627,460300,new-0.0,completed,265.0,7.6,174,91,0,23,242,265,65,0,200,265,68,0,197,265,27,0,238,265,21,0,244,265
1421890,1627,460300,new-0.5,completed,280.0,7.8,180,100,65,1,214,280,30,0,250,280,81,0,199,280,45,0,235,280,0,34,246,280
1421890,1627,460300,new-1.0,completed,268.0,7.95,153,115,5,0,263,268,0,52,216,268,63,0,205,268,24,0,244,268,39,0,229,268
1421890,1627,309704,base,completed,304.0,6.85,132,172,50,16,238,304,55,0,249,304,0,66,238,304,25,50,229,304,56,0,248,304
1421890,1627,309704,base+,completed,314.0,7.05,174,140,84,0,230,314,82,0,232,314,59,28,227,314,86,0,228,314,0,81,233,314
1421890,1627,309704,dpv1,completed,320.0,7.55,128,192,0,42,278,320,70,95,155,320,72,0,248,320,97,0,223,320,59,0,261,320
1421890,1627,309704,dpv2,completed,356.0,7.65,143,213,149,0,207,356,75,44,237,356,105,0,251,356,0,100,256,356,102,48,206,356
1421890,1627,309704,new-0.0,completed,268.0,7.6,180,88,0,15,253,268,61,0,207,268,69,4,195,268,29,0,239,268,30,0,238,268
1421890,1627,309704,new-0.5,completed,293.0,8.05,180,113,42,4,247,293,90,0,203,293,0,35,258,293,74,0,219,293,83,0,210,293
1421890,1627,309704,new-1.0,completed,287.0,7.85,139,148,0,67,220,287,32,0,255,287,18,10,259,287,71,0,216,287,71,0,216,287
1421890,1627,247588,base,completed,351.0,7.25,156,195,71,94,186,351,123,0,228,351,101,0,250,351,0,79,272,351,95,0,256,351
1421890,1627,247588,base+,completed,325.0,7.0,144,181,97,67,161,325,73,84,168,325,27,0,298,325,0,89,236,325,30,0,295,325
1421890,1627,247588,dpv1,completed,314.0,7.65,127,187,41,0,273,314,67,94,153,314,0,85,229,314,93,0,221,314,72,0,242,314
1421890,1627,247588,dpv2,completed,322.0,7.6,121,201,0,140,182,322,83,0,239,322,84,0,238,322,61,36,225,322,80,0,242,322
1421890,1627,247588,new-0.0,completed,276.0,7.6,178,98,0,38,238,276,74,0,202,276,59,0,217,276,60,0,216,276,62,0,214,276
1421890,1627,247588,new-0.5,completed,271.0,7.9,180,91,27,0,244,271,62,3,206,271,81,0,190,271,0,26,245,271,26,0,245,271
1421890,1627,247588,new-1.0,completed,270.0,7.95,152,118,17,0,253,270,19,0,251,270,55,45,170,270,50,0,220,270,0,18,252,270
1421890,1627,203195,base,completed,320.0,6.9,92,228,62,1,257,320,0,166,154,320,48,0,272,320,98,0,222,320,37,8,275,320
1421890,1627,203195,base+,completed,342.0,7.3,182,160,0,91,251,342,117,0,225,342,98,0,244,342,69,34,239,342,122,0,220,342
1421890,1627,203195,dpv1,completed,327.0,7.3,170,157,94,0,233,327,0,75,252,327,78,0,249,327,103,0,224,327,72,54,201,327
1421890,1627,203195,dpv2,completed,328.0,7.8,157,171,82,24,222,328,66,46,216,328,92,0,236,328,97,0,231,328,0,84,244,328
1421890,1627,203195,new-0.0,completed,283.0,7.45,189,94,66,0,217,283,0,27,256,283,82,0,201,283,67,0,216,283,42,0,241,283
1421890,1627,203195,new-0.5,completed,280.0,7.8,186,94,68,0,212,280,22,2,256,280,86,0,194,280,26,0,254,280,0,24,256,280
1421890,1627,203195,new-1.0,completed,273.0,7.95,144,129,67,5,201,273,0,57,216,273,5,0,268,273,34,0,239,273,46,0,227,273
1421890,1627,178029,base,completed,299.0,7.15,122,177,62,86,151,299,33,114,152,299,0,12,287,299,39,0,260,299,29,0,270,299
1421890,1627,178029,base+,completed,294.0,6.9,170,124,63,0,231,294,0,46,248,294,49,15,230,294,70,0,224,294,69,0,225,294
1421890,1627,178029,dpv1,completed,325.0,7.5,122,203,94,0,231,325,71,102,152,325,77,0,248,325,0,30,295,325,79,14,232,325
1421890,1627,178029,dpv2,completed,349.0,7.85,165,184,70,42,237,349,115,0,234,349,0,114,235,349,139,0,210,349,103,0,246,349
1421890,1627,178029,new-0.0,completed,314.0,7.55,179,135,0,71,243,314,104,0,210,314,93,0,221,314,64,30,220,314,79,0,235,314
1421890,1627,178029,new-0.5,completed,301.0,7.75,184,117,99,0,202,301,0,42,259,301,73,0,228,301,47,18,236,301,65,0,236,301
1421890,1627,178029,new-1.0,completed,282.0,7.8,181,101,67,8,207,282,58,0,224,282,9,25,248,282,51,0,231,282,0,35,247,282
1421890,1627,239735,base,completed,374.0,7.2,108,266,0,199,175,374,67,90,217,374,67,0,307,374,95,100,179,374,95,0,279,374
1421890,1627,239735,base+,completed,385.0,7.1,112,273,101,0,284,385,70,96,219,385,0,203,182,385,127,8,250,385,167,0,218,385
1421890,1627,239735,dpv1,completed,312.0,7.65,119,193,46,0,266,312,58,105,149,312,0,90,222,312,88,0,224,312,93,0,219,312
1421890,1627,239735,dpv2,completed,357.0,7.85,152,205,98,0,259,357,67,60,230,357,0,138,219,357,159,0,198,357,120,11,226,357
1421890,1627,239735,new-0.0,completed,286.0,7.3,185,101,0,37,249,286,26,11,249,286,91,0,195,286,62,0,224,286,90,0,196,286
1421890,1627,239735,new-0.5,completed,270.0,7.75,177,93,78,0,192,270,15,15,240,270,62,6,202,270,0,25,245,270,29,0,241,270
1421890,1627,239735,new-1.0,completed,275.0,8.1,128,147,16,2,257,275,66,48,161,275,0,35,240,275,19,0,256,275,52,0,223,275
1421890,1627,675528,base,completed,339.0,6.95,177,162,98,0,241,339,0,96,243,339,100,0,239,339,121,0,218,339,66,48,225,339
1421890,1627,675528,base+,completed,386.0,7.4,122,264,65,135,186,386,95,0,291,386,0,199,187,386,115,0,271,386,158,0,228,386
1421890,1627,675528,dpv1,completed,328.0,7.4,175,153,80,0,248,328,0,75,253,328,94,0,234,328,103,0,225,328,70,40,218,328
1421890,1627,675528,dpv2,completed,349.0,7.85,171,178,94,0,255,349,65,47,237,349,0,113,236,349,140,0,209,349,101,5,243,349
1421890,1627,675528,new-0.0,completed,285.0,7.35,192,93,0,27,258,285,60,0,225,285,82,0,203,285,66,0,219,285,64,0,221,285
1421890,1627,675528,new-0.5,completed,297.0,7.85,190,107,0,39,258,297,93,0,204,297,40,3,254,297,65,0,232,297,84,0,213,297
1421890,1627,675528,new-1.0,completed,278.0,7.95,133,145,66,19,193,278,0,48,230,278,6,12,260,278,6,0,272,278,52,0,226,278
1421890,1627,380692,base,completed,358.0,7.2,151,207,0,124,234,358,59,119,180,358,104,0,254,358,127,0,231,358,88,0,270,358
1421890,1627,380692,base+,completed,274.0,7.0,182,92,0,31,243,274,58,3,213,274,41,0,233,274,86,0,188,274,22,0,252,274
1421890,1627,380692,dpv1,completed,334.0,7.4,172,162,100,0,234,334,0,83,251,334,97,0,237,334,108,0,226,334,76,47,211,334
1421890,1627,380692,dpv2,completed,353.0,7.65,151,202,139,0,214,353,74,42,237,353,110,0,243,353,0,95,258,353,104,39,210,353
1421890,1627,380692,new-0.0,completed,291.0,7.7,181,110,52,0,239,291,80,0,211,291,77,1,213,291,0,32,259,291,60,0,231,291
1421890,1627,380692,new-0.5,completed,291.0,7.65,187,104,48,0,243,291,39,0,252,291,95,0,196,291,0,30,261,291,71,3,217,291
1421890,1627,380692,new-1.0,completed,282.0,7.95,133,149,72,20,190,282,0,48,234,282,17,9,256,282,37,0,245,282,47,0,235,282
7214142,1730,310811,base,completed,357.0,7.0,119,238,25,21,311,357,24,0,333,357,36,0,321,357,42,162,153,357,0,196,161,357
7214142,1730,310811,base+,completed,332.0,6.9,141,191,27,82,223,332,47,0,285,332,0,14,318,332,17,46,269,332,49,106,177,332
7214142,1730,310811,dpv1,completed,313.0,7.1,124,189,0,0,313,313,13,0,300,313,46,65,202,313,22,83,208,313,49,43,221,313
7214142,1730,310811,dpv2,completed,286.0,7.2,159,127,15,15,256,286,26,25,235,286,34,0,252,286,3,38,245,286,0,30,256,286
7214142,1730,310811,new-0.0,completed,273.0,7.0,185,88,21,9,243,273,3,9,261,273,42,9,222,273,0,11,262,273,51,8,214,273
7214142,1730,310811,new-0.5,completed,317.0,7.35,164,153,0,10,307,317,70,27,220,317,44,13,260,317,73,0,244,317,78,35,204,317
7214142,1730,310811,new-1.0,completed,297.0,7.5,138,159,20,5,272,297,0,0,297,297,35,50,212,297,28,71,198,297,56,4,237,297
7214142,1730,208428,base,completed,350.0,6.9,101,249,31,0,319,350,17,93,240,350,0,142,208,350,14,0,336,350,39,165,146,350
7214142,1730,208428,base+,completed,312.0,7.0,111,201,6,83,223,312,0,0,312,312,42,52,218,312,17,70,225,312,45,0,267,312
7214142,1730,208428,dpv1,completed,324.0,7.05,115,209,0,3,321,324,66,71,187,324,85,34,205,324,41,42,241,324,22,28,274,324
7214142,1730,208428,dpv2,completed,305.0,7.3,116,189,63,10,232,305,43,40,222,305,22,0,283,305,0,37,268,305,9,48,248,305
7214142,1730,208428,new-0.0,completed,304.0,7.2,148,156,19,31,254,304,43,23,238,304,77,0,227,304,60,8,236,304,0,42,262,304
7214142,1730,208428,new-0.5,completed,296.0,7.4,169,127,56,19,221,296,25,33,238,296,21,0,275,296,52,12,232,296,0,33,263,296
7214142,1730,208428,new-1.0,completed,294.0,7.5,173,121,39,0,255,294,31,3,260,294,1,34,259,294,24,74,196,294,0,5,289,294
7214142,1730,460300,base,completed,324.0,6.9,123,201,0,33,291,324,43,0,281,324,51,81,192,324,4,69,251,324,36,59,229,324
7214142,1730,460300,base+,completed,284.0,6.8,160,124,0,0,284,284,17,0,267,284,22,12,250,284,8,67,209,284,33,18,233,284
7214142,1730,460300,dpv1,completed,317.0,7.3,113,204,0,21,296,317,20,92,205,317,74,12,231,317,56,44,217,317,42,0,275,317
7214142,1730,460300,dpv2,completed,308.0,7.45,132,176,25,66,217,308,0,29,279,308,5,45,258,308,48,23,237,308,58,0,250,308
7214142,1730,460300,new-0.0,completed,277.0,7.05,180,97,1,9,267,277,0,13,264,277,44,4,229,277,37,15,225,277,1,12,264,277
7214142,1730,460300,new-0.5,completed,276.0,7.4,175,101,34,0,242,276,35,16,225,276,8,0,268,276,36,40,200,276,0,9,267,276
7214142,1730,460300,new-1.0,completed,303.0,7.45,179,124,0,4,299,303,53,0,250,303,21,55,227,303,60,5,238,303,66,3,234,303
7214142,1730,309704,base,completed,346.0,6.8,113,233,0,55,291,346,19,0,327,346,37,0,309,346,14,182,150,346,51,121,174,346
7214142,1730,309704,base+,completed,319.0,6.95,147,172,0,9,310,319,34,0,285,319,89,0,230,319,23,48,248,319,66,58,195,319
7214142,1730,309704,dpv1,completed,331.0,7.0,95,236,36,56,239,331,0,0,331,331,64,86,181,331,73,69,189,331,43,11,277,331
7214142,1730,309704,dpv2,completed,317.0,7.4,123,194,0,43,274,317,56,11,250,317,42,9,266,317,81,83,153,317,45,20,252,317
7214142,1730,309704,new-0.0,completed,298.0,7.15,152,146,24,8,266,298,0,32,266,298,46,0,252,298,50,10,238,298,81,23,194,298
7214142,1730,309704,new-0.5,completed,289.0,7.4,161,128,81,0,208,289,50,7,232,289,39,0,250,289,0,40,249,289,25,0,264,289
7214142,1730,309704,new-1.0,completed,311.0,7.5,154,157,67,0,244,311,59,11,241,311,33,39,239,311,0,72,239,311,56,0,255,311
7214142,1730,247588,base,completed,353.0,7.1,75,278,11,0,342,353,63,62,228,353,43,64,246,353,0,124,229,353,42,109,202,353
7214142,1730,247588,base+,completed,304.0,6.9,136,168,0,0,304,304,38,29,237,304,47,4,253,304,71,8,225,304,14,90,200,304
7214142,1730,247588,dpv1,completed,313.0,7.2,93,220,47,73,193,313,0,0,313,313,29,54,230,313,61,55,197,313,29,1,283,313
7214142,1730,247588,dpv2,completed,327.0,7.2,98,229,16,29,282,327,66,37,224,327,42,33,252,327,0,43,284,327,37,76,214,327
7214142,1730,247588,new-0.0,completed,276.0,6.95,165,111,0,11,265,276,53,0,223,276,30,27,219,276,0,24,252,276,10,15,251,276
7214142,1730,247588,new-0.5,completed,267.0,7.35,193,74,1,6,260,267,20,18,229,267,0,13,254,267,19,0,248,267,19,17,231,267
7214142,1730,247588,new-1.0,completed,289.0,7.35,169,120,20,40,229,289,19,3,267,289,0,44,245,289,29,0,260,289,35,14,240,289
7214142,1730,203195,base,completed,337.0,6.8,121,216,9,66,262,337,46,49,242,337,39,0,298,337,0,39,298,337,55,114,168,337
7214142,1730,203195,base+,completed,332.0,7.0,127,205,50,8,274,332,54,45,233,332,0,47,285,332,66,65,201,332,83,0,249,332
7214142,1730,203195,dpv1,completed,311.0,7.15,139,172,80,8,223,311,47,23,241,311,0,13,298,311,62,28,221,311,22,46,243,311
7214142,1730,203195,dpv2,completed,299.0,7.2,124,175,34,59,206,299,59,29,211,299,15,23,261,299,0,0,299,299,0,32,267,299
7214142,1730,203195,new-0.0,completed,289.0,7.05,165,124,43,29,217,289,19,24,246,289,25,0,264,289,0,8,281,289,66,6,217,289
7214142,1730,203195,new-0.5,completed,268.0,7.35,160,108,4,0,264,268,0,14,254,268,5,34,229,268,0,39,229,268,11,29,228,268
7214142,1730,203195,new-1.0,completed,323.0,7.4,119,204,7,31,285,323,52,0,271,323,68,54,201,323,68,58,197,323,0,24,299,323
7214142,1730,178029,base,completed,358.0,7.05,98,260,72,160,126,358,51,0,307,358,0,63,295,358,36,0,322,358,8,190,160,358
7214142,1730,178029,base+,completed,275.0,6.8,180,95,18,0,257,275,22,0,253,275,32,2,241,275,7,61,207,275,0,0,275,275
7214142,1730,178029,dpv1,completed,323.0,7.0,115,208,25,0,298,323,0,0,323,323,55,69,199,323,12,89,222,323,58,48,217,323
7214142,1730,178029,dpv2,completed,299.0,7.2,147,152,12,27,260,299,24,37,238,299,29,0,270,299,16,39,244,299,0,39,260,299
7214142,1730,178029,new-0.0,completed,288.0,7.1,157,131,40,21,227,288,68,0,220,288,11,10,267,288,0,16,272,288,7,26,255,288
7214142,1730,178029,new-0.5,completed,285.0,7.35,161,124,51,11,223,285,0,5,280,285,3,39,243,285,33,0,252,285,17,26,242,285
7214142,1730,178029,new-1.0,completed,309.0,7.5,164,145,52,0,257,309,0,0,309,309,35,44,230,309,38,84,187,309,18,4,287,309
7214142,1730,239735,base,completed,331.0,6.8,125,206,0,73,258,331,50,49,232,331,10,34,287,331,62,71,198,331,20,37,274,331
7214142,1730,239735,base+,completed,286.0,6.7,155,131,56,21,209,286,0,5,281,286,42,45,199,286,14,11,261,286,2,14,270,286
7214142,1730,239735,dpv1,completed,319.0,6.85,138,181,34,1,284,319,77,32,210,319,78,34,207,319,0,48,271,319,46,16,257,319
7214142,1730,239735,dpv2,completed,301.0,7.15,137,164,0,10,291,301,50,42,209,301,34,21,246,301,64,56,181,301,18,15,268,301
7214142,1730,239735,new-0.0,completed,261.0,6.95,191,70,0,0,261,261,49,11,201,261,8,0,253,261,37,7,217,261,17,8,236,261
7214142,1730,239735,new-0.5,completed,276.0,7.4,166,110,34,9,233,276,10,1,265,276,0,20,256,276,17,46,213,276,17,0,259,276
7214142,1730,239735,new-1.0,completed,301.0,7.55,140,161,0,23,278,301,47,0,254,301,61,38,202,301,12,76,213,301,49,0,252,301
7214142,1730,675528,base,completed,340.0,6.9,97,243,21,26,293,340,37,191,112,340,0,13,327,340,26,128,186,340,24,0,316,340
7214142,1730,675528,base+,completed,311.0,6.95,136,175,0,76,235,311,20,0,291,311,16,57,238,311,60,27,224,311,52,0,259,311
7214142,1730,675528,dpv1,completed,320.0,7.1,113,207,0,35,285,320,63,0,257,320,30,72,218,320,40,50,230,320,67,0,253,320
7214142,1730,675528,dpv2,completed,290.0,7.2,146,144,23,9,258,290,38,26,226,290,0,0,290,290,4,34,252,290,64,19,207,290
7214142,1730,675528,new-0.0,completed,285.0,6.95,180,105,34,12,239,285,41,19,225,285,13,4,268,285,29,29,227,285,0,18,267,285
7214142,1730,675528,new-0.5,completed,284.0,7.4,179,105,33,20,231,284,2,21,261,284,37,2,245,284,41,6,237,284,0,22,262,284
7214142,1730,675528,new-1.0,completed,298.0,7.5,156,142,25,12,261,298,30,12,256,298,0,47,251,298,23,46,229,298,35,0,263,298
7214142,1730,380692,base,completed,296.0,6.6,110,186,0,12,284,296,51,32,213,296,5,0,291,296,2,36,258,296,40,75,181,296
7214142,1730,380692,base+,completed,317.0,6.8,134,183,46,2,269,317,0,92,225,317,62,19,236,317,40,10,267,317,52,37,228,317
7214142,1730,380692,dpv1,completed,310.0,7.15,131,179,66,0,244,310,33,26,251,310,28,56,226,310,69,43,198,310,0,0,310,310
7214142,1730,380692,dpv2,completed,298.0,7.3,132,166,23,19,256,298,0,49,249,298,37,0,261,298,18,82,198,298,34,0,264,298
7214142,1730,380692,new-0.0,completed,290.0,6.95,163,127,38,18,234,290,0,21,269,290,59,0,231,290,12,23,255,290,12,32,246,290
7214142,1730,380692,new-0.5,completed,281.0,7.3,162,119,48,10,223,281,0,29,252,281,12,11,258,281,39,0,242,281,11,22,248,281
7214142,1730,380692,new-1.0,completed,304.0,7.5,119,185,0,24,280,304,21,0,283,304,35,38,231,304,76,80,148,304,31,0,273,304
3120394,1668,310811,base,completed,450.0,7.0,71,379,0,171,279,450,14,251,185,450,10,310,130,450,8,0,442,450,30,279,141,450
3120394,1668,310811,base+,completed,271.0,6.8,157,114,0,63,208,271,8,0,263,271,34,0,237,271,7,0,264,271,51,0,220,271
3120394,1668,310811,dpv1,completed,257.0,7.3,220,37,7,0,250,257,37,0,220,257,36,0,221,257,0,0,257,257,27,0,230,257
3120394,1668,310811,dpv2,completed,313.0,7.3,129,184,51,4,258,313,78,43,192,313,0,26,287,313,19,47,247,313,33,93,187,313
3120394,1668,310811,new-0.0,completed,250.0,7.15,197,53,13,1,236,250,53,0,197,250,8,0,242,250,15,0,235,250,0,0,250,250
3120394,1668,310811,new-0.5,completed,261.0,7.45,219,42,19,0,242,261,41,0,220,261,8,0,253,261,32,0,229,261,0,1,260,261
3120394,1668,310811,new-1.0,completed,272.0,7.45,203,69,33,0,239,272,56,0,216,272,0,10,262,272,30,0,242,272,27,3,242,272
3120394,1668,208428,base,completed,274.0,6.8,157,117,17,0,257,274,0,53,221,274,31,27,216,274,32,8,234,274,18,0,256,274
3120394,1668,208428,base+,completed,272.0,6.8,216,56,41,0,231,272,47,0,225,272,19,0,253,272,0,0,272,272,56,0,216,272
3120394,1668,208428,dpv1,completed,275.0,7.15,211,64,0,0,275,275,31,17,227,275,35,0,240,275,32,0,243,275,64,0,211,275
3120394,1668,208428,dpv2,completed,283.0,7.25,128,155,58,0,225,283,0,0,283,283,14,19,250,283,43,0,240,283,23,78,182,283
3120394,1668,208428,new-0.0,completed,267.0,7.0,203,64,16,0,251,267,58,0,209,267,0,0,267,267,64,0,203,267,26,0,241,267
3120394,1668,208428,new-0.5,completed,259.0,7.45,223,36,0,0,259,259,19,0,240,259,22,0,237,259,36,0,223,259,25,0,234,259
3120394,1668,208428,new-1.0,completed,270.0,7.45,157,113,47,8,215,270,17,50,203,270,23,9,238,270,23,0,247,270,0,0,270,270
3120394,1668,460300,base,completed,435.0,6.75,78,357,0,170,265,435,46,238,151,435,44,195,196,435,51,215,169,435,0,7,428,435
3120394,1668,460300,base+,completed,278.0,6.75,162,116,0,0,278,278,11,61,206,278,55,0,223,278,23,0,255,278,53,0,225,278
3120394,1668,460300,dpv1,completed,270.0,7.2,214,56,44,0,226,270,19,17,234,270,34,0,236,270,0,0,270,270,43,0,227,270
3120394,1668,460300,dpv2,completed,269.0,7.35,159,110,42,0,227,269,0,55,214,269,24,13,232,269,40,0,229,269,2,0,267,269
3120394,1668,460300,new-0.0,completed,269.0,7.15,209,60,28,0,241,269,60,0,209,269,0,0,269,269,47,0,222,269,37,0,232,269
3120394,1668,460300,new-0.5,completed,261.0,7.35,197,64,6,0,255,261,32,0,229,261,60,0,201,261,14,4,243,261,0,0,261,261
3120394,1668,460300,new-1.0,completed,284.0,7.45,186,98,42,0,242,284,0,0,284,284,61,37,186,284,18,0,266,284,57,0,227,284
3120394,1668,309704,base,completed,283.0,6.8,122,161,41,0,242,283,0,28,255,283,29,34,220,283,14,0,269,283,22,76,185,283
3120394,1668,309704,base+,completed,280.0,7.05,110,170,2,38,240,280,7,0,273,280,16,24,240,280,0,86,194,280,50,0,230,280
3120394,1668,309704,dpv1,completed,270.0,7.3,214,56,25,0,245,270,22,16,232,270,0,1,269,270,31,0,239,270,46,0,224,270
3120394,1668,309704,dpv2,completed,291.0,7.15,135,156,0,14,277,291,4,0,287,291,42,0,249,291,33,27,231,291,37,114,140,291
3120394,1668,309704,new-0.0,completed,271.0,7.1,196,75,44,0,227,271,0,19,252,271,23,0,248,271,30,0,241,271,65,0,206,271
3120394,1668,309704,new-0.5,completed,272.0,7.4,215,57,22,0,250,272,57,0,215,272,0,0,272,272,52,0,220,272,45,0,227,272
3120394,1668,309704,new-1.0,completed,295.0,7.4,178,117,0,0,295,295,67,0,228,295,69,43,183,295,51,0,244,295,48,5,242,295
3120394,1668,247588,base,completed,285.0,6.9,130,155,20,0,265,285,0,0,285,285,30,0,255,285,58,78,149,285,61,16,208,285
3120394,1668,247588,base+,completed,300.0,6.85,138,162,48,100,152,300,50,93,157,300,27,0,273,300,12,0,288,300,0,0,300,300
3120394,1668,247588,dpv1,completed,240.0,7.25,191,49,24,0,216,240,0,23,217,240,3,0,237,240,7,2,231,240,7,0,233,240
3120394,1668,247588,dpv2,completed,264.0,7.05,145,119,0,7,257,264,26,4,234,264,36,0,228,264,2,0,262,264,17,72,175,264
3120394,1668,247588,new-0.0,completed,265.0,7.15,196,69,65,0,200,265,0,0,265,265,51,0,214,265,42,3,220,265,10,18,237,265
3120394,1668,247588,new-0.5,completed,264.0,7.4,219,45,7,0,257,264,41,0,223,264,0,0,264,264,37,4,223,264,38,0,226,264
3120394,1668,247588,new-1.0,completed,262.0,7.25,162,100,38,0,224,262,29,49,184,262,16,0,246,262,0,0,262,262,0,13,249,262
3120394,1668,203195,base,completed,287.0,6.9,158,129,40,0,247,287,17,72,198,287,0,0,287,287,46,0,241,287,20,14,253,287
3120394,1668,203195,base+,completed,271.0,7.2,196,75,32,16,223,271,0,5,266,271,52,0,219,271,15,0,256,271,24,16,231,271
3120394,1668,203195,dpv1,completed,252.0,7.2,220,32,12,0,240,252,26,0,226,252,32,0,220,252,0,0,252,252,1,0,251,252
3120394,1668,203195,dpv2,completed,269.0,7.2,144,125,61,0,208,269,0,46,223,269,24,18,227,269,13,0,256,269,21,4,244,269
3120394,1668,203195,new-0.0,completed,260.0,7.05,198,62,18,5,237,260,27,0,233,260,57,0,203,260,48,0,212,260,0,0,260,260
3120394,1668,203195,new-0.5,completed,249.0,7.3,211,38,36,0,213,249,3,0,246,249,0,0,249,249,16,0,233,249,13,2,234,249
3120394,1668,203195,new-1.0,completed,274.0,7.4,176,98,44,0,230,274,23,5,246,274,33,35,206,274,0,0,274,274,58,0,216,274
3120394,1668,178029,base,completed,371.0,6.8,133,238,0,182,189,371,44,90,237,371,31,48,292,371,53,88,230,371,37,107,227,371
3120394,1668,178029,base+,completed,269.0,6.7,211,58,58,0,211,269,11,0,258,269,40,0,229,269,0,0,269,269,23,7,239,269
3120394,1668,178029,dpv1,completed,254.0,7.3,200,54,1,2,251,254,18,15,221,254,18,0,236,254,0,0,254,254,32,5,217,254
3120394,1668,178029,dpv2,completed,271.0,7.15,157,114,38,0,233,271,11,0,260,271,3,0,268,271,0,76,195,271,44,0,227,271
3120394,1668,178029,new-0.0,completed,256.0,7.15,201,55,54,0,202,256,54,1,201,256,3,0,253,256,0,0,256,256,17,0,239,256
3120394,1668,178029,new-0.5,completed,257.0,7.5,194,63,33,13,211,257,50,0,207,257,7,0,250,257,9,0,248,257,0,0,257,257
3120394,1668,178029,new-1.0,completed,271.0,7.45,205,66,47,1,223,271,55,0,216,271,0,10,261,271,13,0,258,271,49,0,222,271
3120394,1668,239735,base,completed,267.0,6.75,158,109,15,91,161,267,0,0,267,267,18,0,249,267,9,0,258,267,14,0,253,267
3120394,1668,239735,base+,completed,316.0,6.85,142,174,52,0,264,316,18,55,243,316,0,43,273,316,62,64,190,316,60,66,190,316
3120394,1668,239735,dpv1,completed,257.0,7.1,202,55,32,0,225,257,40,7,210,257,23,0,234,257,0,0,257,257,44,4,209,257
3120394,1668,239735,dpv2,completed,250.0,7.15,167,83,44,0,206,250,0,25,225,250,23,14,213,250,6,0,244,250,14,0,236,250
3120394,1668,239735,new-0.0,completed,242.0,7.05,194,48,0,0,242,242,48,0,194,242,31,0,211,242,9,0,233,242,19,0,223,242
3120394,1668,239735,new-0.5,completed,249.0,7.3,207,42,25,0,224,249,42,0,207,249,0,0,249,249,22,0,227,249,28,0,221,249
3120394,1668,239735,new-1.0,completed,280.0,7.45,175,105,46,0,234,280,59,13,208,280,0,33,247,280,27,0,253,280,37,0,243,280
3120394,1668,675528,base,completed,282.0,6.95,125,157,42,26,214,282,0,13,269,282,22,0,260,282,26,90,166,282,35,0,247,282
3120394,1668,675528,base+,completed,282.0,6.95,169,113,13,0,269,282,18,0,264,282,50,57,175,282,0,6,276,282,49,0,233,282
3120394,1668,675528,dpv1,completed,269.0,7.4,206,63,24,0,245,269,43,13,213,269,0,1,268,269,35,0,234,269,17,10,242,269
3120394,1668,675528,dpv2,completed,279.0,7.25,137,142,10,10,259,279,0,27,252,279,48,0,231,279,58,0,221,279,4,67,208,279
3120394,1668,675528,new-0.0,completed,279.0,7.1,205,74,18,0,261,279,0,22,257,279,52,0,227,279,45,13,221,279,73,0,206,279
3120394,1668,675528,new-0.5,completed,272.0,7.4,213,59,15,0,257,272,45,0,227,272,0,0,272,272,36,0,236,272,59,0,213,272
3120394,1668,675528,new-1.0,completed,282.0,7.45,177,105,37,0,245,282,56,0,226,282,0,49,233,282,28,0,254,282,26,0,256,282
3120394,1668,380692,base,completed,294.0,6.95,112,182,49,0,245,294,29,21,244,294,12,65,217,294,22,0,272,294,0,86,208,294
3120394,1668,380692,base+,completed,247.0,6.9,194,53,42,7,198,247,2,0,245,247,0,0,247,247,4,0,243,247,12,13,222,247
3120394,1668,380692,dpv1,completed,245.0,7.25,217,28,7,0,238,245,0,2,243,245,22,0,223,245,14,0,231,245,26,0,219,245
3120394,1668,380692,dpv2,completed,279.0,7.35,149,130,50,0,229,279,3,65,211,279,29,27,223,279,45,8,226,279,0,0,279,279
3120394,1668,380692,new-0.0,completed,257.0,7.05,202,55,4,0,253,257,54,1,202,257,0,0,257,257,52,0,205,257,14,0,243,257
3120394,1668,380692,new-0.5,completed,273.0,7.45,217,56,56,0,217,273,0,0,273,273,45,0,228,273,26,0,247,273,56,0,217,273
3120394,1668,380692,new-1.0,completed,281.0,7.4,157,124,22,55,204,281,65,12,204,281,48,4,229,281,22,0,259,281,0,0,281,281
4444063,1772,310811,base,completed,336.0,7.2,119,217,31,120,185,336,16,55,265,336,0,28,308,336,16,127,193,336,36,0,300,336
4444063,1772,310811,base+,completed,364.0,6.6,101,263,86,100,178,364,58,0,306,364,26,19,319,364,12,28,324,364,0,195,169,364
4444063,1772,310811,dpv1,completed,332.0,7.3,116,216,75,1,256,332,57,20,255,332,17,26,289,332,32,76,224,332,0,62,270,332
4444063,1772,310811,dpv2,completed,333.0,7.25,113,220,41,15,277,333,88,36,209,333,10,30,293,333,59,7,267,333,0,117,216,333
4444063,1772,310811,new-0.0,completed,308.0,6.9,150,158,49,15,244,308,74,67,167,308,59,3,246,308,0,1,307,308,3,20,285,308
4444063,1772,310811,new-0.5,completed,317.0,7.35,129,188,0,0,317,317,13,0,304,317,71,84,162,317,39,23,255,317,69,32,216,317
4444063,1772,310811,new-1.0,completed,333.0,7.6,103,230,0,91,242,333,34,30,269,333,51,46,236,333,45,21,267,333,70,14,249,333
4444063,1772,208428,base,completed,460.0,6.65,114,346,33,42,385,460,0,55,405,460,11,218,231,460,43,253,164,460,26,294,140,460
4444063,1772,208428,base+,completed,330.0,6.65,148,182,7,25,298,330,75,21,234,330,34,16,280,330,0,107,223,330,56,14,260,330
4444063,1772,208428,dpv1,completed,329.0,7.05,109,220,38,0,291,329,73,84,172,329,1,20,308,329,52,17,260,329,0,88,241,329
4444063,1772,208428,dpv2,completed,337.0,7.15,109,228,41,0,296,337,15,47,275,337,71,47,219,337,0,116,221,337,55,30,252,337
4444063,1772,208428,new-0.0,completed,304.0,7.15,139,165,68,67,169,304,51,36,217,304,14,0,290,304,22,0,282,304,0,10,294,304
4444063,1772,208428,new-0.5,completed,301.0,7.45,143,158,0,28,273,301,38,60,203,301,56,0,245,301,30,0,271,301,21,14,266,301
4444063,1772,208428,new-1.0,completed,311.0,7.5,126,185,0,63,248,311,27,24,260,311,54,0,257,311,31,4,276,311,35,44,232,311
4444063,1772,460300,base,completed,527.0,6.65,74,453,57,301,169,527,3,244,280,527,0,383,144,527,74,273,180,527,26,0,501,527
4444063,1772,460300,base+,completed,353.0,6.85,118,235,32,39,282,353,14,60,279,353,25,86,242,353,53,0,300,353,0,127,226,353
4444063,1772,460300,dpv1,completed,343.0,6.85,135,208,9,65,269,343,86,80,177,343,39,0,304,343,0,37,306,343,57,37,249,343
4444063,1772,460300,dpv2,completed,328.0,7.45,101,227,24,75,229,328,71,51,206,328,5,18,305,328,47,0,281,328,0,78,250,328
4444063,1772,460300,new-0.0,completed,304.0,7.05,155,149,13,61,230,304,49,14,241,304,64,0,240,304,0,11,293,304,8,1,295,304
4444063,1772,460300,new-0.5,completed,301.0,7.15,138,163,0,0,301,301,38,46,217,301,21,26,254,301,61,0,240,301,20,30,251,301
4444063,1772,460300,new-1.0,completed,329.0,7.55,122,207,0,85,244,329,44,59,226,329,65,0,264,329,18,0,311,329,40,56,233,329
4444063,1772,309704,base,completed,401.0,7.25,105,296,19,3,379,401,39,198,164,401,0,0,401,401,29,203,169,401,42,211,148,401
4444063,1772,309704,base+,completed,365.0,7.0,93,272,86,78,201,365,10,35,320,365,0,130,235,365,64,52,249,365,28,64,273,365
4444063,1772,309704,dpv1,completed,338.0,6.9,107,231,16,52,270,338,34,17,287,338,61,3,274,338,0,25,313,338,83,88,167,338
4444063,1772,309704,dpv2,completed,343.0,7.5,111,232,89,36,218,343,54,49,240,343,6,20,317,343,0,125,218,343,31,23,289,343
4444063,1772,309704,new-0.0,completed,310.0,7.05,141,169,58,42,210,310,20,0,290,310,0,45,265,310,48,0,262,310,81,2,227,310
4444063,1772,309704,new-0.5,completed,312.0,7.3,145,167,10,1,301,312,0,3,309,312,54,89,169,312,7,39,266,312,49,38,225,312
4444063,1772,309704,new-1.0,completed,314.0,7.55,116,198,0,78,236,314,33,66,215,314,51,0,263,314,23,5,286,314,22,36,256,314
4444063,1772,247588,base,completed,479.0,6.95,81,398,86,141,252,479,47,314,118,479,0,149,330,479,57,165,257,479,9,142,328,479
4444063,1772,247588,base+,completed,354.0,6.75,109,245,60,0,294,354,31,79,244,354,0,176,178,354,35,32,287,354,13,45,296,354
4444063,1772,247588,dpv1,completed,330.0,6.85,96,234,13,70,247,330,38,0,292,330,53,16,261,330,74,98,158,330,0,29,301,330
4444063,1772,247588,dpv2,completed,343.0,7.5,101,242,86,90,167,343,19,19,305,343,0,139,204,343,50,1,292,343,30,31,282,343
4444063,1772,247588,new-0.0,completed,328.0,7.0,146,182,74,23,231,328,81,82,165,328,14,0,314,328,69,2,257,328,0,35,293,328
4444063,1772,247588,new-0.5,completed,327.0,7.2,131,196,78,66,183,327,69,26,232,327,14,36,277,327,0,11,316,327,53,2,272,327
4444063,1772,247588,new-1.0,completed,314.0,7.35,99,215,27,89,198,314,26,21,267,314,0,0,314,314,66,0,248,314,47,46,221,314
4444063,1772,203195,base,completed,452.0,6.9,84,368,4,264,184,452,0,235,217,452,27,77,348,452,83,37,332,452,61,197,194,452
4444063,1772,203195,base+,completed,360.0,6.95,103,257,9,48,303,360,52,42,266,360,0,190,170,360,39,0,321,360,80,41,239,360
4444063,1772,203195,dpv1,completed,332.0,7.15,135,197,62,0,270,332,46,31,255,332,21,15,296,332,81,66,185,332,0,64,268,332
4444063,1772,203195,dpv2,completed,360.0,7.3,96,264,85,46,229,360,31,35,294,360,19,80,261,360,60,24,276,360,0,153,207,360
4444063,1772,203195,new-0.0,completed,301.0,7.1,157,144,53,16,232,301,61,61,179,301,15,0,286,301,9,5,287,301,0,6,295,301
4444063,1772,203195,new-0.5,completed,323.0,7.25,122,201,0,75,248,323,86,10,227,323,68,27,228,323,15,3,305,323,65,9,249,323
4444063,1772,203195,new-1.0,completed,315.0,7.55,129,186,0,77,238,315,45,60,210,315,67,0,248,315,12,0,303,315,37,22,256,315
4444063,1772,178029,base,completed,448.0,6.9,82,366,0,279,169,448,26,67,355,448,2,324,122,448,23,0,425,448,60,188,200,448
4444063,1772,178029,base+,completed,335.0,6.6,117,218,6,83,246,335,68,10,257,335,0,82,253,335,52,0,283,335,30,67,238,335
4444063,1772,178029,dpv1,completed,344.0,7.0,111,233,22,70,252,344,34,0,310,344,0,31,313,344,53,15,276,344,83,94,167,344
4444063,1772,178029,dpv2,completed,364.0,7.4,88,276,35,48,281,364,80,83,201,364,8,91,265,364,51,10,303,364,0,125,239,364
4444063,1772,178029,new-0.0,completed,316.0,7.05,163,153,29,0,287,316,64,14,238,316,25,0,291,316,0,12,304,316,74,60,182,316
4444063,1772,178029,new-0.5,completed,323.0,7.3,150,173,0,4,319,323,62,81,180,323,15,0,308,323,37,34,252,323,62,42,219,323
4444063,1772,178029,new-1.0,completed,323.0,7.55,132,191,17,63,243,323,52,34,237,323,32,43,248,323,0,11,312,323,24,45,254,323
4444063,1772,239735,base,completed,326.0,6.8,104,222,54,0,272,326,0,0,326,326,74,7,245,326,52,148,126,326,13,0,313,326
4444063,1772,239735,base+,completed,332.0,6.85,129,203,38,89,205,332,0,37,295,332,80,50,202,332,21,8,303,332,58,9,265,332
4444063,1772,239735,dpv1,completed,329.0,7.2,106,223,46,82,201,329,88,7,234,329,11,21,297,329,58,6,265,329,0,86,243,329
4444063,1772,239735,dpv2,completed,372.0,7.5,93,279,96,71,205,372,20,102,250,372,0,207,165,372,63,36,273,372,38,0,334,372
4444063,1772,239735,new-0.0,completed,326.0,7.0,146,180,63,34,229,326,66,83,177,326,0,33,293,326,56,8,262,326,16,2,308,326
4444063,1772,239735,new-0.5,completed,313.0,7.35,138,175,77,77,159,313,0,0,313,313,33,0,280,313,37,14,262,313,69,22,222,313
4444063,1772,239735,new-1.0,completed,318.0,7.45,115,203,76,85,157,318,0,50,268,318,18,8,292,318,51,0,267,318,65,0,253,318
4444063,1772,675528,base,completed,385.0,6.95,100,285,54,100,231,385,83,160,142,385,67,0,318,385,0,32,353,385,61,61,263,385
4444063,1772,675528,base+,completed,334.0,6.95,145,189,12,23,299,334,77,25,232,334,57,0,277,334,47,24,263,334,0,121,213,334
4444063,1772,675528,dpv1,completed,344.0,7.0,114,230,51,4,289,344,12,60,272,344,0,36,308,344,56,29,259,344,86,94,164,344
4444063,1772,675528,dpv2,completed,362.0,7.3,91,271,58,1,303,362,85,75,202,362,17,83,262,362,0,119,243,362,30,66,266,362
4444063,1772,675528,new-0.0,completed,301.0,7.1,147,154,12,69,220,301,65,2,234,301,0,4,297,301,43,29,229,301,7,1,293,301
4444063,1772,675528,new-0.5,completed,321.0,7.35,140,181,0,0,321,321,26,0,295,321,61,82,178,321,26,30,265,321,62,42,217,321
4444063,1772,675528,new-1.0,completed,310.0,7.4,122,188,0,66,244,310,19,29,262,310,22,0,288,310,43,30,237,310,66,4,240,310
4444063,1772,380692,base,completed,451.0,6.75,81,370,19,0,432,451,38,219,194,451,6,252,193,451,74,65,312,451,0,319,132,451
4444063,1772,380692,base+,completed,364.0,7.1,109,255,0,165,199,364,58,0,306,364,18,32,314,364,87,107,170,364,35,33,296,364
4444063,1772,380692,dpv1,completed,341.0,6.85,119,222,60,10,271,341,52,24,265,341,26,43,272,341,82,101,158,341,0,31,310,341
4444063,1772,380692,dpv2,completed,348.0,7.45,85,263,52,38,258,348,73,92,183,348,14,36,298,348,0,157,191,348,37,0,311,348
4444063,1772,380692,new-0.0,completed,311.0,7.15,151,160,55,37,219,311,59,79,173,311,9,0,302,311,0,30,281,311,29,0,282,311
4444063,1772,380692,new-0.5,completed,313.0,7.2,146,167,23,0,290,313,0,26,287,313,16,0,297,313,63,70,180,313,59,31,223,313
4444063,1772,380692,new-1.0,completed,323.0,7.6,92,231,0,88,235,323,35,43,245,323,33,41,249,323,31,19,273,323,52,23,248,323
3286147,1549,310811,base,completed,289.0,7.05,104,185,59,0,230,289,69,0,220,289,4,143,142,289,0,6,283,289,2,47,240,289
3286147,1549,310811,base+,completed,311.0,7.15,125,186,77,45,189,311,87,13,211,311,24,100,187,311,26,0,285,311,0,30,281,311
3286147,1549,310811,dpv1,completed,329.0,7.25,68,261,0,57,272,329,33,37,259,329,51,31,247,329,76,107,146,329,37,120,172,329
3286147,1549,310811,dpv2,completed,313.0,7.45,99,214,101,0,212,313,67,0,246,313,0,118,195,313,37,24,252,313,28,80,205,313
3286147,1549,310811,new-0.0,completed,266.0,7.1,144,122,8,0,258,266,84,0,182,266,5,31,230,266,74,0,192,266,0,36,230,266
3286147,1549,310811,new-0.5,completed,270.0,7.4,144,126,69,12,189,270,2,23,245,270,0,38,232,270,6,5,259,270,76,1,193,270
3286147,1549,310811,new-1.0,completed,310.0,7.75,116,194,48,60,202,310,82,0,228,310,71,0,239,310,63,10,237,310,0,105,205,310
3286147,1549,208428,base,completed,348.0,7.05,82,266,47,76,225,348,71,89,188,348,51,4,293,348,0,56,292,348,107,111,130,348
3286147,1549,208428,base+,completed,324.0,7.15,98,226,58,13,253,324,0,64,260,324,56,111,157,324,69,75,180,324,44,17,263,324
3286147,1549,208428,dpv1,completed,340.0,7.3,69,271,39,35,266,340,62,0,278,340,15,45,280,340,0,179,161,340,9,171,160,340
3286147,1549,208428,dpv2,completed,313.0,7.4,111,202,28,141,144,313,0,38,275,313,94,39,180,313,23,0,290,313,70,7,236,313
3286147,1549,208428,new-0.0,completed,274.0,7.15,135,139,82,0,192,274,11,13,250,274,9,38,227,274,72,0,202,274,0,46,228,274
3286147,1549,208428,new-0.5,completed,287.0,7.2,163,124,0,44,243,287,21,0,266,287,76,0,211,287,26,23,238,287,95,0,192,287
3286147,1549,208428,new-1.0,completed,313.0,7.75,115,198,41,62,210,313,0,63,250,313,68,6,239,313,56,14,243,313,99,41,173,313
3286147,1549,460300,base,completed,413.0,7.4,72,341,104,121,188,413,67,130,216,413,0,213,200,413,48,9,356,413,33,207,173,413
3286147,1549,460300,base+,completed,281.0,7.2,152,129,81,47,153,281,18,0,263,281,0,33,248,281,29,0,252,281,63,0,218,281
3286147,1549,460300,dpv1,completed,348.0,7.25,62,286,7,68,273,348,68,51,229,348,2,57,289,348,0,171,177,348,51,127,170,348
3286147,1549,460300,dpv2,completed,303.0,7.3,123,180,77,0,226,303,0,82,221,303,97,19,187,303,44,4,255,303,43,23,237,303
3286147,1549,460300,new-0.0,completed,270.0,7.05,146,124,9,17,244,270,0,29,241,270,0,17,253,270,80,3,187,270,68,16,186,270
3286147,1549,460300,new-0.5,completed,296.0,7.25,154,142,0,56,240,296,107,0,189,296,78,0,218,296,36,8,252,296,34,16,246,296
3286147,1549,460300,new-1.0,completed,320.0,7.75,109,211,0,122,198,320,82,3,235,320,75,0,245,320,66,16,238,320,51,52,217,320
3286147,1549,309704,base,completed,261.0,7.25,152,109,11,21,229,261,8,0,253,261,0,0,261,261,5,18,238,261,77,32,152,261
3286147,1549,309704,base+,completed,287.0,7.1,120,167,46,0,241,287,10,33,244,287,0,105,182,287,0,49,238,287,73,0,214,287
3286147,1549,309704,dpv1,completed,342.0,7.3,68,274,61,41,240,342,73,0,269,342,23,47,272,342,0,165,177,342,6,171,165,342
3286147,1549,309704,dpv2,completed,315.0,7.4,107,208,28,83,204,315,0,38,277,315,22,90,203,315,76,28,211,315,92,12,211,315
3286147,1549,309704,new-0.0,completed,267.0,7.0,142,125,0,17,250,267,72,9,186,267,6,12,249,267,69,0,198,267,3,35,229,267
3286147,1549,309704,new-0.5,completed,282.0,7.2,156,126,0,44,238,282,97,4,181,282,70,0,212,282,30,7,245,282,25,11,246,282
3286147,1549,309704,new-1.0,completed,314.0,7.75,108,206,0,121,193,314,43,6,265,314,71,5,238,314,57,18,239,314,102,44,168,314
3286147,1549,247588,base,completed,318.0,7.05,50,268,13,19,286,318,0,52,266,318,52,95,171,318,77,55,186,318,10,95,213,318
3286147,1549,247588,base+,completed,306.0,7.25,94,212,19,77,210,306,81,97,128,306,0,69,237,306,67,19,220,306,23,13,270,306
3286147,1549,247588,dpv1,completed,324.0,7.4,70,254,0,27,297,324,6,59,259,324,1,176,147,324,35,42,247,324,61,113,150,324
3286147,1549,247588,dpv2,completed,306.0,7.5,88,218,34,38,234,306,81,0,225,306,0,118,188,306,66,30,210,306,31,21,254,306
3286147,1549,247588,new-0.0,completed,263.0,7.2,140,123,9,5,249,263,0,31,232,263,74,14,175,263,69,0,194,263,11,16,236,263
3286147,1549,247588,new-0.5,completed,271.0,7.4,148,123,66,0,205,271,85,0,186,271,0,50,221,271,38,14,219,271,32,0,239,271
3286147,1549,247588,new-1.0,completed,310.0,7.75,106,204,40,59,211,310,63,14,233,310,51,15,244,310,0,77,233,310,99,41,170,310
3286147,1549,203195,base,completed,256.0,7.1,173,83,4,40,212,256,0,0,256,256,54,0,202,256,21,0,235,256,13,0,243,256
3286147,1549,203195,base+,completed,329.0,7.2,116,213,53,59,217,329,40,0,289,329,0,142,187,329,71,16,242,329,102,34,193,329
3286147,1549,203195,dpv1,completed,344.0,7.25,69,275,52,54,238,344,5,38,301,344,8,71,265,344,0,166,178,344,73,113,158,344
3286147,1549,203195,dpv2,completed,311.0,7.4,101,210,18,92,201,311,0,44,267,311,12,88,211,311,74,32,205,311,91,1,219,311
3286147,1549,203195,new-0.0,completed,268.0,6.95,131,137,71,0,197,268,71,9,188,268,9,6,253,268,14,21,233,268,0,51,217,268
3286147,1549,203195,new-0.5,completed,271.0,7.65,146,125,0,39,232,271,28,4,239,271,34,4,233,271,78,0,193,271,63,0,208,271
3286147,1549,203195,new-1.0,completed,306.0,7.65,109,197,45,46,215,306,48,9,249,306,70,0,236,306,80,15,211,306,0,101,205,306
3286147,1549,178029,base,completed,359.0,7.05,51,308,71,71,217,359,48,103,208,359,96,0,263,359,0,127,232,359,104,62,193,359
3286147,1549,178029,base+,completed,302.0,7.0,135,167,0,27,275,302,90,39,173,302,72,0,230,302,37,75,190,302,37,22,243,302
3286147,1549,178029,dpv1,completed,341.0,7.3,69,272,48,56,237,341,13,32,296,341,71,0,270,341,0,162,179,341,4,181,156,341
3286147,1549,178029,dpv2,completed,311.0,7.5,108,203,18,48,245,311,70,49,192,311,89,94,128,311,0,49,262,311,21,9,281,311
3286147,1549,178029,new-0.0,completed,266.0,7.15,149,117,72,0,194,266,68,10,188,266,0,25,241,266,3,0,263,266,5,22,239,266
3286147,1549,178029,new-0.5,completed,291.0,7.25,155,136,0,53,238,291,41,15,235,291,77,0,214,291,40,3,248,291,97,0,194,291
3286147,1549,178029,new-1.0,completed,304.0,7.9,113,191,48,52,204,304,70,4,230,304,71,0,233,304,0,63,241,304,49,46,209,304
3286147,1549,239735,base,completed,312.0,6.9,93,219,0,111,201,312,74,0,238,312,21,51,240,312,22,0,290,312,83,86,143,312
3286147,1549,239735,base+,completed,333.0,7.15,92,241,69,87,177,333,19,103,211,333,23,117,193,333,93,25,215,333,0,29,304,333
3286147,1549,239735,dpv1,completed,321.0,7.25,63,258,7,59,255,321,67,36,218,321,8,36,277,321,0,153,168,321,30,112,179,321
3286147,1549,239735,dpv2,completed,294.0,7.4,114,180,69,0,225,294,87,3,204,294,0,97,197,294,43,29,222,294,36,14,244,294
3286147,1549,239735,new-0.0,completed,260.0,7.3,126,134,17,0,243,260,46,0,214,260,0,60,200,260,69,0,191,260,11,22,227,260
3286147,1549,239735,new-0.5,completed,277.0,7.45,156,121,66,0,211,277,30,5,242,277,0,51,226,277,93,4,180,277,36,0,241,277
3286147,1549,239735,new-1.0,completed,316.0,7.8,115,201,0,107,209,316,55,24,237,316,74,0,242,316,53,12,251,316,117,35,164,316
3286147,1549,675528,base,completed,399.0,7.1,81,318,102,168,129,399,44,183,172,399,0,57,342,399,122,132,145,399,66,0,333,399
3286147,1549,675528,base+,completed,305.0,7.0,101,204,61,0,244,305,15,106,184,305,18,11,276,305,0,114,191,305,88,7,210,305
3286147,1549,675528,dpv1,completed,344.0,7.1,65,279,72,0,272,344,18,87,239,344,24,42,278,344,0,173,171,344,52,123,169,344
3286147,1549,675528,dpv2,completed,317.0,7.4,107,210,9,88,220,317,0,39,278,317,8,93,216,317,65,32,220,317,82,15,220,317
3286147,1549,675528,new-0.0,completed,268.0,7.05,150,118,73,0,195,268,17,7,244,268,72,7,189,268,31,0,237,268,0,32,236,268
3286147,1549,675528,new-0.5,completed,292.0,7.25,152,140,0,52,240,292,37,0,255,292,76,0,216,292,99,12,181,292,50,0,242,292
3286147,1549,675528,new-1.0,completed,309.0,7.75,104,205,45,40,224,309,85,9,215,309,69,0,240,309,54,19,236,309,0,103,206,309
3286147,1549,380692,base,completed,320.0,7.4,146,174,63,5,252,320,71,8,241,320,94,3,223,320,51,105,164,320,0,65,255,320
3286147,1549,380692,base+,completed,282.0,7.15,151,131,0,42,240,282,16,8,258,282,73,0,209,282,24,77,181,282,64,0,218,282
3286147,1549,380692,dpv1,completed,328.0,7.2,72,256,8,63,257,328,64,37,227,328,3,33,292,328,0,158,170,328,39,110,179,328
3286147,1549,380692,dpv2,completed,307.0,7.4,96,211,6,0,301,307,84,17,206,307,4,94,209,307,71,36,200,307,0,95,212,307
3286147,1549,380692,new-0.0,completed,261.0,7.05,132,129,0,44,217,261,71,7,183,261,13,0,248,261,16,3,242,261,51,7,203,261
3286147,1549,380692,new-0.5,completed,263.0,7.65,153,110,67,11,185,263,4,13,246,263,0,27,236,263,71,0,192,263,7,0,256,263
3286147,1549,380692,new-1.0,completed,301.0,7.75,109,192,0,109,192,301,71,0,230,301,65,15,221,301,38,16,247,301,39,60,202,301
9447568,1604,310811,base,completed,402.0,7.05,50,352,9,289,104,402,0,154,248,402,60,0,342,402,20,54,328,402,79,206,117,402
9447568,1604,310811,base+,completed,291.0,7.25,133,158,7,21,263,291,74,8,209,291,0,31,260,291,20,33,238,291,62,29,200,291
9447568,1604,310811,dpv1,completed,313.0,7.55,98,215,0,39,274,313,74,0,239,313,61,23,229,313,6,80,227,313,17,118,178,313
9447568,1604,310811,dpv2,completed,307.0,7.35,77,230,20,51,236,307,0,19,288,307,8,136,163,307,67,0,240,307,78,0,229,307
9447568,1604,310811,new-0.0,completed,276.0,7.0,159,117,0,0,276,276,70,5,201,276,70,0,206,276,14,3,259,276,23,42,211,276
9447568,1604,310811,new-0.5,completed,276.0,7.35,174,102,73,0,203,276,21,17,238,276,71,0,205,276,35,21,220,276,0,0,276,276
9447568,1604,310811,new-1.0,completed,289.0,7.3,132,157,32,48,209,289,18,26,245,289,0,12,277,289,77,0,212,289,56,24,209,289
9447568,1604,208428,base,completed,370.0,7.2,54,316,63,100,207,370,74,0,296,370,0,34,336,370,21,242,107,370,10,92,268,370
9447568,1604,208428,base+,completed,292.0,7.15,133,159,55,0,237,292,59,28,205,292,7,62,223,292,16,62,214,292,0,32,260,292
9447568,1604,208428,dpv1,completed,313.0,7.35,134,179,15,80,218,313,74,1,238,313,7,103,203,313,57,0,256,313,0,56,257,313
9447568,1604,208428,dpv2,completed,299.0,7.4,126,173,66,0,233,299,0,13,286,299,21,106,172,299,63,0,236,299,8,46,245,299
9447568,1604,208428,new-0.0,completed,291.0,7.1,163,128,59,0,232,291,85,0,206,291,12,47,232,291,19,54,218,291,0,25,266,291
9447568,1604,208428,new-0.5,completed,280.0,7.55,160,120,0,12,268,280,6,36,238,280,58,0,222,280,18,41,221,280,55,21,204,280
9447568,1604,208428,new-1.0,completed,295.0,7.55,135,160,75,0,220,295,42,17,236,295,60,29,206,295,39,16,240,295,0,64,231,295
9447568,1604,460300,base,completed,432.0,6.9,62,370,37,252,143,432,9,187,236,432,23,19,390,432,0,315,117,432,61,75,296,432
9447568,1604,460300,base+,completed,322.0,7.1,80,242,0,32,290,322,92,111,119,322,7,55,260,322,64,0,258,322,22,58,242,322
9447568,1604,460300,dpv1,completed,306.0,7.2,149,157,80,0,226,306,61,0,245,306,20,69,217,306,10,99,197,306,0,32,274,306
9447568,1604,460300,dpv2,completed,301.0,7.4,176,125,0,53,248,301,63,0,238,301,20,14,267,301,89,25,187,301,8,77,216,301
9447568,1604,460300,new-0.0,completed,304.0,7.15,165,139,80,4,220,304,12,63,229,304,0,38,266,304,63,0,241,304,26,52,226,304
9447568,1604,460300,new-0.5,completed,300.0,7.45,154,146,24,57,219,300,11,51,238,300,91,0,209,300,72,0,228,300,0,39,261,300
9447568,1604,460300,new-1.0,completed,292.0,7.55,123,169,56,0,236,292,36,17,239,292,0,8,284,292,24,33,235,292,62,67,163,292
9447568,1604,309704,base,completed,372.0,7.1,49,323,68,0,304,372,0,62,310,372,67,92,213,372,77,196,99,372,52,57,263,372
9447568,1604,309704,base+,completed,351.0,6.85,125,226,102,0,249,351,19,64,268,351,61,83,207,351,8,181,162,351,0,51,300,351
9447568,1604,309704,dpv1,completed,303.0,7.5,139,164,0,41,262,303,16,68,219,303,7,80,216,303,67,27,209,303,52,2,249,303
9447568,1604,309704,dpv2,completed,305.0,7.25,82,223,20,48,237,305,0,23,282,305,9,122,174,305,83,0,222,305,60,12,233,305
9447568,1604,309704,new-0.0,completed,285.0,7.1,159,126,10,24,251,285,93,4,188,285,0,28,257,285,69,0,216,285,21,40,224,285
9447568,1604,309704,new-0.5,completed,287.0,7.45,169,118,12,37,238,287,66,0,221,287,24,52,211,287,66,0,221,287,0,27,260,287
9447568,1604,309704,new-1.0,completed,287.0,7.65,150,137,54,0,233,287,0,24,263,287,62,0,225,287,38,24,225,287,39,27,221,287
9447568,1604,247588,base,completed,349.0,7.45,89,260,45,107,197,349,0,0,349,349,30,207,112,349,71,0,278,349,80,46,223,349
9447568,1604,247588,base+,completed,326.0,6.95,92,234,10,129,187,326,89,0,237,326,0,33,293,326,57,0,269,326,20,155,151,326
9447568,1604,247588,dpv1,completed,310.0,7.2,135,175,55,0,255,310,76,0,234,310,22,98,190,310,12,90,208,310,0,42,268,310
9447568,1604,247588,dpv2,completed,323.0,7.2,46,277,18,82,223,323,53,0,270,323,78,128,117,323,7,69,247,323,0,31,292,323
9447568,1604,247588,new-0.0,completed,268.0,6.95,178,90,64,0,204,268,0,0,268,268,71,7,190,268,36,0,232,268,19,12,237,268
9447568,1604,247588,new-0.5,completed,288.0,7.55,159,129,0,40,248,288,14,53,221,288,52,0,236,288,5,63,220,288,64,9,215,288
9447568,1604,247588,new-1.0,completed,282.0,7.55,148,134,56,0,226,282,48,14,220,282,9,47,226,282,0,32,250,282,20,56,206,282
9447568,1604,203195,base,completed,362.0,7.35,79,283,0,39,323,362,16,238,108,362,45,190,127,362,6,9,347,362,10,105,247,362
9447568,1604,203195,base+,completed,325.0,7.0,125,200,0,123,202,325,5,142,178,325,73,0,252,325,58,0,267,325,17,13,295,325
9447568,1604,203195,dpv1,completed,346.0,7.5,61,285,61,0,285,346,0,42,304,346,58,115,173,346,19,115,212,346,8,150,188,346
9447568,1604,203195,dpv2,completed,311.0,7.5,168,143,0,58,253,311,57,0,254,311,88,0,223,311,19,66,226,311,6,75,230,311
9447568,1604,203195,new-0.0,completed,299.0,7.05,157,142,66,1,232,299,11,52,236,299,0,33,266,299,74,11,214,299,24,49,226,299
9447568,1604,203195,new-0.5,completed,300.0,7.65,161,139,61,0,239,300,0,34,266,300,9,72,219,300,21,52,227,300,80,3,217,300
9447568,1604,203195,new-1.0,completed,301.0,7.45,131,170,58,0,243,301,33,48,220,301,41,74,186,301,0,12,289,301,74,0,227,301
9447568,1604,178029,base,completed,371.0,7.15,76,295,51,0,320,371,35,52,284,371,0,172,199,371,32,112,227,371,43,206,122,371
9447568,1604,178029,base+,completed,295.0,7.05,146,149,51,0,244,295,19,65,211,295,71,0,224,295,10,62,223,295,0,38,257,295
9447568,1604,178029,dpv1,completed,297.0,7.3,141,156,70,16,211,297,55,0,242,297,20,70,207,297,0,43,254,297,9,27,261,297
9447568,1604,178029,dpv2,completed,299.0,7.2,107,192,57,51,191,299,61,0,238,299,23,51,225,299,0,22,277,299,10,71,218,299
9447568,1604,178029,new-0.0,completed,275.0,7.25,167,108,0,2,273,275,61,3,211,275,5,43,227,275,53,0,222,275,12,44,219,275
9447568,1604,178029,new-0.5,completed,292.0,7.5,145,147,15,45,232,292,0,33,259,292,8,56,228,292,60,0,232,292,64,26,202,292
9447568,1604,178029,new-1.0,completed,301.0,7.6,161,140,64,0,237,301,0,27,274,301,67,10,224,301,49,39,213,301,61,22,218,301
9447568,1604,239735,base,completed,323.0,7.15,133,190,57,0,266,323,20,1,302,323,9,106,208,323,0,142,181,323,60,58,205,323
9447568,1604,239735,base+,completed,327.0,6.8,73,254,10,157,160,327,54,39,234,327,20,90,217,327,91,0,236,327,0,39,288,327
9447568,1604,239735,dpv1,completed,283.0,7.25,136,147,0,34,249,283,18,59,206,283,51,0,232,283,64,24,195,283,5,35,243,283
9447568,1604,239735,dpv2,completed,288.0,7.5,105,183,0,17,271,288,18,108,162,288,57,0,231,288,54,0,234,288,7,57,224,288
9447568,1604,239735,new-0.0,completed,293.0,7.2,153,140,67,2,224,293,0,46,247,293,58,4,231,293,21,58,214,293,8,67,218,293
9447568,1604,239735,new-0.5,completed,262.0,7.5,181,81,60,0,202,262,70,0,192,262,0,0,262,262,13,19,230,262,24,3,235,262
9447568,1604,239735,new-1.0,completed,291.0,7.7,116,175,42,28,221,291,48,61,182,291,41,30,220,291,64,16,211,291,0,0,291,291
9447568,1604,675528,base,completed,325.0,6.85,105,220,55,119,151,325,54,0,271,325,23,112,190,325,0,112,213,325,11,6,308,325
9447568,1604,675528,base+,completed,311.0,7.05,106,205,0,93,218,311,84,0,227,311,5,71,235,311,64,0,247,311,18,55,238,311
9447568,1604,675528,dpv1,completed,316.0,7.2,106,210,54,0,262,316,86,0,230,316,10,66,240,316,0,52,264,316,23,114,179,316
9447568,1604,675528,dpv2,completed,319.0,7.3,98,221,23,125,171,319,0,24,295,319,9,82,228,319,68,0,251,319,74,19,226,319
9447568,1604,675528,new-0.0,completed,298.0,7.15,159,139,76,21,201,298,12,46,240,298,0,32,266,298,72,0,226,298,26,42,230,298
9447568,1604,675528,new-0.5,completed,289.0,7.35,158,131,21,54,214,289,73,4,212,289,63,0,226,289,0,30,259,289,9,36,244,289
9447568,1604,675528,new-1.0,completed,305.0,7.6,129,176,0,0,305,305,60,15,230,305,55,53,197,305,43,0,262,305,82,65,158,305
9447568,1604,380692,base,completed,339.0,7.1,94,245,37,0,302,339,25,202,112,339,0,136,203,339,54,0,285,339,51,0,288,339
9447568,1604,380692,base+,completed,288.0,7.0,114,174,11,38,239,288,0,25,263,288,63,0,225,288,23,36,229,288,72,41,175,288
9447568,1604,380692,dpv1,completed,310.0,7.4,129,181,0,53,257,310,57,0,253,310,17,111,182,310,70,0,240,310,6,51,253,310
9447568,1604,380692,dpv2,completed,299.0,7.4,129,170,69,0,230,299,0,15,284,299,19,101,179,299,63,0,236,299,8,43,248,299
9447568,1604,380692,new-0.0,completed,273.0,6.85,163,110,23,39,211,273,55,1,217,273,10,34,229,273,63,0,210,273,0,14,259,273
9447568,1604,380692,new-0.5,completed,301.0,7.65,155,146,58,0,243,301,0,40,261,301,9,67,225,301,22,60,219,301,93,0,208,301
9447568,1604,380692,new-1.0,completed,293.0,7.4,143,150,59,0,234,293,63,42,188,293,54,21,218,293,24,14,255,293,0,39,254,293
6550633,1777,310811,base,completed,376.0,7.0,69,307,23,0,353,376,22,157,197,376,0,167,209,376,12,218,146,376,36,0,340,376
6550633,1777,310811,base+,completed,320.0,7.1,100,220,20,54,246,320,27,17,276,320,0,23,297,320,37,92,191,320,4,63,253,320
6550633,1777,310811,dpv1,completed,321.0,7.25,92,229,25,123,173,321,15,44,262,321,21,25,275,321,33,18,270,321,0,93,228,321
6550633,1777,310811,dpv2,completed,309.0,7.6,150,159,3,51,255,309,26,17,266,309,0,8,301,309,29,86,194,309,18,66,225,309
6550633,1777,310811,new-0.0,completed,281.0,6.95,175,106,24,5,252,281,10,26,245,281,29,13,239,281,0,22,259,281,38,12,231,281
6550633,1777,310811,new-0.5,completed,291.0,7.35,161,130,14,41,236,291,26,10,255,291,41,56,194,291,0,9,282,291,25,0,266,291
6550633,1777,310811,new-1.0,completed,276.0,7.3,159,117,5,29,242,276,3,10,263,276,18,56,202,276,0,0,276,276,17,20,239,276
6550633,1777,208428,base,completed,390.0,6.9,85,305,22,0,368,390,38,104,248,390,0,170,220,390,17,99,274,390,2,267,121,390
6550633,1777,208428,base+,completed,301.0,6.95,179,122,7,0,294,301,20,57,224,301,21,65,215,301,0,23,278,301,37,28,236,301
6550633,1777,208428,dpv1,completed,337.0,7.3,92,245,36,110,191,337,15,48,274,337,1,55,281,337,22,30,285,337,0,102,235,337
6550633,1777,208428,dpv2,completed,323.0,7.5,117,206,9,52,262,323,20,50,253,323,0,30,293,323,39,113,171,323,35,23,265,323
6550633,1777,208428,new-0.0,completed,311.0,6.95,157,154,19,25,267,311,0,43,268,311,39,27,245,311,31,73,207,311,12,33,266,311
6550633,1777,208428,new-0.5,completed,295.0,7.4,156,139,0,34,261,295,15,14,266,295,22,78,195,295,4,23,268,295,23,9,263,295
6550633,1777,208428,new-1.0,completed,296.0,7.3,145,151,4,49,243,296,29,4,263,296,18,88,190,296,0,0,296,296,14,28,254,296
6550633,1777,460300,base,completed,437.0,7.1,62,375,10,41,386,437,64,199,174,437,69,265,103,437,50,203,184,437,0,0,437,437
6550633,1777,460300,base+,completed,317.0,7.2,105,212,21,39,257,317,24,95,198,317,1,14,302,317,16,108,193,317,0,16,301,317
6550633,1777,460300,dpv1,completed,339.0,7.2,132,207,18,46,275,339,34,98,207,339,0,47,292,339,4,62,273,339,24,96,219,339
6550633,1777,460300,dpv2,completed,291.0,7.4,151,140,0,15,276,291,24,58,209,291,28,21,242,291,0,5,286,291,16,47,228,291
6550633,1777,460300,new-0.0,completed,282.0,7.0,198,84,2,26,254,282,15,10,257,282,32,3,247,282,0,23,259,282,31,6,245,282
6550633,1777,460300,new-0.5,completed,301.0,7.55,174,127,11,41,249,301,29,1,271,301,0,11,290,301,39,60,202,301,38,8,255,301
6550633,1777,460300,new-1.0,completed,293.0,7.45,151,142,0,20,273,293,3,0,290,293,12,26,255,293,32,60,201,293,23,41,229,293
6550633,1777,309704,base,completed,384.0,7.4,63,321,61,91,232,384,42,138,204,384,0,0,384,384,32,61,291,384,27,192,165,384
6550633,1777,309704,base+,completed,324.0,7.05,111,213,0,24,300,324,25,42,257,324,5,34,285,324,23,73,228,324,29,116,179,324
6550633,1777,309704,dpv1,completed,305.0,7.45,144,161,4,61,240,305,22,29,254,305,0,2,303,305,37,35,233,305,20,66,219,305
6550633,1777,309704,dpv2,completed,301.0,7.3,169,132,22,60,219,301,6,18,277,301,30,19,252,301,19,59,223,301,0,18,283,301
6550633,1777,309704,new-0.0,completed,295.0,7.0,181,114,15,30,250,295,26,4,265,295,38,11,246,295,0,32,263,295,45,2,248,295
6550633,1777,309704,new-0.5,completed,307.0,7.1,154,153,17,8,282,307,6,28,273,307,33,91,183,307,0,35,272,307,27,27,253,307
6550633,1777,309704,new-1.0,completed,310.0,7.4,123,187,35,40,235,310,22,49,239,310,6,47,257,310,34,29,247,310,0,38,272,310
6550633,1777,247588,base,completed,527.0,6.7,77,450,33,264,230,527,2,379,146,527,26,267,234,527,0,0,527,527,11,380,136,527
6550633,1777,247588,base+,completed,338.0,6.9,104,234,26,68,244,338,53,95,190,338,30,21,287,338,0,71,267,338,14,57,267,338
6550633,1777,247588,dpv1,completed,306.0,7.35,125,181,0,80,226,306,12,50,244,306,26,45,235,306,39,61,206,306,4,0,302,306
6550633,1777,247588,dpv2,completed,296.0,7.35,158,138,0,21,275,296,15,18,263,296,30,42,224,296,23,70,203,296,32,11,253,296
6550633,1777,247588,new-0.0,completed,286.0,7.25,149,137,11,25,250,286,0,0,286,286,26,78,182,286,26,25,235,286,21,6,259,286
6550633,1777,247588,new-0.5,completed,294.0,7.35,148,146,4,64,226,294,19,20,255,294,27,30,237,294,37,30,227,294,0,23,271,294
6550633,1777,247588,new-1.0,completed,289.0,7.55,135,154,6,38,245,289,15,17,257,289,0,45,244,289,25,51,213,289,17,10,262,289
6550633,1777,203195,base,completed,463.0,6.85,57,406,0,27,436,463,12,289,162,463,1,75,387,463,40,303,120,463,47,257,159,463
6550633,1777,203195,base+,completed,307.0,6.85,145,162,0,17,290,307,23,31,253,307,9,56,242,307,42,49,216,307,34,21,252,307
6550633,1777,203195,dpv1,completed,328.0,7.05,142,186,0,48,280,328,16,75,237,328,31,46,251,328,6,61,261,328,46,50,232,328
6550633,1777,203195,dpv2,completed,295.0,7.35,167,128,5,7,283,295,0,1,294,295,24,62,209,295,30,23,242,295,23,40,232,295
6550633,1777,203195,new-0.0,completed,290.0,7.15,160,130,29,3,258,290,13,21,256,290,0,48,242,290,32,12,246,290,38,18,234,290
6550633,1777,203195,new-0.5,completed,302.0,7.0,155,147,12,20,270,302,35,59,208,302,34,10,258,302,27,0,275,302,0,52,250,302
6550633,1777,203195,new-1.0,completed,298.0,7.4,137,161,24,15,259,298,13,24,261,298,1,52,245,298,30,18,250,298,0,54,244,298
6550633,1777,178029,base,completed,390.0,7.0,77,313,20,58,312,390,38,236,116,390,13,27,350,390,0,141,249,390,42,116,232,390
6550633,1777,178029,base+,completed,324.0,7.1,135,189,35,55,234,324,24,48,252,324,0,27,297,324,7,63,254,324,19,47,258,324
6550633,1777,178029,dpv1,completed,308.0,7.1,133,175,18,17,273,308,0,62,246,308,2,19,287,308,21,43,244,308,10,84,214,308
6550633,1777,178029,dpv2,completed,316.0,7.6,133,183,14,49,253,316,37,1,278,316,0,15,301,316,30,109,177,316,24,49,243,316
6550633,1777,178029,new-0.0,completed,290.0,6.9,179,111,19,5,266,290,37,17,236,290,30,20,240,290,0,30,260,290,4,27,259,290
6550633,1777,178029,new-0.5,completed,308.0,7.3,131,177,45,5,258,308,36,21,251,308,0,56,252,308,23,23,262,308,47,49,212,308
6550633,1777,178029,new-1.0,completed,293.0,7.25,111,182,14,24,255,293,1,47,245,293,30,78,185,293,10,0,283,293,0,34,259,293
6550633,1777,239735,base,completed,414.0,6.9,72,342,1,113,300,414,0,0,414,414,47,246,121,414,53,49,312,414,32,284,98,414
6550633,1777,239735,base+,completed,325.0,7.3,97,228,27,53,245,325,12,62,251,325,31,75,219,325,20,90,215,325,0,40,285,325
6550633,1777,239735,dpv1,completed,307.0,7.1,147,160,38,16,253,307,30,62,215,307,22,11,274,307,33,79,195,307,0,16,291,307
6550633,1777,239735,dpv2,completed,294.0,7.25,123,171,1,40,253,294,0,30,264,294,7,61,226,294,18,68,208,294,27,13,254,294
6550633,1777,239735,new-0.0,completed,277.0,7.15,161,116,33,11,233,277,26,20,231,277,7,67,203,277,16,15,246,277,0,2,275,277
6550633,1777,239735,new-0.5,completed,280.0,7.3,142,138,20,2,258,280,25,22,233,280,30,69,181,280,12,19,249,280,0,16,264,280
6550633,1777,239735,new-1.0,completed,280.0,7.25,143,137,21,13,246,280,26,8,246,280,29,69,182,280,13,24,243,280,0,16,264,280
6550633,1777,675528,base,completed,416.0,7.0,79,337,22,33,361,416,30,249,137,416,0,74,342,416,47,166,203,416,1,214,201,416
6550633,1777,675528,base+,completed,310.0,6.9,174,136,5,17,288,310,26,22,262,310,32,58,220,310,0,5,305,310,20,74,216,310
6550633,1777,675528,dpv1,completed,334.0,7.3,139,195,1,71,262,334,32,93,209,334,0,38,296,334,16,31,287,334,25,74,235,334
6550633,1777,675528,dpv2,completed,308.0,7.3,181,127,19,57,232,308,47,29,232,308,0,37,271,308,29,0,279,308,10,28,270,308
6550633,1777,675528,new-0.0,completed,286.0,7.15,180,106,23,3,260,286,11,23,252,286,0,53,233,286,40,5,241,286,33,3,250,286
6550633,1777,675528,new-0.5,completed,306.0,7.3,140,166,23,0,283,306,22,23,261,306,33,93,180,306,17,31,258,306,0,25,281,306
6550633,1777,675528,new-1.0,completed,300.0,7.25,133,167,12,23,265,300,14,9,277,300,21,96,183,300,2,28,270,300,0,33,267,300
6550633,1777,380692,base,completed,317.0,6.75,80,237,17,132,168,317,0,70,247,317,37,46,234,317,1,0,316,317,30,0,287,317
6550633,1777,380692,base+,completed,306.0,6.95,150,156,31,6,269,306,18,55,233,306,0,44,262,306,10,25,271,306,33,53,220,306
6550633,1777,380692,dpv1,completed,313.0,6.9,150,163,24,32,257,313,34,81,198,313,4,14,295,313,18,86,209,313,0,9,304,313
6550633,1777,380692,dpv2,completed,313.0,7.15,147,166,19,70,224,313,38,72,203,313,6,33,274,313,33,9,271,313,0,17,296,313
6550633,1777,380692,new-0.0,completed,285.0,7.15,167,118,19,2,264,285,9,17,259,285,0,45,240,285,30,27,228,285,33,11,241,285
6550633,1777,380692,new-0.5,completed,310.0,7.45,142,168,5,58,247,310,20,37,253,310,0,30,280,310,29,63,218,310,36,15,259,310
6550633,1777,380692,new-1.0,completed,302.0,7.4,142,160,6,50,246,302,36,11,255,302,0,23,279,302,28,58,216,302,22,39,241,302
6828407,1703,310811,base,completed,288.0,7.05,144,144,0,73,215,288,1,0,287,288,43,0,245,288,21,37,230,288,48,0,240,288
6828407,1703,310811,base+,completed,275.0,7.0,218,57,18,0,257,275,52,0,223,275,57,0,218,275,0,0,275,275,14,0,261,275
6828407,1703,310811,dpv1,completed,270.0,7.2,185,85,0,30,240,270,23,0,247,270,21,0,249,270,12,8,250,270,55,0,215,270
6828407,1703,310811,dpv2,completed,311.0,7.45,157,154,104,1,206,311,59,0,252,311,6,60,245,311,51,6,254,311,0,43,268,311
6828407,1703,310811,new-0.0,completed,248.0,7.15,198,50,49,0,199,248,3,0,245,248,13,1,234,248,0,0,248,248,12,0,236,248
6828407,1703,310811,new-0.5,completed,256.0,7.55,205,51,19,0,237,256,6,0,250,256,0,0,256,256,28,0,228,256,51,0,205,256
6828407,1703,310811,new-1.0,completed,276.0,7.45,167,109,27,16,233,276,1,0,275,276,36,0,240,276,0,0,276,276,41,52,183,276
6828407,1703,208428,base,completed,260.0,7.15,230,30,10,0,250,260,5,0,255,260,15,0,245,260,0,0,260,260,30,0,230,260
6828407,1703,208428,base+,completed,299.0,6.7,196,103,0,0,299,299,47,37,215,299,70,0,229,299,24,1,274,299,72,5,222,299
6828407,1703,208428,dpv1,completed,346.0,7.0,177,169,83,0,263,346,118,0,228,346,128,0,218,346,0,77,269,346,79,21,246,346
6828407,1703,208428,dpv2,completed,284.0,7.3,187,97,46,0,238,284,37,0,247,284,0,35,249,284,43,0,241,284,2,35,247,284
6828407,1703,208428,new-0.0,completed,253.0,7.1,209,44,0,0,253,253,11,0,242,253,44,0,209,253,21,0,232,253,34,0,219,253
6828407,1703,208428,new-0.5,completed,264.0,7.5,202,62,22,0,242,264,25,0,239,264,0,0,264,264,62,0,202,264,6,0,258,264
6828407,1703,208428,new-1.0,completed,269.0,7.55,209,60,13,19,237,269,41,0,228,269,6,0,263,269,41,0,228,269,0,0,269,269
6828407,1703,460300,base,completed,311.0,6.85,207,104,0,0,311,311,30,15,266,311,80,6,225,311,83,0,228,311,81,0,230,311
6828407,1703,460300,base+,completed,342.0,7.1,187,155,0,61,281,342,116,0,226,342,114,0,228,342,89,0,253,342,68,18,256,342
6828407,1703,460300,dpv1,completed,345.0,7.05,191,154,104,0,241,345,78,0,267,345,105,0,240,345,0,59,286,345,58,27,260,345
6828407,1703,460300,dpv2,completed,298.0,7.1,167,131,49,0,249,298,64,0,234,298,0,22,276,298,58,0,240,298,22,52,224,298
6828407,1703,460300,new-0.0,completed,271.0,7.1,212,59,59,0,212,271,0,0,271,271,15,0,256,271,54,0,217,271,42,0,229,271
6828407,1703,460300,new-0.5,completed,259.0,7.55,211,48,12,0,247,259,12,0,247,259,0,0,259,259,21,0,238,259,48,0,211,259
6828407,1703,460300,new-1.0,completed,277.0,7.55,198,79,12,39,226,277,40,0,237,277,0,0,277,277,38,0,239,277,12,0,265,277
6828407,1703,309704,base,completed,282.0,6.75,170,112,47,0,235,282,57,0,225,282,4,21,257,282,25,0,257,282,0,55,227,282
6828407,1703,309704,base+,completed,293.0,6.95,214,79,0,0,293,293,76,0,217,293,61,0,232,293,71,0,222,293,19,3,271,293
6828407,1703,309704,dpv1,completed,345.0,7.25,166,179,127,0,218,345,105,0,240,345,80,0,265,345,78,33,234,345,0,78,267,345
6828407,1703,309704,dpv2,completed,302.0,7.35,181,121,0,0,302,302,54,21,227,302,75,33,194,302,73,0,229,302,28,0,274,302
6828407,1703,309704,new-0.0,completed,271.0,7.1,217,54,0,0,271,271,46,0,225,271,54,0,217,271,18,0,253,271,41,0,230,271
6828407,1703,309704,new-0.5,completed,266.0,7.55,191,75,12,0,254,266,20,0,246,266,0,0,266,266,36,0,230,266,75,0,191,266
6828407,1703,309704,new-1.0,completed,273.0,7.65,194,79,40,39,194,273,28,0,245,273,0,0,273,273,9,0,264,273,4,0,269,273
6828407,1703,247588,base,completed,324.0,7.0,104,220,91,11,222,324,1,134,189,324,51,0,273,324,55,21,248,324,0,27,297,324
6828407,1703,247588,base+,completed,280.0,6.8,202,78,58,0,222,280,0,5,275,280,19,0,261,280,53,0,227,280,8,16,256,280
6828407,1703,247588,dpv1,completed,274.0,7.25,191,83,0,0,274,274,34,0,240,274,15,7,252,274,17,27,230,274,56,0,218,274
6828407,1703,247588,dpv2,completed,295.0,7.15,157,138,0,58,237,295,42,13,240,295,0,31,264,295,44,0,251,295,56,0,239,295
6828407,1703,247588,new-0.0,completed,254.0,7.1,207,47,0,0,254,254,18,0,236,254,47,0,207,254,26,0,228,254,23,0,231,254
6828407,1703,247588,new-0.5,completed,257.0,7.5,199,58,13,0,244,257,5,0,252,257,11,0,246,257,58,0,199,257,0,0,257,257
6828407,1703,247588,new-1.0,completed,269.0,7.6,200,69,31,0,238,269,42,0,227,269,16,0,253,269,2,11,256,269,0,27,242,269
6828407,1703,203195,base,completed,275.0,7.2,218,57,49,0,226,275,50,0,225,275,0,7,268,275,11,0,264,275,37,0,238,275
6828407,1703,203195,base+,completed,285.0,7.2,187,98,0,14,271,285,59,0,226,285,41,0,244,285,5,34,246,285,44,10,231,285
6828407,1703,203195,dpv1,completed,280.0,7.05,196,84,38,0,242,280,47,0,233,280,48,0,232,280,0,8,272,280,2,28,250,280
6828407,1703,203195,dpv2,completed,280.0,7.4,171,109,63,0,217,280,53,7,220,280,17,0,263,280,0,46,234,280,9,0,271,280
6828407,1703,203195,new-0.0,completed,256.0,7.1,213,43,0,0,256,256,21,0,235,256,43,0,213,256,17,0,239,256,14,0,242,256
6828407,1703,203195,new-0.5,completed,267.0,7.4,205,62,18,0,249,267,0,0,267,267,4,0,263,267,62,0,205,267,27,0,240,267
6828407,1703,203195,new-1.0,completed,289.0,7.55,185,104,0,46,243,289,58,0,231,289,17,0,272,289,20,0,269,289,44,0,245,289
6828407,1703,178029,base,completed,281.0,6.75,204,77,5,22,254,281,6,2,273,281,0,0,281,281,53,0,228,281,55,0,226,281
6828407,1703,178029,base+,completed,286.0,7.1,151,135,58,0,228,286,13,0,273,286,20,2,264,286,0,77,209,286,56,0,230,286
6828407,1703,178029,dpv1,completed,282.0,7.05,202,80,9,26,247,282,48,0,234,282,48,0,234,282,54,0,228,282,0,0,282,282
6828407,1703,178029,dpv2,completed,294.0,7.3,161,133,30,0,264,294,54,0,240,294,9,45,240,294,77,0,217,294,0,41,253,294
6828407,1703,178029,new-0.0,completed,273.0,7.2,210,63,0,0,273,273,57,0,216,273,63,0,210,273,51,0,222,273,33,0,240,273
6828407,1703,178029,new-0.5,completed,259.0,7.5,226,33,22,0,237,259,17,0,242,259,0,0,259,259,27,0,232,259,33,0,226,259
6828407,1703,178029,new-1.0,completed,272.0,7.6,173,99,3,9,260,272,10,0,262,272,0,0,272,272,15,4,253,272,35,55,182,272
6828407,1703,239735,base,completed,267.0,6.95,201,66,7,0,260,267,53,0,214,267,10,13,244,267,37,0,230,267,0,0,267,267
6828407,1703,239735,base+,completed,305.0,7.05,136,169,50,28,227,305,34,23,248,305,0,66,239,305,72,0,233,305,51,0,254,305
6828407,1703,239735,dpv1,completed,268.0,7.25,179,89,0,0,268,268,8,0,260,268,41,0,227,268,31,23,214,268,66,0,202,268
6828407,1703,239735,dpv2,completed,280.0,7.1,183,97,0,16,264,280,39,0,241,280,4,29,247,280,43,0,237,280,52,0,228,280
6828407,1703,239735,new-0.0,completed,240.0,7.1,208,32,0,0,240,240,4,0,236,240,32,0,208,240,20,0,220,240,0,0,240,240
6828407,1703,239735,new-0.5,completed,241.0,7.45,209,32,5,0,236,241,1,0,240,241,0,0,241,241,9,0,232,241,32,0,209,241
6828407,1703,239735,new-1.0,completed,271.0,7.55,193,78,17,29,225,271,49,0,222,271,0,0,271,271,49,0,222,271,12,0,259,271
6828407,1703,675528,base,completed,284.0,6.95,190,94,44,0,240,284,47,0,237,284,14,0,270,284,3,37,244,284,0,34,250,284
6828407,1703,675528,base+,completed,324.0,6.65,191,133,102,0,222,324,0,66,258,324,94,0,230,324,60,0,264,324,67,0,257,324
6828407,1703,675528,dpv1,completed,285.0,7.1,191,94,45,0,240,285,0,0,285,285,3,36,246,285,25,0,260,285,58,0,227,285
6828407,1703,675528,dpv2,completed,273.0,7.2,184,89,58,0,215,273,2,0,271,273,44,0,229,273,8,31,234,273,0,14,259,273
6828407,1703,675528,new-0.0,completed,292.0,7.2,215,77,0,0,292,292,69,0,223,292,77,0,215,292,72,0,220,292,57,0,235,292
6828407,1703,675528,new-0.5,completed,267.0,7.55,217,50,29,0,238,267,25,0,242,267,0,0,267,267,20,0,247,267,50,0,217,267
6828407,1703,675528,new-1.0,completed,275.0,7.65,210,65,42,23,210,275,24,0,251,275,0,0,275,275,22,0,253,275,10,0,265,275
6828407,1703,380692,base,completed,288.0,6.9,154,134,66,0,222,288,6,15,267,288,0,68,220,288,48,0,240,288,27,0,261,288
6828407,1703,380692,base+,completed,290.0,7.05,158,132,41,0,249,290,5,28,257,290,44,0,246,290,49,83,158,290,0,0,290,290
6828407,1703,380692,dpv1,completed,277.0,7.15,184,93,8,0,269,277,31,0,246,277,0,33,244,277,22,0,255,277,60,0,217,277
6828407,1703,380692,dpv2,completed,268.0,7.2,178,90,10,0,258,268,51,0,217,268,55,0,213,268,6,16,246,268,0,21,247,268
6828407,1703,380692,new-0.0,completed,280.0,7.2,213,67,67,0,213,280,67,0,213,280,0,0,280,280,61,0,219,280,29,0,251,280
6828407,1703,380692,new-0.5,completed,265.0,7.5,201,64,22,0,243,265,15,0,250,265,19,0,246,265,64,0,201,265,0,0,265,265
6828407,1703,380692,new-1.0,completed,263.0,7.55,213,50,19,11,233,263,29,0,234,263,12,0,251,263,39,0,224,263,0,0,263,263
6656479,1723,310811,base,completed,346.0,7.1,119,227,0,91,255,346,94,0,252,346,80,92,174,346,106,0,240,346,30,0,316,346
6656479,1723,310811,base+,completed,347.0,7.0,140,207,0,40,307,347,44,0,303,347,94,0,253,347,95,107,145,347,86,0,261,347
6656479,1723,310811,dpv1,completed,315.0,6.8,193,122,75,0,240,315,34,0,281,315,0,65,250,315,67,12,236,315,77,0,238,315
6656479,1723,310811,dpv2,completed,336.0,7.3,92,244,33,70,233,336,95,15,226,336,0,122,214,336,54,0,282,336,78,0,258,336
6656479,1723,310811,new-0.0,completed,279.0,6.95,216,63,40,0,239,279,0,0,279,279,6,1,272,279,50,0,229,279,62,0,217,279
6656479,1723,310811,new-0.5,completed,287.0,7.4,199,88,23,4,260,287,43,0,244,287,58,0,229,287,0,19,268,287,64,1,222,287
6656479,1723,310811,new-1.0,completed,313.0,7.1,170,143,0,48,265,313,40,18,255,313,8,0,305,313,81,27,205,313,87,0,226,313
6656479,1723,208428,base,completed,316.0,6.75,124,192,52,0,264,316,44,0,272,316,67,29,220,316,34,0,282,316,0,127,189,316
6656479,1723,208428,base+,completed,316.0,7.15,192,124,40,2,274,316,68,26,222,316,43,0,273,316,89,0,227,316,0,44,272,316
6656479,1723,208428,dpv1,completed,345.0,6.9,142,203,67,0,278,345,0,66,279,345,41,0,304,345,90,10,245,345,103,73,169,345
6656479,1723,208428,dpv2,completed,352.0,7.4,111,241,38,74,240,352,66,68,218,352,0,119,233,352,36,21,295,352,96,6,250,352
6656479,1723,208428,new-0.0,completed,285.0,7.05,203,82,40,0,245,285,0,14,271,285,44,0,241,285,34,0,251,285,59,15,211,285
6656479,1723,208428,new-0.5,completed,283.0,7.35,209,74,46,0,237,283,0,7,276,283,46,0,237,283,4,16,263,283,44,5,234,283
6656479,1723,208428,new-1.0,completed,281.0,7.6,205,76,42,0,239,281,0,23,258,281,35,0,246,281,11,10,260,281,36,2,243,281
6656479,1723,460300,base,completed,396.0,6.95,68,328,41,0,355,396,92,188,116,396,35,0,361,396,68,0,328,396,0,273,123,396
6656479,1723,460300,base+,completed,369.0,6.85,93,276,35,101,233,369,54,179,136,369,76,0,293,369,0,45,324,369,87,0,282,369
6656479,1723,460300,dpv1,completed,338.0,7.0,142,196,61,0,277,338,0,90,248,338,52,51,235,338,45,0,293,338,80,37,221,338
6656479,1723,460300,dpv2,completed,352.0,7.3,148,204,101,64,187,352,111,22,219,352,0,60,292,352,96,0,256,352,47,0,305,352
6656479,1723,460300,new-0.0,completed,292.0,6.8,216,76,0,0,292,292,20,3,269,292,61,0,231,292,75,0,217,292,49,0,243,292
6656479,1723,460300,new-0.5,completed,305.0,7.15,198,107,0,0,305,305,76,0,229,305,22,24,259,305,60,1,244,305,79,12,214,305
6656479,1723,460300,new-1.0,completed,330.0,7.1,171,159,85,0,245,330,0,58,272,330,97,13,220,330,46,32,252,330,38,0,292,330
6656479,1723,309704,base,completed,379.0,7.2,64,315,0,264,115,379,32,220,127,379,43,0,336,379,19,0,360,379,39,3,337,379
6656479,1723,309704,base+,completed,344.0,6.85,119,225,73,127,144,344,76,0,268,344,64,0,280,344,43,25,276,344,0,44,300,344
6656479,1723,309704,dpv1,completed,344.0,7.05,144,200,0,49,295,344,45,0,299,344,78,0,266,344,76,12,256,344,96,82,166,344
6656479,1723,309704,dpv2,completed,336.0,7.25,160,176,79,67,190,336,99,0,237,336,37,0,299,336,81,0,255,336,0,74,262,336
6656479,1723,309704,new-0.0,completed,322.0,6.7,203,119,91,0,231,322,105,0,217,322,40,0,282,322,0,57,265,322,50,1,271,322
6656479,1723,309704,new-0.5,completed,307.0,7.0,189,118,19,3,285,307,52,6,249,307,0,37,270,307,48,0,259,307,89,14,204,307
6656479,1723,309704,new-1.0,completed,294.0,7.3,193,101,0,23,271,294,54,0,240,294,66,0,228,294,3,17,274,294,42,7,245,294
6656479,1723,247588,base,completed,352.0,6.85,68,284,44,0,308,352,0,154,198,352,34,189,129,352,58,0,294,352,24,7,321,352
6656479,1723,247588,base+,completed,341.0,6.8,79,262,0,72,269,341,57,144,140,341,37,0,304,341,74,0,267,341,83,0,258,341
6656479,1723,247588,dpv1,completed,327.0,6.9,171,156,88,0,239,327,96,0,231,327,36,0,291,327,0,108,219,327,70,0,257,327
6656479,1723,247588,dpv2,completed,314.0,7.25,162,152,62,72,180,314,0,37,277,314,28,0,286,314,68,0,246,314,77,12,225,314
6656479,1723,247588,new-0.0,completed,289.0,6.95,216,73,41,0,248,289,59,0,230,289,55,0,234,289,0,20,269,289,54,0,235,289
6656479,1723,247588,new-0.5,completed,283.0,7.35,189,94,43,0,240,283,0,0,283,283,2,23,258,283,57,15,211,283,62,0,221,283
6656479,1723,247588,new-1.0,completed,306.0,7.25,178,128,76,0,230,306,0,51,255,306,40,0,266,306,76,0,230,306,25,26,255,306
6656479,1723,203195,base,completed,370.0,6.55,72,298,85,26,259,370,64,0,306,370,55,0,315,370,0,245,125,370,39,41,290,370
6656479,1723,203195,base+,completed,351.0,6.85,121,230,0,170,181,351,37,0,314,351,109,0,242,351,105,0,246,351,56,7,288,351
6656479,1723,203195,dpv1,completed,354.0,7.15,128,226,0,88,266,354,88,0,266,354,89,0,265,354,43,84,227,354,114,0,240,354
6656479,1723,203195,dpv2,completed,336.0,7.25,174,162,72,60,204,336,95,0,241,336,46,0,290,336,96,0,240,336,0,60,276,336
6656479,1723,203195,new-0.0,completed,275.0,6.9,208,67,33,0,242,275,0,16,259,275,64,0,211,275,42,0,233,275,7,0,268,275
6656479,1723,203195,new-0.5,completed,308.0,7.2,183,125,40,0,268,308,34,0,274,308,81,9,218,308,0,63,245,308,76,0,232,308
6656479,1723,203195,new-1.0,completed,314.0,7.3,200,114,0,43,271,314,93,0,221,314,20,0,294,314,43,12,259,314,96,3,215,314
6656479,1723,178029,base,completed,337.0,6.8,113,224,50,0,287,337,83,109,145,337,76,0,261,337,0,53,284,337,80,10,247,337
6656479,1723,178029,base+,completed,304.0,6.65,166,138,39,0,265,304,64,38,202,304,29,0,275,304,0,48,256,304,52,0,252,304
6656479,1723,178029,dpv1,completed,310.0,6.95,209,101,44,0,266,310,54,0,256,310,0,33,277,310,78,12,220,310,74,0,236,310
6656479,1723,178029,dpv2,completed,339.0,7.4,97,242,0,166,173,339,93,23,223,339,85,0,254,339,40,0,299,339,63,0,276,339
6656479,1723,178029,new-0.0,completed,290.0,7.0,206,84,42,0,248,290,0,25,265,290,45,0,245,290,47,0,243,290,66,5,219,290
6656479,1723,178029,new-0.5,completed,285.0,7.45,211,74,0,11,274,285,40,0,245,285,50,0,235,285,26,0,259,285,32,18,235,285
6656479,1723,178029,new-1.0,completed,305.0,7.3,172,133,0,29,276,305,66,11,228,305,55,0,250,305,7,37,261,305,48,0,257,305
6656479,1723,239735,base,completed,439.0,6.55,71,368,54,238,147,439,93,172,174,439,40,0,399,439,0,268,171,439,66,0,373,439
6656479,1723,239735,base+,completed,336.0,7.05,98,238,31,10,295,336,0,94,242,336,73,112,151,336,94,0,242,336,56,0,280,336
6656479,1723,239735,dpv1,completed,346.0,7.15,114,232,79,0,267,346,0,162,184,346,78,0,268,346,34,91,221,346,43,0,303,346
6656479,1723,239735,dpv2,completed,319.0,7.35,96,223,79,72,168,319,51,18,250,319,0,50,269,319,41,56,222,319,40,0,279,319
6656479,1723,239735,new-0.0,completed,282.0,7.0,201,81,36,0,246,282,47,0,235,282,0,33,249,282,46,0,236,282,54,0,228,282
6656479,1723,239735,new-0.5,completed,289.0,7.35,178,111,37,0,252,289,0,19,270,289,71,0,218,289,9,22,258,289,42,18,229,289
6656479,1723,239735,new-1.0,completed,307.0,7.2,178,129,74,0,233,307,37,0,270,307,87,0,220,307,28,24,255,307,0,57,250,307
6656479,1723,675528,base,completed,325.0,6.85,146,179,0,56,269,325,51,0,274,325,95,0,230,325,39,0,286,325,58,76,191,325
6656479,1723,675528,base+,completed,363.0,7.0,132,231,74,118,171,363,0,67,296,363,52,0,311,363,100,20,243,363,40,61,262,363
6656479,1723,675528,dpv1,completed,341.0,7.15,128,213,0,60,281,341,77,0,264,341,85,88,168,341,76,15,250,341,42,0,299,341
6656479,1723,675528,dpv2,completed,335.0,7.15,155,180,88,15,232,335,0,51,284,335,67,85,183,335,90,0,245,335,33,0,302,335
6656479,1723,675528,new-0.0,completed,290.0,6.95,216,74,51,0,239,290,56,0,234,290,0,25,265,290,32,0,258,290,39,0,251,290
6656479,1723,675528,new-0.5,completed,288.0,7.15,198,90,60,0,228,288,58,0,230,288,5,20,263,288,49,0,239,288,0,10,278,288
6656479,1723,675528,new-1.0,completed,329.0,7.3,192,137,0,55,274,329,104,0,225,329,31,0,298,329,52,14,263,329,111,9,209,329
6656479,1723,380692,base,completed,330.0,7.05,155,175,0,55,275,330,42,67,221,330,73,0,257,330,84,0,246,330,106,0,224,330
6656479,1723,380692,base+,completed,352.0,7.15,121,231,43,10,299,352,75,92,185,352,83,0,269,352,98,0,254,352,0,98,254,352
6656479,1723,380692,dpv1,completed,327.0,6.9,155,172,54,0,273,327,75,0,252,327,0,105,222,327,47,0,280,327,97,10,220,327
6656479,1723,380692,dpv2,completed,329.0,7.4,179,150,0,90,239,329,86,0,243,329,50,0,279,329,79,0,250,329,87,12,230,329
6656479,1723,380692,new-0.0,completed,298.0,7.0,207,91,70,0,228,298,58,0,240,298,0,27,271,298,54,0,244,298,51,0,247,298
6656479,1723,380692,new-0.5,completed,281.0,7.15,224,57,54,0,227,281,0,4,277,281,5,0,276,281,42,0,239,281,49,0,232,281
6656479,1723,380692,new-1.0,completed,302.0,7.55,195,107,39,0,263,302,0,31,271,302,60,0,242,302,33,17,252,302,72,8,222,302
5905852,1945,310811,base,completed,342.0,6.8,190,152,0,59,283,342,82,0,260,342,40,0,302,342,83,12,247,342,28,29,285,342
5905852,1945,310811,base+,completed,362.0,6.8,191,171,71,0,291,362,81,39,242,362,32,4,326,362,69,24,269,362,0,70,292,362
5905852,1945,310811,dpv1,completed,347.0,7.35,165,182,80,0,267,347,41,1,305,347,0,69,278,347,60,0,287,347,43,35,269,347
5905852,1945,310811,dpv2,completed,323.0,7.3,241,82,81,0,242,323,0,13,310,323,40,0,283,323,39,1,283,323,53,0,270,323
5905852,1945,310811,new-0.0,completed,357.0,7.0,210,147,44,9,304,357,83,17,257,357,93,3,261,357,90,4,263,357,0,32,325,357
5905852,1945,310811,new-0.5,completed,353.0,7.45,220,133,73,20,260,353,105,5,243,353,38,0,315,353,108,0,245,353,0,34,319,353
5905852,1945,310811,new-1.0,completed,330.0,7.25,151,179,43,35,252,330,11,42,277,330,8,56,266,330,0,0,330,330,71,0,259,330
5905852,1945,208428,base,completed,336.0,7.1,230,106,82,0,254,336,76,24,236,336,0,13,323,336,79,0,257,336,23,0,313,336
5905852,1945,208428,base+,completed,320.0,7.15,251,69,62,0,258,320,32,0,288,320,0,1,319,320,42,0,278,320,28,8,284,320
5905852,1945,208428,dpv1,completed,353.0,7.25,168,185,41,30,282,353,101,0,252,353,66,0,287,353,46,20,287,353,0,56,297,353
5905852,1945,208428,dpv2,completed,330.0,7.3,234,96,84,0,246,330,39,0,291,330,52,0,278,330,0,13,317,330,34,12,284,330
5905852,1945,208428,new-0.0,completed,361.0,7.0,192,169,0,11,350,361,87,27,247,361,87,38,236,361,35,21,305,361,93,16,252,361
5905852,1945,208428,new-0.5,completed,334.0,7.3,239,95,90,0,244,334,79,0,255,334,0,18,316,334,83,0,251,334,34,0,300,334
5905852,1945,208428,new-1.0,completed,339.0,7.3,178,161,59,8,272,339,0,42,297,339,33,32,274,339,87,0,252,339,35,0,304,339
5905852,1945,460300,base,completed,361.0,6.6,190,171,0,62,299,361,36,8,317,361,35,2,324,361,85,42,234,361,90,0,271,361
5905852,1945,460300,base+,completed,353.0,7.25,249,104,95,0,258,353,36,0,317,353,78,0,275,353,0,43,310,353,82,0,271,353
5905852,1945,460300,dpv1,completed,368.0,7.1,142,226,70,0,298,368,100,0,268,368,54,27,287,368,0,85,283,368,40,46,282,368
5905852,1945,460300,dpv2,completed,351.0,7.4,243,108,108,0,243,351,45,0,306,351,0,30,321,351,65,0,286,351,65,0,286,351
5905852,1945,460300,new-0.0,completed,349.0,6.9,216,133,0,31,318,349,85,0,264,349,66,8,275,349,35,15,299,349,62,28,259,349
5905852,1945,460300,new-0.5,completed,356.0,7.25,236,120,106,0,250,356,101,10,245,356,43,4,309,356,77,0,279,356,0,17,339,356
5905852,1945,460300,new-1.0,completed,325.0,7.35,164,161,39,14,272,325,2,50,273,325,0,38,287,325,69,0,256,325,14,0,311,325
5905852,1945,309704,base,completed,364.0,7.0,169,195,93,91,180,364,0,47,317,364,64,0,300,364,95,0,269,364,35,0,329,364
5905852,1945,309704,base+,completed,332.0,6.75,226,106,54,0,278,332,74,8,250,332,0,4,328,332,27,6,299,332,71,18,243,332
5905852,1945,309704,dpv1,completed,353.0,7.3,157,196,36,38,279,353,64,0,289,353,0,3,350,353,61,0,292,353,65,98,190,353
5905852,1945,309704,dpv2,completed,341.0,7.45,213,128,41,0,300,341,0,12,329,341,92,0,249,341,41,8,292,341,94,26,221,341
5905852,1945,309704,new-0.0,completed,338.0,7.0,208,130,78,0,260,338,0,15,323,338,80,17,241,338,31,12,295,338,65,21,252,338
5905852,1945,309704,new-0.5,completed,351.0,7.4,228,123,33,0,318,351,90,12,249,351,0,16,335,351,93,28,230,351,88,0,263,351
5905852,1945,309704,new-1.0,completed,352.0,7.3,164,188,67,13,272,352,45,0,307,352,0,52,300,352,37,70,245,352,61,0,291,352
5905852,1945,247588,base,completed,368.0,7.0,184,184,53,0,315,368,101,0,267,368,0,125,243,368,42,30,296,368,47,0,321,368
5905852,1945,247588,base+,completed,339.0,6.9,200,139,78,3,258,339,0,16,323,339,37,1,301,339,62,0,277,339,83,53,203,339
5905852,1945,247588,dpv1,completed,355.0,7.25,187,168,32,29,294,355,0,27,328,355,58,103,194,355,97,0,258,355,55,0,300,355
5905852,1945,247588,dpv2,completed,320.0,7.3,243,77,62,0,258,320,26,0,294,320,0,0,320,320,77,0,243,320,69,0,251,320
5905852,1945,247588,new-0.0,completed,348.0,7.05,189,159,82,4,262,348,0,35,313,348,31,10,307,348,81,18,249,348,70,27,251,348
5905852,1945,247588,new-0.5,completed,332.0,7.45,221,111,53,10,269,332,0,10,322,332,35,0,297,332,83,0,249,332,65,18,249,332
5905852,1945,247588,new-1.0,completed,333.0,7.35,180,153,70,34,229,333,31,0,302,333,33,38,262,333,0,17,316,333,81,0,252,333
5905852,1945,203195,base,completed,374.0,7.25,154,220,45,40,289,374,0,161,213,374,67,0,307,374,40,0,334,374,81,0,293,374
5905852,1945,203195,base+,completed,373.0,6.9,166,207,31,54,288,373,85,0,288,373,0,17,356,373,73,83,217,373,84,0,289,373
5905852,1945,203195,dpv1,completed,353.0,7.05,219,134,78,5,270,353,84,0,269,353,45,0,308,353,84,6,263,353,0,45,308,353
5905852,1945,203195,dpv2,completed,342.0,7.4,215,127,79,0,263,342,36,0,306,342,30,0,312,342,0,33,309,342,89,22,231,342
5905852,1945,203195,new-0.0,completed,350.0,7.05,194,156,32,12,306,350,68,27,255,350,84,25,241,350,0,12,338,350,89,15,246,350
5905852,1945,203195,new-0.5,completed,323.0,7.4,241,82,77,0,246,323,67,0,256,323,0,4,319,323,43,5,275,323,30,0,293,323
5905852,1945,203195,new-1.0,completed,340.0,7.4,193,147,76,16,248,340,39,15,286,340,0,31,309,340,91,0,249,340,20,0,320,340
5905852,1945,178029,base,completed,349.0,7.15,208,141,38,0,311,349,83,0,266,349,72,13,264,349,88,40,221,349,0,8,341,349
5905852,1945,178029,base+,completed,329.0,6.9,239,90,34,0,295,329,90,0,239,329,0,22,307,329,35,0,294,329,49,0,280,329
5905852,1945,178029,dpv1,completed,357.0,7.2,195,162,64,87,206,357,0,20,337,357,59,0,298,357,75,0,282,357,36,25,296,357
5905852,1945,178029,dpv2,completed,348.0,7.4,235,113,84,0,264,348,42,0,306,348,49,4,295,348,0,29,319,348,101,6,241,348
5905852,1945,178029,new-0.0,completed,363.0,7.0,193,170,0,10,353,363,90,40,233,363,93,40,230,363,44,9,310,363,96,15,252,363
5905852,1945,178029,new-0.5,completed,322.0,7.5,236,86,39,7,276,322,0,0,322,322,74,0,248,322,31,0,291,322,79,0,243,322
5905852,1945,178029,new-1.0,completed,336.0,7.4,212,124,45,26,265,336,0,0,336,336,71,0,265,336,87,11,238,336,41,0,295,336
5905852,1945,239735,base,completed,371.0,6.9,167,204,0,115,256,371,99,10,262,371,96,0,275,371,45,0,326,371,64,25,282,371
5905852,1945,239735,base+,completed,390.0,7.1,131,259,54,0,336,390,99,11,280,390,114,0,276,390,99,45,246,390,0,136,254,390
5905852,1945,239735,dpv1,completed,359.0,7.25,180,179,73,0,286,359,44,14,301,359,68,98,193,359,71,0,288,359,0,38,321,359
5905852,1945,239735,dpv2,completed,322.0,7.45,250,72,72,0,250,322,28,0,294,322,0,16,306,322,58,0,264,322,69,0,253,322
5905852,1945,239735,new-0.0,completed,340.0,7.0,191,149,75,0,265,340,0,25,315,340,77,24,239,340,38,11,291,340,69,27,244,340
5905852,1945,239735,new-0.5,completed,318.0,7.4,210,108,40,19,259,318,55,23,240,318,26,0,292,318,0,0,318,318,66,0,252,318
5905852,1945,239735,new-1.0,completed,331.0,7.35,194,137,65,30,236,331,34,28,269,331,26,24,281,331,0,4,327,331,58,0,273,331
5905852,1945,675528,base,completed,334.0,6.85,252,82,81,0,253,334,46,1,287,334,54,0,280,334,68,0,266,334,0,0,334,334
5905852,1945,675528,base+,completed,351.0,6.9,216,135,0,47,304,351,52,0,299,351,72,0,279,351,74,11,266,351,77,0,274,351
5905852,1945,675528,dpv1,completed,365.0,7.3,187,178,84,93,188,365,46,3,316,365,78,0,287,365,82,0,283,365,0,17,348,365
5905852,1945,675528,dpv2,completed,337.0,7.25,250,87,76,0,261,337,52,0,285,337,25,0,312,337,0,36,301,337,60,0,277,337
5905852,1945,675528,new-0.0,completed,343.0,7.0,210,133,87,0,256,343,89,15,239,343,0,23,320,343,30,11,302,343,70,18,255,343
5905852,1945,675528,new-0.5,completed,354.0,7.4,220,134,0,38,316,354,103,2,249,354,69,0,285,354,105,5,244,354,37,0,317,354
5905852,1945,675528,new-1.0,completed,344.0,7.35,191,153,80,0,264,344,0,37,307,344,34,0,310,344,64,36,244,344,44,2,298,344
5905852,1945,380692,base,completed,334.0,7.1,232,102,39,0,295,334,0,35,299,334,68,0,266,334,95,0,239,334,53,7,274,334
5905852,1945,380692,base+,completed,328.0,6.95,216,112,36,12,280,328,60,0,268,328,0,32,296,328,64,5,259,328,25,0,303,328
5905852,1945,380692,dpv1,completed,349.0,7.15,163,186,57,0,292,349,56,0,293,349,58,87,204,349,0,19,330,349,35,43,271,349
5905852,1945,380692,dpv2,completed,333.0,7.35,213,120,53,8,272,333,81,15,237,333,63,0,270,333,0,5,328,333,32,26,275,333
5905852,1945,380692,new-0.0,completed,350.0,7.0,199,151,87,5,258,350,0,26,324,350,82,15,253,350,38,10,302,350,78,28,244,350
5905852,1945,380692,new-0.5,completed,328.0,7.4,246,82,80,0,248,328,75,2,251,328,0,10,318,328,75,0,253,328,18,0,310,328
5905852,1945,380692,new-1.0,completed,336.0,7.35,192,144,72,34,230,336,35,6,295,336,34,30,272,336,0,12,324,336,74,0,262,336
9026946,1728,310811,base,completed,326.0,7.3,115,211,69,0,257,326,11,131,184,326,62,74,190,326,0,0,326,326,26,11,289,326
9026946,1728,310811,base+,completed,308.0,6.9,170,138,0,0,308,308,36,0,272,308,15,19,274,308,37,0,271,308,78,54,176,308
9026946,1728,310811,dpv1,completed,325.0,7.25,132,193,76,35,214,325,20,0,305,325,22,7,296,325,65,0,260,325,0,114,211,325
9026946,1728,310811,dpv2,completed,287.0,7.55,205,82,0,3,284,287,37,0,250,287,25,0,262,287,22,0,265,287,79,0,208,287
9026946,1728,310811,new-0.0,completed,272.0,7.05,199,73,16,0,256,272,0,0,272,272,30,2,240,272,30,0,242,272,71,0,201,272
9026946,1728,310811,new-0.5,completed,295.0,7.5,176,119,0,11,284,295,55,11,229,295,29,9,257,295,74,0,221,295,1,32,262,295
9026946,1728,310811,new-1.0,completed,329.0,7.55,148,181,67,37,225,329,82,37,210,329,28,43,258,329,46,39,244,329,0,0,329,329
9026946,1728,208428,base,completed,297.0,6.6,163,134,0,0,297,297,35,0,262,297,36,0,261,297,11,0,286,297,22,98,177,297
9026946,1728,208428,base+,completed,287.0,6.9,183,104,65,0,222,287,8,0,279,287,0,0,287,287,52,26,209,287,8,19,260,287
9026946,1728,208428,dpv1,completed,319.0,7.05,138,181,79,0,240,319,85,0,234,319,42,21,256,319,0,0,319,319,32,87,200,319
9026946,1728,208428,dpv2,completed,323.0,7.45,174,149,65,21,237,323,69,0,254,323,45,0,278,323,0,0,323,323,45,59,219,323
9026946,1728,208428,new-0.0,completed,285.0,7.2,207,78,57,0,228,285,27,0,258,285,47,0,238,285,0,0,285,285,33,21,231,285
9026946,1728,208428,new-0.5,completed,295.0,7.45,200,95,32,11,252,295,72,0,223,295,38,0,257,295,33,1,261,295,0,11,284,295
9026946,1728,208428,new-1.0,completed,309.0,7.7,151,158,21,34,254,309,0,11,298,309,38,17,254,309,27,18,264,309,63,28,218,309
9026946,1728,460300,base,completed,301.0,6.75,172,129,11,5,285,301,60,58,183,301,66,0,235,301,0,0,301,301,29,0,272,301
9026946,1728,460300,base+,completed,310.0,7.05,166,144,14,31,265,310,64,0,246,310,19,0,291,310,0,36,274,310,56,28,226,310
9026946,1728,460300,dpv1,completed,321.0,7.35,163,158,19,0,302,321,35,5,281,321,82,0,239,321,0,0,321,321,81,71,169,321
9026946,1728,460300,dpv2,completed,299.0,7.5,163,136,53,33,213,299,63,0,236,299,0,0,299,299,10,0,289,299,15,40,244,299
9026946,1728,460300,new-0.0,completed,277.0,7.1,197,80,0,4,273,277,2,3,272,277,20,0,257,277,73,0,204,277,39,0,238,277
9026946,1728,460300,new-0.5,completed,299.0,7.4,213,86,43,12,244,299,0,0,299,299,74,0,225,299,43,0,256,299,47,0,252,299
9026946,1728,460300,new-1.0,completed,333.0,7.6,166,167,51,0,282,333,78,42,213,333,28,39,266,333,0,23,310,333,86,0,247,333
9026946,1728,309704,base,completed,311.0,7.1,156,155,26,75,210,311,41,5,265,311,41,0,270,311,64,0,247,311,0,12,299,311
9026946,1728,309704,base+,completed,303.0,6.75,182,121,67,31,205,303,24,20,259,303,0,0,303,303,16,12,275,303,55,8,240,303
9026946,1728,309704,dpv1,completed,316.0,7.3,134,182,73,16,227,316,14,0,302,316,0,0,316,316,74,0,242,316,16,108,192,316
9026946,1728,309704,dpv2,completed,328.0,7.4,164,164,74,89,165,328,74,0,254,328,0,0,328,328,58,0,270,328,48,14,266,328
9026946,1728,309704,new-0.0,completed,301.0,7.3,176,125,68,5,228,301,62,17,222,301,0,1,300,301,25,2,274,301,9,39,253,301
9026946,1728,309704,new-0.5,completed,301.0,7.5,182,119,79,10,212,301,69,19,213,301,0,0,301,301,16,20,265,301,8,0,293,301
9026946,1728,309704,new-1.0,completed,340.0,7.6,158,182,39,47,254,340,0,38,302,340,41,33,266,340,87,41,212,340,86,0,254,340
9026946,1728,247588,base,completed,348.0,6.9,136,212,48,0,300,348,13,68,267,348,6,29,313,348,0,156,192,348,56,89,203,348
9026946,1728,247588,base+,completed,307.0,6.75,174,133,30,3,274,307,73,31,203,307,45,17,245,307,82,0,225,307,0,0,307,307
9026946,1728,247588,dpv1,completed,321.0,7.2,131,190,51,0,270,321,71,52,198,321,0,0,321,321,22,4,295,321,14,107,200,321
9026946,1728,247588,dpv2,completed,305.0,7.5,152,153,49,60,196,305,50,0,255,305,0,0,305,305,20,0,285,305,32,47,226,305
9026946,1728,247588,new-0.0,completed,278.0,7.05,207,71,30,9,239,278,32,0,246,278,41,3,234,278,0,0,278,278,59,0,219,278
9026946,1728,247588,new-0.5,completed,275.0,7.5,211,64,0,17,258,275,46,0,229,275,33,0,242,275,26,1,248,275,2,0,273,275
9026946,1728,247588,new-1.0,completed,315.0,7.75,154,161,29,37,249,315,0,0,315,315,53,19,243,315,15,43,257,315,38,54,223,315
9026946,1728,203195,base,completed,302.0,6.85,171,131,44,0,258,302,75,0,227,302,3,66,233,302,0,0,302,302,42,0,260,302
9026946,1728,203195,base+,completed,302.0,7.1,137,165,0,16,286,302,69,0,233,302,9,74,219,302,21,12,269,302,43,0,259,302
9026946,1728,203195,dpv1,completed,330.0,7.05,139,191,28,0,302,330,69,7,254,330,78,43,209,330,0,0,330,330,17,103,210,330
9026946,1728,203195,dpv2,completed,277.0,7.15,223,54,9,3,265,277,0,3,274,277,5,0,272,277,51,0,226,277,27,0,250,277
9026946,1728,203195,new-0.0,completed,275.0,6.9,187,88,0,0,275,275,6,0,269,275,62,11,202,275,41,0,234,275,12,15,248,275
9026946,1728,203195,new-0.5,completed,297.0,7.4,196,101,74,11,212,297,0,0,297,297,65,0,232,297,16,17,264,297,30,0,267,297
9026946,1728,203195,new-1.0,completed,326.0,7.5,166,160,78,35,213,326,68,34,224,326,0,27,299,326,19,38,269,326,47,0,279,326
9026946,1728,178029,base,completed,317.0,7.25,129,188,74,0,243,317,27,49,241,317,52,0,265,317,0,0,317,317,33,89,195,317
9026946,1728,178029,base+,completed,300.0,6.8,183,117,8,18,274,300,59,9,232,300,60,0,240,300,11,0,289,300,0,31,269,300
9026946,1728,178029,dpv1,completed,311.0,7.1,154,157,63,0,248,311,30,25,256,311,0,0,311,311,67,0,244,311,14,82,215,311
9026946,1728,178029,dpv2,completed,303.0,7.5,171,132,51,46,206,303,51,0,252,303,0,0,303,303,17,0,286,303,16,35,252,303
9026946,1728,178029,new-0.0,completed,293.0,7.0,207,86,51,0,242,293,73,12,208,293,40,1,252,293,0,0,293,293,56,0,237,293
9026946,1728,178029,new-0.5,completed,298.0,7.45,192,106,7,26,265,298,56,27,215,298,0,0,298,298,18,0,280,298,78,0,220,298
9026946,1728,178029,new-1.0,completed,336.0,7.6,162,174,63,15,258,336,18,41,277,336,68,39,229,336,0,36,300,336,94,0,242,336
9026946,1728,239735,base,completed,312.0,6.9,155,157,66,0,246,312,13,0,299,312,0,0,312,312,22,70,220,312,64,41,207,312
9026946,1728,239735,base+,completed,302.0,7.05,163,139,53,0,249,302,56,59,187,302,8,83,211,302,3,0,299,302,0,0,302,302
9026946,1728,239735,dpv1,completed,307.0,7.35,101,206,14,55,238,307,5,39,263,307,0,0,307,307,22,0,285,307,51,80,176,307
9026946,1728,239735,dpv2,completed,284.0,7.5,163,121,41,44,199,284,47,0,237,284,0,0,284,284,3,0,281,284,11,30,243,284
9026946,1728,239735,new-0.0,completed,273.0,7.05,209,64,21,8,244,273,0,0,273,273,38,2,233,273,48,0,225,273,54,0,219,273
9026946,1728,239735,new-0.5,completed,289.0,7.45,193,96,12,37,240,289,35,7,247,289,53,0,236,289,59,0,230,289,0,0,289,289
9026946,1728,239735,new-1.0,completed,296.0,7.75,157,139,26,0,270,296,0,0,296,296,31,41,224,296,8,37,251,296,57,28,211,296
9026946,1728,675528,base,completed,293.0,6.75,185,108,4,42,247,293,0,22,271,293,48,0,245,293,40,0,253,293,12,0,281,293
9026946,1728,675528,base+,completed,303.0,6.85,143,160,59,0,244,303,44,15,244,303,6,57,240,303,0,41,262,303,11,1,291,303
9026946,1728,675528,dpv1,completed,319.0,7.1,125,194,55,0,264,319,0,5,314,319,54,54,211,319,0,0,319,319,6,131,182,319
9026946,1728,675528,dpv2,completed,313.0,7.35,156,157,58,41,214,313,39,0,274,313,0,0,313,313,45,0,268,313,16,58,239,313
9026946,1728,675528,new-0.0,completed,297.0,7.2,206,91,70,0,227,297,61,0,236,297,46,4,247,297,0,0,297,297,43,21,233,297
9026946,1728,675528,new-0.5,completed,299.0,7.4,211,88,0,19,280,299,54,7,238,299,72,0,227,299,39,1,259,299,2,0,297,299
9026946,1728,675528,new-1.0,completed,311.0,7.5,162,149,69,30,212,311,72,28,211,311,0,14,297,311,32,26,253,311,15,7,289,311
9026946,1728,380692,base,completed,330.0,6.95,104,226,71,0,259,330,9,0,321,330,66,9,255,330,18,155,157,330,0,39,291,330
9026946,1728,380692,base+,completed,290.0,7.1,199,91,18,21,251,290,20,0,270,290,67,0,223,290,0,0,290,290,70,0,220,290
9026946,1728,380692,dpv1,completed,292.0,7.3,157,135,0,0,292,292,58,0,234,292,35,4,253,292,5,0,287,292,11,73,208,292
9026946,1728,380692,dpv2,completed,308.0,7.4,164,144,51,60,197,308,37,0,271,308,0,0,308,308,48,0,260,308,15,39,254,308
9026946,1728,380692,new-0.0,completed,280.0,7.2,204,76,53,0,227,280,47,4,229,280,30,0,250,280,0,0,280,280,23,19,238,280
9026946,1728,380692,new-0.5,completed,305.0,7.4,181,124,10,43,252,305,60,30,215,305,76,0,229,305,28,0,277,305,0,0,305,305
9026946,1728,380692,new-1.0,completed,327.0,7.6,157,170,54,0,273,327,74,35,218,327,36,29,262,327,81,31,215,327,0,21,306,327
4381235,1541,310811,base,completed,273.0,6.85,157,116,64,0,209,273,70,0,203,273,18,0,255,273,18,14,241,273,0,51,222,273
4381235,1541,310811,base+,completed,250.0,6.8,188,62,25,0,225,250,62,0,188,250,0,0,250,250,15,0,235,250,52,0,198,250
4381235,1541,310811,dpv1,completed,240.0,7.35,198,42,36,0,204,240,31,0,209,240,0,0,240,240,3,6,231,240,30,0,210,240
4381235,1541,310811,dpv2,completed,258.0,7.5,171,87,17,0,241,258,0,24,234,258,15,2,241,258,68,0,190,258,66,0,192,258
4381235,1541,310811,new-0.0,completed,238.0,7.05,184,54,42,0,196,238,0,0,238,238,54,0,184,238,14,0,224,238,26,0,212,238
4381235,1541,310811,new-0.5,completed,244.0,7.6,182,62,37,0,207,244,0,14,230,244,8,0,236,244,52,0,192,244,32,0,212,244
4381235,1541,310811,new-1.0,completed,239.0,7.65,179,60,38,0,201,239,0,0,239,239,20,22,197,239,0,0,239,239,24,0,215,239
4381235,1541,208428,base,completed,263.0,6.6,196,67,0,0,263,263,60,0,203,263,43,0,220,263,31,0,232,263,67,0,196,263
4381235,1541,208428,base+,completed,242.0,6.9,216,26,15,0,227,242,23,0,219,242,22,0,220,242,14,0,228,242,0,3,239,242
4381235,1541,208428,dpv1,completed,246.0,7.55,192,54,20,2,224,246,52,0,194,246,0,0,246,246,29,0,217,246,44,0,202,246
4381235,1541,208428,dpv2,completed,241.0,7.5,197,44,17,0,224,241,0,8,233,241,36,0,205,241,22,0,219,241,35,0,206,241
4381235,1541,208428,new-0.0,completed,255.0,6.95,178,77,29,0,226,255,70,0,185,255,43,0,212,255,0,9,246,255,67,0,188,255
4381235,1541,208428,new-0.5,completed,249.0,7.45,186,63,47,0,202,249,37,0,212,249,0,16,233,249,19,2,228,249,39,0,210,249
4381235,1541,208428,new-1.0,completed,246.0,7.55,183,63,39,0,207,246,0,0,246,246,35,14,197,246,10,0,236,246,19,10,217,246
4381235,1541,460300,base,completed,250.0,6.95,157,93,28,0,222,250,0,27,223,250,16,0,234,250,3,41,206,250,32,0,218,250
4381235,1541,460300,base+,completed,246.0,6.6,208,38,30,0,216,246,19,0,227,246,35,0,211,246,38,0,208,246,0,0,246,246
4381235,1541,460300,dpv1,completed,244.0,7.3,204,40,0,0,244,244,7,0,237,244,40,0,204,244,40,0,204,244,23,0,221,244
4381235,1541,460300,dpv2,completed,246.0,7.55,179,67,45,0,201,246,0,14,232,246,40,0,206,246,16,0,230,246,0,17,229,246
4381235,1541,460300,new-0.0,completed,227.0,7.05,186,41,0,0,227,227,3,0,224,227,11,0,216,227,41,0,186,227,14,0,213,227
4381235,1541,460300,new-0.5,completed,260.0,7.55,185,75,40,0,220,260,54,0,206,260,0,23,237,260,22,11,227,260,48,0,212,260
4381235,1541,460300,new-1.0,completed,253.0,7.65,196,57,20,19,214,253,38,0,215,253,33,0,220,253,0,0,253,253,31,0,222,253
4381235,1541,309704,base,completed,278.0,6.95,170,108,27,10,241,278,52,0,226,278,93,0,185,278,0,24,254,278,48,1,229,278
4381235,1541,309704,base+,completed,250.0,7.15,187,63,18,0,232,250,0,1,249,250,13,0,237,250,46,0,204,250,62,0,188,250
4381235,1541,309704,dpv1,completed,242.0,7.4,193,49,30,0,212,242,49,0,193,242,1,0,241,242,0,0,242,242,35,0,207,242
4381235,1541,309704,dpv2,completed,255.0,7.5,163,92,71,0,184,255,27,0,228,255,54,0,201,255,0,18,237,255,4,14,237,255
4381235,1541,309704,new-0.0,completed,233.0,7.05,188,45,0,0,233,233,43,0,190,233,1,2,230,233,43,0,190,233,13,0,220,233
4381235,1541,309704,new-0.5,completed,242.0,7.5,188,54,45,0,197,242,42,0,200,242,0,9,233,242,10,0,232,242,43,0,199,242
4381235,1541,309704,new-1.0,completed,247.0,7.5,179,68,32,0,215,247,0,3,244,247,47,21,179,247,12,0,235,247,6,0,241,247
4381235,1541,247588,base,completed,249.0,7.05,186,63,40,0,209,249,4,0,245,249,0,0,249,249,63,0,186,249,19,0,230,249
4381235,1541,247588,base+,completed,269.0,6.9,146,123,41,0,228,269,82,0,187,269,5,19,245,269,30,0,239,269,0,62,207,269
4381235,1541,247588,dpv1,completed,238.0,7.55,169,69,7,28,203,238,36,0,202,238,0,8,230,238,14,0,224,238,30,0,208,238
4381235,1541,247588,dpv2,completed,251.0,7.55,172,79,71,0,180,251,2,16,233,251,0,0,251,251,18,0,233,251,58,0,193,251
4381235,1541,247588,new-0.0,completed,220.0,7.0,183,37,15,0,205,220,37,0,183,220,0,0,220,220,1,0,219,220,10,0,210,220
4381235,1541,247588,new-0.5,completed,242.0,7.6,191,51,16,0,226,242,49,0,193,242,51,0,191,242,0,0,242,242,24,0,218,242
4381235,1541,247588,new-1.0,completed,238.0,7.6,188,50,0,0,238,238,34,0,204,238,41,7,190,238,8,0,230,238,4,9,225,238
4381235,1541,203195,base,completed,255.0,7.05,172,83,22,0,233,255,22,27,206,255,0,0,255,255,56,0,199,255,25,0,230,255
4381235,1541,203195,base+,completed,254.0,7.0,190,64,28,0,226,254,0,0,254,254,15,0,239,254,64,0,190,254,62,0,192,254
4381235,1541,203195,dpv1,completed,242.0,7.25,185,57,0,23,219,242,25,0,217,242,34,0,208,242,1,0,241,242,25,0,217,242
4381235,1541,203195,dpv2,completed,249.0,7.55,180,69,59,0,190,249,6,10,233,249,0,0,249,249,25,0,224,249,57,0,192,249
4381235,1541,203195,new-0.0,completed,223.0,7.0,182,41,28,0,195,223,37,0,186,223,0,4,219,223,3,0,220,223,1,0,222,223
4381235,1541,203195,new-0.5,completed,247.0,7.45,191,56,43,0,204,247,42,0,205,247,0,13,234,247,19,5,223,247,33,0,214,247
4381235,1541,203195,new-1.0,completed,245.0,7.5,176,69,28,0,217,245,47,0,198,245,36,22,187,245,1,0,244,245,0,0,245,245
4381235,1541,178029,base,completed,252.0,7.0,164,88,0,0,252,252,11,0,241,252,52,0,200,252,61,0,191,252,2,33,217,252
4381235,1541,178029,base+,completed,252.0,6.8,167,85,30,0,222,252,0,0,252,252,15,0,237,252,58,0,194,252,21,27,204,252
4381235,1541,178029,dpv1,completed,240.0,7.2,178,62,10,7,223,240,17,0,223,240,42,0,198,240,18,0,222,240,0,13,227,240
4381235,1541,178029,dpv2,completed,249.0,7.45,194,55,35,0,214,249,29,0,220,249,43,0,206,249,0,7,242,249,48,0,201,249
4381235,1541,178029,new-0.0,completed,238.0,7.1,189,49,40,5,193,238,38,4,196,238,0,0,238,238,18,0,220,238,27,0,211,238
4381235,1541,178029,new-0.5,completed,251.0,7.55,185,66,34,0,217,251,53,0,198,251,0,21,230,251,12,10,229,251,51,0,200,251
4381235,1541,178029,new-1.0,completed,247.0,7.6,177,70,5,11,231,247,46,0,201,247,24,0,223,247,0,0,247,247,30,13,204,247
4381235,1541,239735,base,completed,257.0,6.85,173,84,23,0,234,257,52,0,205,257,23,21,213,257,0,0,257,257,63,0,194,257
4381235,1541,239735,base+,completed,265.0,7.05,164,101,95,0,170,265,0,21,244,265,21,12,232,265,43,0,222,265,53,0,212,265
4381235,1541,239735,dpv1,completed,226.0,7.2,177,49,10,0,216,226,38,0,188,226,10,0,216,226,5,0,221,226,0,11,215,226
4381235,1541,239735,dpv2,completed,247.0,7.55,175,72,50,0,197,247,2,22,223,247,0,4,243,247,24,0,223,247,47,0,200,247
4381235,1541,239735,new-0.0,completed,227.0,7.05,196,31,14,0,213,227,31,0,196,227,17,0,210,227,0,0,227,227,21,0,206,227
4381235,1541,239735,new-0.5,completed,253.0,7.55,181,72,34,0,219,253,60,0,193,253,0,27,226,253,18,8,227,253,51,0,202,253
4381235,1541,239735,new-1.0,completed,243.0,7.65,165,78,17,24,202,243,54,0,189,243,22,0,221,243,0,0,243,243,39,0,204,243
4381235,1541,675528,base,completed,254.0,6.95,157,97,0,0,254,254,61,0,193,254,66,0,188,254,3,0,251,254,12,34,208,254
4381235,1541,675528,base+,completed,255.0,7.0,194,61,0,0,255,255,32,0,223,255,61,0,194,255,28,0,227,255,55,0,200,255
4381235,1541,675528,dpv1,completed,228.0,7.35,204,24,24,0,204,228,0,0,228,228,8,0,220,228,10,0,218,228,16,0,212,228
4381235,1541,675528,dpv2,completed,257.0,7.55,178,79,61,0,196,257,13,9,235,257,0,18,239,257,31,0,226,257,56,0,201,257
4381235,1541,675528,new-0.0,completed,252.0,7.1,197,55,54,0,198,252,0,0,252,252,55,0,197,252,19,0,233,252,39,0,213,252
4381235,1541,675528,new-0.5,completed,261.0,7.5,186,75,24,6,231,261,66,0,195,261,0,21,240,261,44,0,217,261,58,0,203,261
4381235,1541,675528,new-1.0,completed,250.0,7.6,186,64,0,0,250,250,54,0,196,250,35,10,205,250,14,0,236,250,35,0,215,250
4381235,1541,380692,base,completed,268.0,6.7,177,91,43,0,225,268,24,26,218,268,0,25,243,268,49,0,219,268,54,0,214,268
4381235,1541,380692,base+,completed,263.0,7.25,161,102,0,39,224,263,63,0,200,263,37,0,226,263,29,0,234,263,44,0,219,263
4381235,1541,380692,dpv1,completed,240.0,7.4,182,58,5,19,216,240,36,0,204,240,20,0,220,240,0,3,237,240,33,0,207,240
4381235,1541,380692,dpv2,completed,246.0,7.55,184,62,42,0,204,246,0,19,227,246,0,13,233,246,18,0,228,246,43,0,203,246
4381235,1541,380692,new-0.0,completed,224.0,7.1,190,34,15,0,209,224,0,0,224,224,34,0,190,224,1,0,223,224,17,0,207,224
4381235,1541,380692,new-0.5,completed,243.0,7.5,196,47,35,0,208,243,31,0,212,243,0,1,242,243,16,0,227,243,46,0,197,243
4381235,1541,380692,new-1.0,completed,236.0,7.65,189,47,0,14,222,236,33,0,203,236,16,0,220,236,1,0,235,236,26,0,210,236
7694698,1662,310811,base,completed,340.0,6.9,143,197,80,83,177,340,19,51,270,340,47,52,241,340,0,123,217,340,24,0,316,340
7694698,1662,310811,base+,completed,294.0,7.05,166,128,0,38,256,294,78,0,216,294,11,84,199,294,65,0,229,294,19,0,275,294
7694698,1662,310811,dpv1,completed,286.0,7.55,180,106,26,10,250,286,21,53,212,286,0,16,270,286,73,0,213,286,60,0,226,286
7694698,1662,310811,dpv2,completed,308.0,7.4,138,170,71,33,204,308,81,0,227,308,0,0,308,308,30,106,172,308,32,0,276,308
7694698,1662,310811,new-0.0,completed,290.0,7.15,207,83,65,3,222,290,78,0,212,290,0,0,290,290,77,2,211,290,56,0,234,290
7694698,1662,310811,new-0.5,completed,283.0,7.25,205,78,38,0,245,283,33,23,227,283,0,0,283,283,66,0,217,283,78,0,205,283
7694698,1662,310811,new-1.0,completed,266.0,7.7,193,73,73,0,193,266,57,0,209,266,25,0,241,266,26,0,240,266,0,0,266,266
7694698,1662,208428,base,completed,296.0,7.05,158,138,31,77,188,296,0,0,296,296,38,2,256,296,39,0,257,296,49,12,235,296
7694698,1662,208428,base+,completed,305.0,6.95,153,152,0,22,283,305,50,0,255,305,16,0,289,305,16,112,177,305,77,0,228,305
7694698,1662,208428,dpv1,completed,295.0,7.65,135,160,62,18,215,295,0,0,295,295,25,105,165,295,56,0,239,295,28,9,258,295
7694698,1662,208428,dpv2,completed,292.0,7.5,139,153,0,0,292,292,36,23,233,292,48,0,244,292,62,0,230,292,32,86,174,292
7694698,1662,208428,new-0.0,completed,280.0,7.3,210,70,0,0,280,280,65,0,215,280,62,1,217,280,65,4,211,280,40,0,240,280
7694698,1662,208428,new-0.5,completed,275.0,7.7,208,67,19,0,256,275,67,0,208,275,55,0,220,275,59,0,216,275,0,0,275,275
7694698,1662,208428,new-1.0,completed,276.0,7.55,179,97,19,15,242,276,70,19,187,276,39,0,237,276,43,0,233,276,0,0,276,276
7694698,1662,460300,base,completed,293.0,7.05,159,134,0,0,293,293,63,32,198,293,32,52,209,293,21,25,247,293,28,0,265,293
7694698,1662,460300,base+,completed,276.0,7.05,191,85,43,8,225,276,18,0,258,276,0,10,266,276,61,0,215,276,31,16,229,276
7694698,1662,460300,dpv1,completed,304.0,7.65,138,166,68,14,222,304,0,14,290,304,13,118,173,304,60,0,244,304,25,8,271,304
7694698,1662,460300,dpv2,completed,304.0,7.5,142,162,0,0,304,304,67,25,212,304,21,104,179,304,63,0,241,304,29,0,275,304
7694698,1662,460300,new-0.0,completed,273.0,7.25,180,93,38,0,235,273,0,0,273,273,44,0,229,273,31,38,204,273,58,0,215,273
7694698,1662,460300,new-0.5,completed,278.0,7.7,210,68,49,0,229,278,0,0,278,278,60,0,218,278,68,0,210,278,28,0,250,278
7694698,1662,460300,new-1.0,completed,277.0,7.55,174,103,18,12,247,277,73,18,186,277,44,0,233,277,42,0,235,277,0,0,277,277
7694698,1662,309704,base,completed,302.0,6.9,164,138,14,0,288,302,0,101,201,302,58,0,244,302,30,0,272,302,60,25,217,302
7694698,1662,309704,base+,completed,326.0,7.1,132,194,0,64,262,326,98,31,197,326,8,0,318,326,11,96,219,326,89,10,227,326
7694698,1662,309704,dpv1,completed,277.0,7.5,138,139,4,0,273,277,0,25,252,277,15,0,262,277,14,102,161,277,57,0,220,277
7694698,1662,309704,dpv2,completed,283.0,7.3,196,87,29,4,250,283,63,0,220,283,66,0,217,283,0,0,283,283,27,34,222,283
7694698,1662,309704,new-0.0,completed,288.0,7.45,178,110,61,0,227,288,0,0,288,288,70,2,216,288,55,28,205,288,81,0,207,288
7694698,1662,309704,new-0.5,completed,282.0,7.35,195,87,0,0,282,282,48,13,221,282,80,0,202,282,64,0,218,282,54,0,228,282
7694698,1662,309704,new-1.0,completed,277.0,7.6,192,85,4,28,245,277,69,0,208,277,34,0,243,277,72,0,205,277,0,0,277,277
7694698,1662,247588,base,completed,294.0,7.25,102,192,15,153,126,294,0,6,288,294,50,0,244,294,58,0,236,294,21,0,273,294
7694698,1662,247588,base+,completed,305.0,6.8,102,203,9,165,131,305,58,12,235,305,49,0,256,305,20,7,278,305,0,25,280,305
7694698,1662,247588,dpv1,completed,299.0,7.4,84,215,0,20,279,299,12,179,108,299,45,0,254,299,60,0,239,299,22,27,250,299
7694698,1662,247588,dpv2,completed,297.0,7.5,143,154,35,0,262,297,0,0,297,297,67,0,230,297,66,0,231,297,29,103,165,297
7694698,1662,247588,new-0.0,completed,256.0,7.25,183,73,23,0,233,256,0,1,255,256,15,34,207,256,40,0,216,256,31,0,225,256
7694698,1662,247588,new-0.5,completed,267.0,7.6,191,76,0,3,264,267,44,0,223,267,28,23,216,267,71,0,196,267,30,0,237,267
7694698,1662,247588,new-1.0,completed,264.0,7.5,167,97,25,10,229,264,11,29,224,264,0,0,264,264,48,0,216,264,60,0,204,264
7694698,1662,203195,base,completed,331.0,7.15,149,182,31,0,300,331,28,137,166,331,77,47,207,331,73,0,258,331,0,84,247,331
7694698,1662,203195,base+,completed,325.0,7.0,113,212,0,22,303,325,95,0,230,325,63,57,205,325,24,21,280,325,17,128,180,325
7694698,1662,203195,dpv1,completed,320.0,7.55,91,229,70,38,212,320,18,188,114,320,0,31,289,320,72,0,248,320,25,0,295,320
7694698,1662,203195,dpv2,completed,300.0,7.4,147,153,0,0,300,300,51,0,249,300,71,0,229,300,68,0,232,300,47,85,168,300
7694698,1662,203195,new-0.0,completed,254.0,7.25,187,67,14,0,240,254,0,7,247,254,35,2,217,254,13,29,212,254,19,0,235,254
7694698,1662,203195,new-0.5,completed,264.0,7.75,208,56,29,0,235,264,0,0,264,264,8,15,241,264,46,0,218,264,51,0,213,264
7694698,1662,203195,new-1.0,completed,288.0,7.65,191,97,59,12,217,288,0,0,288,288,85,0,203,288,49,0,239,288,34,0,254,288
7694698,1662,178029,base,completed,313.0,7.2,124,189,12,150,151,313,64,0,249,313,0,9,304,313,77,74,162,313,21,0,292,313
7694698,1662,178029,base+,completed,282.0,6.85,155,127,10,0,272,282,9,76,197,282,11,80,191,282,25,0,257,282,0,8,274,282
7694698,1662,178029,dpv1,completed,297.0,7.65,130,167,48,0,249,297,61,19,217,297,0,11,286,297,20,126,151,297,23,0,274,297
7694698,1662,178029,dpv2,completed,297.0,7.35,144,153,0,0,297,297,67,6,224,297,25,0,272,297,64,0,233,297,23,108,166,297
7694698,1662,178029,new-0.0,completed,280.0,7.3,210,70,0,0,280,280,66,0,214,280,59,0,221,280,61,4,215,280,46,0,234,280
7694698,1662,178029,new-0.5,completed,253.0,7.6,199,54,8,2,243,253,31,0,222,253,18,21,214,253,0,0,253,253,20,0,233,253
7694698,1662,178029,new-1.0,completed,281.0,7.8,187,94,69,18,194,281,0,0,281,281,34,0,247,281,29,0,252,281,76,0,205,281
7694698,1662,239735,base,completed,290.0,6.95,144,146,21,53,216,290,35,25,230,290,33,33,224,290,0,0,290,290,31,36,223,290
7694698,1662,239735,base+,completed,304.0,7.05,116,188,19,62,223,304,48,22,234,304,0,63,241,304,40,78,186,304,18,20,266,304
7694698,1662,239735,dpv1,completed,311.0,7.55,82,229,63,30,218,311,13,194,104,311,0,34,277,311,66,0,245,311,16,0,295,311
7694698,1662,239735,dpv2,completed,296.0,7.45,144,152,76,0,220,296,0,8,288,296,33,0,263,296,69,0,227,296,34,94,168,296
7694698,1662,239735,new-0.0,completed,275.0,7.1,177,98,27,45,203,275,39,0,236,275,69,0,206,275,0,0,275,275,68,0,207,275
7694698,1662,239735,new-0.5,completed,272.0,7.45,199,73,49,0,223,272,34,0,238,272,63,0,209,272,0,0,272,272,65,8,199,272
7694698,1662,239735,new-1.0,completed,275.0,7.55,166,109,23,11,241,275,68,30,177,275,39,0,236,275,60,0,215,275,0,0,275,275
7694698,1662,675528,base,completed,300.0,6.8,160,140,28,97,175,300,0,0,300,300,31,0,269,300,23,0,277,300,9,109,182,300
7694698,1662,675528,base+,completed,305.0,7.45,172,133,77,0,228,305,0,66,239,305,11,3,291,305,15,53,237,305,96,0,209,305
7694698,1662,675528,dpv1,completed,310.0,7.45,144,166,40,20,250,310,78,28,204,310,10,129,171,310,19,0,291,310,0,37,273,310
7694698,1662,675528,dpv2,completed,288.0,7.65,142,146,64,0,224,288,0,0,288,288,33,11,244,288,16,107,165,288,21,0,267,288
7694698,1662,675528,new-0.0,completed,280.0,7.45,194,86,52,0,228,280,0,0,280,280,74,2,204,280,50,14,216,280,66,0,214,280
7694698,1662,675528,new-0.5,completed,282.0,7.35,202,80,77,0,205,282,46,0,236,282,0,0,282,282,50,7,225,282,54,0,228,282
7694698,1662,675528,new-1.0,completed,266.0,7.6,180,86,18,5,243,266,0,24,242,266,57,0,209,266,41,0,225,266,1,0,265,266
7694698,1662,380692,base,completed,317.0,7.05,114,203,13,67,237,317,0,10,307,317,12,131,174,317,56,17,244,317,85,0,232,317
7694698,1662,380692,base+,completed,286.0,6.9,104,182,37,0,249,286,24,145,117,286,31,0,255,286,0,0,286,286,7,32,247,286
7694698,1662,380692,dpv1,completed,320.0,7.5,132,188,75,29,216,320,75,0,245,320,18,136,166,320,0,37,283,320,28,9,283,320
7694698,1662,380692,dpv2,completed,293.0,7.3,150,143,36,0,257,293,72,0,221,293,24,93,176,293,64,0,229,293,0,0,293,293
7694698,1662,380692,new-0.0,completed,279.0,7.3,188,91,47,0,232,279,69,0,210,279,0,2,277,279,45,25,209,279,65,0,214,279
7694698,1662,380692,new-0.5,completed,269.0,7.4,207,62,0,0,269,269,42,0,227,269,53,0,216,269,36,9,224,269,40,0,229,269
7694698,1662,380692,new-1.0,completed,270.0,7.5,196,74,33,6,231,270,57,0,213,270,68,0,202,270,0,0,270,270,20,0,250,270
2236976,1653,310811,base,completed,276.0,7.25,155,121,19,24,233,276,0,0,276,276,33,8,235,276,4,67,205,276,54,0,222,276
2236976,1653,310811,base+,completed,269.0,6.75,211,58,0,0,269,269,27,0,242,269,46,0,223,269,58,0,211,269,9,0,260,269
2236976,1653,310811,dpv1,completed,285.0,7.3,127,158,17,0,268,285,17,24,244,285,80,0,205,285,0,92,193,285,32,0,253,285
2236976,1653,310811,dpv2,completed,278.0,7.15,156,122,32,25,221,278,0,0,278,278,13,30,235,278,67,0,211,278,57,6,215,278
2236976,1653,310811,new-0.0,completed,260.0,7.25,196,64,44,0,216,260,27,0,233,260,17,10,233,260,52,0,208,260,0,12,248,260
2236976,1653,310811,new-0.5,completed,281.0,7.6,183,98,56,0,225,281,21,10,250,281,25,0,256,281,0,26,255,281,79,0,202,281
2236976,1653,310811,new-1.0,completed,281.0,7.8,177,104,0,0,281,281,42,17,222,281,66,17,198,281,7,0,274,281,70,0,211,281
2236976,1653,208428,base,completed,300.0,7.4,152,148,0,4,296,300,60,62,178,300,38,60,202,300,32,12,256,300,56,0,244,300
2236976,1653,208428,base+,completed,272.0,7.1,164,108,0,51,221,272,13,0,259,272,13,0,259,272,17,1,254,272,57,0,215,272
2236976,1653,208428,dpv1,completed,295.0,7.35,130,165,87,0,208,295,17,0,278,295,12,28,255,295,0,104,191,295,55,0,240,295
2236976,1653,208428,dpv2,completed,263.0,7.4,182,81,8,0,255,263,0,43,220,263,23,0,240,263,25,0,238,263,38,0,225,263
2236976,1653,208428,new-0.0,completed,272.0,7.25,199,73,0,0,272,272,42,0,230,272,69,0,203,272,48,4,220,272,19,0,253,272
2236976,1653,208428,new-0.5,completed,277.0,7.6,193,84,49,0,228,277,0,16,261,277,23,20,234,277,37,0,240,277,64,0,213,277
2236976,1653,208428,new-1.0,completed,281.0,7.8,189,92,0,0,281,281,31,17,233,281,75,0,206,281,39,0,242,281,66,0,215,281
2236976,1653,460300,base,completed,301.0,7.2,141,160,12,75,214,301,0,47,254,301,6,70,225,301,32,0,269,301,59,0,242,301
2236976,1653,460300,base+,completed,294.0,7.1,167,127,84,0,210,294,37,0,257,294,23,10,261,294,57,6,231,294,0,45,249,294
2236976,1653,460300,dpv1,completed,291.0,7.15,140,151,20,13,258,291,35,0,256,291,37,0,254,291,77,0,214,291,0,75,216,291
2236976,1653,460300,dpv2,completed,276.0,7.4,171,105,36,0,240,276,0,52,224,276,53,0,223,276,30,0,246,276,21,1,254,276
2236976,1653,460300,new-0.0,completed,266.0,7.2,205,61,13,0,253,266,13,5,248,266,56,0,210,266,0,0,266,266,47,0,219,266
2236976,1653,460300,new-0.5,completed,280.0,7.55,185,95,25,0,255,280,77,0,203,280,30,2,248,280,0,19,261,280,49,0,231,280
2236976,1653,460300,new-1.0,completed,273.0,7.8,179,94,0,0,273,273,2,16,255,273,60,18,195,273,1,0,272,273,52,0,221,273
2236976,1653,309704,base,completed,336.0,7.05,132,204,56,43,237,336,27,0,309,336,17,134,185,336,0,88,248,336,85,31,220,336
2236976,1653,309704,base+,completed,289.0,7.4,141,148,25,12,252,289,74,0,215,289,25,0,264,289,0,80,209,289,37,0,252,289
2236976,1653,309704,dpv1,completed,290.0,7.4,150,140,40,0,250,290,24,14,252,290,78,0,212,290,0,62,228,290,38,0,252,290
2236976,1653,309704,dpv2,completed,288.0,7.55,155,133,52,0,236,288,72,0,216,288,26,0,262,288,0,61,227,288,21,21,246,288
2236976,1653,309704,new-0.0,completed,269.0,7.1,203,66,0,0,269,269,52,4,213,269,62,0,207,269,10,0,259,269,47,0,222,269
2236976,1653,309704,new-0.5,completed,264.0,7.65,195,69,12,0,252,264,26,0,238,264,59,0,205,264,0,10,254,264,36,0,228,264
2236976,1653,309704,new-1.0,completed,280.0,7.8,183,97,0,0,280,280,34,19,227,280,77,1,202,280,13,0,267,280,68,0,212,280
2236976,1653,247588,base,completed,293.0,7.15,142,151,61,0,232,293,5,47,241,293,18,45,230,293,0,77,216,293,31,0,262,293
2236976,1653,247588,base+,completed,269.0,7.1,138,131,0,49,220,269,14,21,234,269,65,0,204,269,33,17,219,269,20,0,249,269
2236976,1653,247588,dpv1,completed,271.0,7.2,192,79,59,0,212,271,14,12,245,271,18,0,253,271,72,0,199,271,0,12,259,271
2236976,1653,247588,dpv2,completed,250.0,7.5,188,62,6,0,244,250,1,30,219,250,32,0,218,250,19,0,231,250,0,0,250,250
2236976,1653,247588,new-0.0,completed,256.0,7.3,196,60,0,0,256,256,30,0,226,256,2,5,249,256,30,4,222,256,51,0,205,256
2236976,1653,247588,new-0.5,completed,275.0,7.6,186,89,38,0,237,275,0,17,258,275,26,27,222,275,24,0,251,275,62,0,213,275
2236976,1653,247588,new-1.0,completed,287.0,7.6,184,103,34,9,244,287,31,19,237,287,75,0,212,287,0,0,287,287,72,0,215,287
2236976,1653,203195,base,completed,288.0,7.0,207,81,55,7,226,288,66,0,222,288,74,0,214,288,36,0,252,288,0,1,287,288
2236976,1653,203195,base+,completed,276.0,7.1,179,97,36,0,240,276,43,18,215,276,22,0,254,276,16,54,206,276,0,0,276,276
2236976,1653,203195,dpv1,completed,305.0,7.25,139,166,27,0,278,305,22,27,256,305,0,89,216,305,91,0,214,305,55,0,250,305
2236976,1653,203195,dpv2,completed,274.0,7.6,169,105,22,15,237,274,0,0,274,274,49,0,225,274,18,49,207,274,32,5,237,274
2236976,1653,203195,new-0.0,completed,270.0,7.1,208,62,0,0,270,270,53,0,217,270,62,0,208,270,21,0,249,270,47,0,223,270
2236976,1653,203195,new-0.5,completed,257.0,7.55,194,63,14,0,243,257,6,0,251,257,55,0,202,257,0,8,249,257,27,0,230,257
2236976,1653,203195,new-1.0,completed,286.0,7.8,192,94,0,0,286,286,36,9,241,286,69,16,201,286,39,0,247,286,63,0,223,286
2236976,1653,178029,base,completed,274.0,7.15,175,99,61,3,210,274,0,0,274,274,48,0,226,274,28,38,208,274,13,0,261,274
2236976,1653,178029,base+,completed,300.0,7.05,184,116,0,50,250,300,83,0,217,300,19,28,253,300,28,0,272,300,73,15,212,300
2236976,1653,178029,dpv1,completed,287.0,7.05,143,144,19,22,246,287,0,74,213,287,36,0,251,287,32,0,255,287,77,0,210,287
2236976,1653,178029,dpv2,completed,262.0,7.35,176,86,0,41,221,262,31,0,231,262,45,0,217,262,26,0,236,262,3,0,259,262
2236976,1653,178029,new-0.0,completed,264.0,7.25,203,61,0,0,264,264,11,0,253,264,61,0,203,264,49,0,215,264,43,0,221,264
2236976,1653,178029,new-0.5,completed,263.0,7.55,195,68,48,0,215,263,0,0,263,263,28,0,235,263,6,17,240,263,33,3,227,263
2236976,1653,178029,new-1.0,completed,275.0,7.75,183,92,70,0,205,275,18,1,256,275,56,21,198,275,10,0,265,275,0,0,275,275
2236976,1653,239735,base,completed,305.0,7.0,136,169,89,0,216,305,22,0,283,305,38,0,267,305,30,68,207,305,0,93,212,305
2236976,1653,239735,base+,completed,297.0,7.15,138,159,19,44,234,297,0,64,233,297,89,0,208,297,42,21,234,297,36,0,261,297
2236976,1653,239735,dpv1,completed,285.0,7.05,133,152,15,0,270,285,77,0,208,285,0,87,198,285,6,13,266,285,45,0,240,285
2236976,1653,239735,dpv2,completed,274.0,7.45,161,113,59,0,215,274,0,54,220,274,46,0,228,274,31,0,243,274,25,2,247,274
2236976,1653,239735,new-0.0,completed,249.0,7.2,196,53,9,0,240,249,13,6,230,249,47,0,202,249,0,0,249,249,44,0,205,249
2236976,1653,239735,new-0.5,completed,274.0,7.45,176,98,85,0,189,274,0,15,259,274,28,0,246,274,30,25,219,274,55,0,219,274
2236976,1653,239735,new-1.0,completed,276.0,7.8,175,101,0,0,276,276,26,12,238,276,61,17,198,276,24,0,252,276,72,0,204,276
2236976,1653,675528,base,completed,284.0,7.05,192,92,82,0,202,284,0,13,271,284,18,22,244,284,25,0,259,284,69,0,215,284
2236976,1653,675528,base+,completed,290.0,7.2,166,124,24,2,264,290,70,0,220,290,0,46,244,290,31,8,251,290,50,0,240,290
2236976,1653,675528,dpv1,completed,303.0,7.15,134,169,34,19,250,303,35,0,268,303,49,0,254,303,91,0,212,303,0,90,213,303
2236976,1653,675528,dpv2,completed,272.0,7.2,175,97,33,3,236,272,0,46,226,272,20,0,252,272,51,0,221,272,11,0,261,272
2236976,1653,675528,new-0.0,completed,264.0,7.2,214,50,50,0,214,264,36,0,228,264,0,0,264,264,35,0,229,264,8,0,256,264
2236976,1653,675528,new-0.5,completed,279.0,7.55,186,93,44,0,235,279,80,0,199,279,27,0,252,279,0,17,262,279,16,5,258,279
2236976,1653,675528,new-1.0,completed,271.0,7.65,192,79,9,4,258,271,0,10,261,271,58,0,213,271,13,0,258,271,65,0,206,271
2236976,1653,380692,base,completed,286.0,6.95,165,121,14,0,272,286,52,21,213,286,72,0,214,286,0,52,234,286,8,35,243,286
2236976,1653,380692,base+,completed,290.0,6.95,137,153,68,0,222,290,14,53,223,290,15,24,251,290,22,6,262,290,0,86,204,290
2236976,1653,380692,dpv1,completed,271.0,7.2,187,84,56,0,215,271,15,18,238,271,0,11,260,271,75,0,196,271,23,0,248,271
2236976,1653,380692,dpv2,completed,270.0,7.55,146,124,24,0,246,270,17,0,253,270,55,0,215,270,0,69,201,270,10,9,251,270
2236976,1653,380692,new-0.0,completed,274.0,7.2,213,61,0,0,274,274,47,0,227,274,61,0,213,274,46,0,228,274,34,0,240,274
2236976,1653,380692,new-0.5,completed,277.0,7.5,177,100,44,0,233,277,0,13,264,277,30,0,247,277,10,32,235,277,81,0,196,277
2236976,1653,380692,new-1.0,completed,281.0,7.8,190,91,0,0,281,281,35,16,230,281,75,0,206,281,20,0,261,281,69,0,212,281
4778804,1761,310811,base,completed,287.0,7.25,214,73,0,0,287,287,51,0,236,287,31,14,242,287,10,0,277,287,45,18,224,287
4778804,1761,310811,base+,completed,307.0,7.15,124,183,62,54,191,307,19,53,235,307,12,27,268,307,19,42,246,307,0,0,307,307
4778804,1761,310811,dpv1,completed,298.0,7.25,154,144,0,0,298,298,66,0,232,298,32,15,251,298,10,81,207,298,44,6,248,298
4778804,1761,310811,dpv2,completed,288.0,7.55,148,140,9,79,200,288,61,0,227,288,14,0,274,288,0,0,288,288,21,2,265,288
4778804,1761,310811,new-0.0,completed,291.0,7.2,188,103,47,24,220,291,55,0,236,291,17,3,271,291,0,0,291,291,76,0,215,291
4778804,1761,310811,new-0.5,completed,295.0,7.7,186,109,62,0,233,295,68,16,211,295,52,0,243,295,8,0,287,295,0,25,270,295
4778804,1761,310811,new-1.0,completed,312.0,7.5,212,100,73,0,239,312,70,11,231,312,57,16,239,312,66,0,246,312,0,0,312,312
4778804,1761,208428,base,completed,285.0,6.95,223,62,0,1,284,285,60,0,225,285,17,0,268,285,33,1,251,285,11,0,274,285
4778804,1761,208428,base+,completed,325.0,6.75,121,204,48,31,246,325,41,44,240,325,0,0,325,325,26,76,223,325,80,0,245,325
4778804,1761,208428,dpv1,completed,306.0,7.2,157,149,0,0,306,306,71,0,235,306,55,43,208,306,12,48,246,306,34,24,248,306
4778804,1761,208428,dpv2,completed,306.0,7.7,181,125,29,0,277,306,25,28,253,306,49,22,235,306,0,0,306,306,26,76,204,306
4778804,1761,208428,new-0.0,completed,277.0,7.3,206,71,56,0,221,277,42,0,235,277,0,0,277,277,3,0,274,277,24,15,238,277
4778804,1761,208428,new-0.5,completed,274.0,7.65,206,68,0,0,274,274,43,5,226,274,3,20,251,274,24,0,250,274,38,0,236,274
4778804,1761,208428,new-1.0,completed,293.0,7.7,192,101,24,0,269,293,0,0,293,293,25,11,257,293,71,0,222,293,32,19,242,293
4778804,1761,460300,base,completed,278.0,7.15,217,61,26,0,252,278,37,24,217,278,12,0,266,278,0,0,278,278,31,0,247,278
4778804,1761,460300,base+,completed,314.0,6.65,171,143,84,0,230,314,25,76,213,314,7,0,307,314,0,0,314,314,31,43,240,314
4778804,1761,460300,dpv1,completed,317.0,7.2,154,163,21,51,245,317,86,0,231,317,54,51,212,317,0,0,317,317,13,22,282,317
4778804,1761,460300,dpv2,completed,283.0,7.55,156,127,23,54,206,283,73,0,210,283,10,0,273,283,0,0,283,283,3,0,280,283
4778804,1761,460300,new-0.0,completed,280.0,7.3,180,100,65,0,215,280,42,0,238,280,0,4,276,280,0,0,280,280,23,31,226,280
4778804,1761,460300,new-0.5,completed,281.0,7.65,204,77,0,0,281,281,59,5,217,281,18,13,250,281,19,0,262,281,47,0,234,281
4778804,1761,460300,new-1.0,completed,304.0,7.7,179,125,30,0,274,304,0,0,304,304,34,23,247,304,85,0,219,304,39,24,241,304
4778804,1761,309704,base,completed,343.0,7.1,146,197,59,95,189,343,21,60,262,343,73,0,270,343,31,137,175,343,0,0,343,343
4778804,1761,309704,base+,completed,291.0,6.9,179,112,38,0,253,291,26,26,239,291,0,0,291,291,21,19,251,291,14,40,237,291
4778804,1761,309704,dpv1,completed,314.0,7.4,156,158,0,0,314,314,69,0,245,314,59,50,205,314,35,21,258,314,7,56,251,314
4778804,1761,309704,dpv2,completed,287.0,7.65,177,110,40,49,198,287,47,0,240,287,2,0,285,287,0,0,287,287,3,27,257,287
4778804,1761,309704,new-0.0,completed,280.0,7.25,201,79,50,14,216,280,39,0,241,280,8,0,272,280,65,0,215,280,0,0,280,280
4778804,1761,309704,new-0.5,completed,279.0,7.45,183,96,10,0,269,279,16,0,263,279,13,0,266,279,0,24,255,279,67,5,207,279
4778804,1761,309704,new-1.0,completed,290.0,7.5,185,105,48,0,242,290,33,21,236,290,2,10,278,290,44,16,230,290,0,12,278,290
4778804,1761,247588,base,completed,360.0,7.2,141,219,0,90,270,360,22,114,224,360,48,87,225,360,93,0,267,360,44,0,316,360
4778804,1761,247588,base+,completed,311.0,6.9,182,129,61,0,250,311,39,28,244,311,45,42,224,311,49,25,237,311,0,0,311,311
4778804,1761,247588,dpv1,completed,312.0,7.25,134,178,0,0,312,312,35,27,250,312,51,14,247,312,77,0,235,312,4,110,198,312
4778804,1761,247588,dpv2,completed,284.0,7.7,191,93,8,0,276,284,12,17,255,284,26,27,231,284,0,0,284,284,27,66,191,284
4778804,1761,247588,new-0.0,completed,274.0,7.15,204,70,40,11,223,274,32,0,242,274,0,6,268,274,5,0,269,274,53,0,221,274
4778804,1761,247588,new-0.5,completed,293.0,7.65,215,78,30,0,263,293,60,18,215,293,52,0,241,293,0,0,293,293,54,0,239,293
4778804,1761,247588,new-1.0,completed,294.0,7.65,182,112,30,12,252,294,48,0,246,294,20,36,238,294,0,0,294,294,56,8,230,294
4778804,1761,203195,base,completed,315.0,7.05,156,159,51,12,252,315,79,6,230,315,41,20,254,315,0,0,315,315,16,87,212,315
4778804,1761,203195,base+,completed,309.0,7.2,102,207,2,75,232,309,14,77,218,309,40,23,246,309,0,0,309,309,45,0,264,309
4778804,1761,203195,dpv1,completed,305.0,7.2,133,172,71,0,234,305,0,12,293,305,51,48,206,305,14,53,238,305,20,26,259,305
4778804,1761,203195,dpv2,completed,281.0,7.55,139,142,72,0,209,281,5,0,276,281,0,0,281,281,0,0,281,281,14,70,197,281
4778804,1761,203195,new-0.0,completed,296.0,7.1,193,103,0,0,296,296,53,21,222,296,13,18,265,296,53,12,231,296,64,0,232,296
4778804,1761,203195,new-0.5,completed,302.0,7.65,192,110,66,14,222,302,10,18,274,302,62,0,240,302,0,9,293,302,69,0,233,302
4778804,1761,203195,new-1.0,completed,285.0,7.65,173,112,11,10,264,285,58,0,227,285,2,16,267,285,0,0,285,285,16,28,241,285
4778804,1761,178029,base,completed,346.0,6.85,133,213,70,5,271,346,90,54,202,346,25,125,196,346,80,12,254,346,0,0,346,346
4778804,1761,178029,base+,completed,298.0,7.0,173,125,0,0,298,298,25,13,260,298,10,0,288,298,22,71,205,298,71,0,227,298
4778804,1761,178029,dpv1,completed,297.0,7.3,130,167,30,16,251,297,62,0,235,297,2,0,295,297,0,28,269,297,9,97,191,297
4778804,1761,178029,dpv2,completed,296.0,7.45,157,139,21,64,211,296,75,0,221,296,23,0,273,296,19,0,277,296,0,0,296,296
4778804,1761,178029,new-0.0,completed,298.0,7.1,171,127,38,0,260,298,58,18,222,298,0,0,298,298,88,0,210,298,28,22,248,298
4778804,1761,178029,new-0.5,completed,273.0,7.65,198,75,0,0,273,273,48,8,217,273,4,19,250,273,10,0,263,273,38,0,235,273
4778804,1761,178029,new-1.0,completed,291.0,7.75,174,117,16,0,275,291,73,0,218,291,5,28,258,291,0,0,291,291,30,16,245,291
4778804,1761,239735,base,completed,309.0,7.1,131,178,0,0,309,309,50,0,259,309,30,0,279,309,54,51,204,309,4,116,189,309
4778804,1761,239735,base+,completed,303.0,7.15,188,115,37,39,227,303,55,0,248,303,55,55,193,303,21,13,269,303,0,0,303,303
4778804,1761,239735,dpv1,completed,299.0,7.25,166,133,48,19,232,299,88,0,211,299,21,44,234,299,14,0,285,299,0,17,282,299
4778804,1761,239735,dpv2,completed,279.0,7.65,180,99,36,59,184,279,25,0,254,279,21,0,258,279,0,0,279,279,4,28,247,279
4778804,1761,239735,new-0.0,completed,274.0,7.15,181,93,59,0,215,274,0,0,274,274,0,6,268,274,41,0,233,274,35,28,211,274
4778804,1761,239735,new-0.5,completed,284.0,7.55,195,89,23,14,247,284,45,14,225,284,0,0,284,284,58,0,226,284,51,7,226,284
4778804,1761,239735,new-1.0,completed,292.0,7.65,165,127,21,24,247,292,42,0,250,292,60,43,189,292,37,0,255,292,0,4,288,292
4778804,1761,675528,base,completed,303.0,7.05,176,127,29,59,215,303,36,0,267,303,25,0,278,303,36,75,192,303,0,18,285,303
4778804,1761,675528,base+,completed,284.0,7.1,181,103,32,0,252,284,31,27,226,284,9,70,205,284,0,20,264,284,12,0,272,284
4778804,1761,675528,dpv1,completed,313.0,7.3,142,171,59,30,224,313,68,0,245,313,23,31,259,313,0,0,313,313,11,64,238,313
4778804,1761,675528,dpv2,completed,297.0,7.65,177,120,50,54,193,297,54,0,243,297,8,0,289,297,0,0,297,297,17,29,251,297
4778804,1761,675528,new-0.0,completed,284.0,7.3,165,119,42,14,228,284,10,37,237,284,0,0,284,284,10,0,274,284,68,0,216,284
4778804,1761,675528,new-0.5,completed,281.0,7.65,199,82,4,0,277,281,52,6,223,281,0,16,265,281,11,0,270,281,60,0,221,281
4778804,1761,675528,new-1.0,completed,300.0,7.55,208,92,35,1,264,300,21,0,279,300,0,19,281,300,56,5,239,300,44,11,245,300
4778804,1761,380692,base,completed,322.0,7.25,131,191,70,0,252,322,0,68,254,322,0,0,322,322,54,45,223,322,10,107,205,322
4778804,1761,380692,base+,completed,303.0,6.9,165,138,46,30,227,303,22,29,252,303,70,0,233,303,0,55,248,303,4,0,299,303
4778804,1761,380692,dpv1,completed,317.0,7.35,132,185,0,0,317,317,93,0,224,317,46,14,257,317,20,35,262,317,11,107,199,317
4778804,1761,380692,dpv2,completed,291.0,7.65,187,104,76,0,215,291,0,0,291,291,34,0,257,291,10,20,261,291,13,38,240,291
4778804,1761,380692,new-0.0,completed,280.0,7.1,197,83,51,0,229,280,37,18,225,280,10,8,262,280,0,0,280,280,57,0,223,280
4778804,1761,380692,new-0.5,completed,276.0,7.65,211,65,45,2,229,276,0,0,276,276,5,18,253,276,10,0,266,276,40,0,236,276
4778804,1761,380692,new-1.0,completed,289.0,7.75,198,91,27,0,262,289,65,0,224,289,23,10,256,289,0,0,289,289,34,16,239,289
5055275,1756,310811,base,completed,331.0,7.25,190,141,78,0,253,331,63,48,220,331,55,0,276,331,0,78,253,331,70,0,261,331
5055275,1756,310811,base+,completed,333.0,7.35,204,129,88,0,245,333,0,66,267,333,84,0,249,333,63,0,270,333,114,0,219,333
5055275,1756,310811,dpv1,completed,313.0,7.3,192,121,46,0,267,313,75,0,238,313,0,69,244,313,52,4,257,313,68,0,245,313
5055275,1756,310811,dpv2,completed,339.0,7.6,196,143,112,0,227,339,113,0,226,339,0,78,261,339,49,0,290,339,76,31,232,339
5055275,1756,310811,new-0.0,completed,316.0,6.9,221,95,0,38,278,316,92,0,224,316,84,0,232,316,86,0,230,316,57,0,259,316
5055275,1756,310811,new-0.5,completed,358.0,7.45,192,166,89,44,225,358,120,0,238,358,70,33,255,358,0,91,267,358,122,0,236,358
5055275,1756,310811,new-1.0,completed,349.0,7.8,199,150,107,0,242,349,65,43,241,349,0,86,263,349,49,39,261,349,118,0,231,349
5055275,1756,208428,base,completed,326.0,6.9,236,90,60,0,266,326,81,0,245,326,69,0,257,326,0,26,300,326,77,4,245,326
5055275,1756,208428,base+,completed,343.0,7.05,206,137,85,0,258,343,103,0,240,343,0,81,262,343,56,0,287,343,110,0,233,343
5055275,1756,208428,dpv1,completed,342.0,7.1,187,155,75,0,267,342,107,0,235,342,61,0,281,342,0,94,248,342,84,0,258,342
5055275,1756,208428,dpv2,completed,342.0,7.1,215,127,123,0,219,342,93,0,249,342,59,0,283,342,106,0,236,342,0,68,274,342
5055275,1756,208428,new-0.0,completed,319.0,7.0,212,107,97,0,222,319,85,0,234,319,0,50,269,319,83,7,229,319,50,0,269,319
5055275,1756,208428,new-0.5,completed,354.0,7.45,208,146,60,21,273,354,0,69,285,354,78,36,240,354,119,0,235,354,110,0,244,354
5055275,1756,208428,new-1.0,completed,352.0,7.65,204,148,52,17,283,352,70,47,235,352,0,82,270,352,98,3,251,352,115,0,237,352
5055275,1756,460300,base,completed,378.0,7.0,162,216,80,0,298,378,105,0,273,378,135,0,243,378,0,151,227,378,65,75,238,378
5055275,1756,460300,base+,completed,334.0,7.15,195,139,89,0,245,334,88,0,246,334,79,0,255,334,0,70,264,334,69,0,265,334
5055275,1756,460300,dpv1,completed,334.0,7.2,208,126,72,0,262,334,98,0,236,334,0,65,269,334,61,21,252,334,76,0,258,334
5055275,1756,460300,dpv2,completed,365.0,7.45,172,193,128,0,237,365,116,0,249,365,96,60,209,365,0,95,270,365,62,0,303,365
5055275,1756,460300,new-0.0,completed,320.0,6.8,204,116,78,0,242,320,0,59,261,320,76,0,244,320,94,0,226,320,57,0,263,320
5055275,1756,460300,new-0.5,completed,366.0,7.3,185,181,78,60,228,366,0,89,277,366,58,41,267,366,127,8,231,366,113,0,253,366
5055275,1756,460300,new-1.0,completed,377.0,7.5,179,198,125,0,252,377,83,56,238,377,131,4,242,377,0,115,262,377,65,35,277,377
5055275,1756,309704,base,completed,340.0,6.8,214,126,70,10,260,340,0,68,272,340,95,0,245,340,92,10,238,340,48,44,248,340
5055275,1756,309704,base+,completed,336.0,6.85,211,125,0,67,269,336,117,0,219,336,58,0,278,336,100,0,236,336,109,0,227,336
5055275,1756,309704,dpv1,completed,369.0,7.1,193,176,134,0,235,369,129,0,240,369,66,0,303,369,132,0,237,369,0,110,259,369
5055275,1756,309704,dpv2,completed,356.0,7.25,209,147,59,15,282,356,139,0,217,356,121,0,235,356,80,1,275,356,0,88,268,356
5055275,1756,309704,new-0.0,completed,329.0,7.0,215,114,102,0,227,329,97,11,221,329,0,46,283,329,81,0,248,329,57,10,262,329
5055275,1756,309704,new-0.5,completed,388.0,7.4,178,210,127,0,261,388,0,108,280,388,65,71,252,388,139,13,236,388,86,70,232,388
5055275,1756,309704,new-1.0,completed,352.0,7.8,183,169,112,0,240,352,76,47,229,352,0,78,274,352,57,28,267,352,110,0,242,352
5055275,1756,247588,base,completed,338.0,7.1,193,145,58,0,280,338,102,25,211,338,79,0,259,338,0,64,274,338,62,36,240,338
5055275,1756,247588,base+,completed,370.0,7.1,169,201,137,0,233,370,93,0,277,370,105,64,201,370,0,97,273,370,65,13,292,370
5055275,1756,247588,dpv1,completed,343.0,7.0,201,142,74,36,233,343,0,75,268,343,106,0,237,343,53,6,284,343,106,0,237,343
5055275,1756,247588,dpv2,completed,330.0,7.45,213,117,105,0,225,330,80,0,250,330,0,68,262,330,103,0,227,330,49,0,281,330
5055275,1756,247588,new-0.0,completed,316.0,7.0,213,103,74,0,242,316,0,47,269,316,89,1,226,316,94,0,222,316,55,0,261,316
5055275,1756,247588,new-0.5,completed,334.0,7.7,199,135,112,8,214,334,69,15,250,334,0,72,262,334,69,0,265,334,55,11,268,334
5055275,1756,247588,new-1.0,completed,363.0,7.7,204,159,109,0,254,363,63,50,250,363,0,102,261,363,132,0,231,363,46,45,272,363
5055275,1756,203195,base,completed,343.0,6.9,169,174,0,114,229,343,70,0,273,343,116,0,227,343,60,13,270,343,77,0,266,343
5055275,1756,203195,base+,completed,338.0,6.8,214,124,0,67,271,338,94,0,244,338,57,6,275,338,75,0,263,338,116,0,222,338
5055275,1756,203195,dpv1,completed,322.0,7.15,224,98,66,0,256,322,81,0,241,322,85,0,237,322,54,0,268,322,0,44,278,322
5055275,1756,203195,dpv2,completed,371.0,7.5,150,221,115,0,256,371,125,0,246,371,77,106,188,371,60,35,276,371,0,94,277,371
5055275,1756,203195,new-0.0,completed,318.0,6.8,190,128,95,0,223,318,0,76,242,318,52,0,266,318,78,0,240,318,73,0,245,318
5055275,1756,203195,new-0.5,completed,367.0,7.45,195,172,83,45,239,367,129,0,238,367,64,36,267,367,0,102,265,367,123,0,244,367
5055275,1756,203195,new-1.0,completed,382.0,7.4,172,210,0,102,280,382,88,71,223,382,69,33,280,382,132,10,240,382,129,0,253,382
5055275,1756,178029,base,completed,335.0,6.7,223,112,102,0,233,335,0,56,279,335,100,0,235,335,67,7,261,335,50,2,283,335
5055275,1756,178029,base+,completed,333.0,7.05,207,126,0,71,262,333,52,0,281,333,82,3,248,333,88,0,245,333,111,0,222,333
5055275,1756,178029,dpv1,completed,317.0,7.3,208,109,44,0,273,317,80,0,237,317,0,58,259,317,51,6,260,317,68,0,249,317
5055275,1756,178029,dpv2,completed,339.0,7.5,206,133,86,6,247,339,55,0,284,339,0,78,261,339,113,0,226,339,119,0,220,339
5055275,1756,178029,new-0.0,completed,330.0,6.95,192,138,107,0,223,330,59,2,269,330,83,14,233,330,80,0,250,330,0,65,265,330
5055275,1756,178029,new-0.5,completed,371.0,7.35,191,180,0,78,293,371,88,47,236,371,68,38,265,371,133,8,230,371,125,0,246,371
5055275,1756,178029,new-1.0,completed,350.0,7.7,178,172,107,0,243,350,77,53,220,350,0,79,271,350,110,0,240,350,55,33,262,350
5055275,1756,239735,base,completed,357.0,6.75,216,141,69,49,239,357,86,20,251,357,121,0,236,357,0,65,292,357,115,0,242,357
5055275,1756,239735,base+,completed,351.0,7.1,167,184,0,87,264,351,113,0,238,351,74,71,206,351,59,3,289,351,115,13,223,351
5055275,1756,239735,dpv1,completed,351.0,7.0,195,156,70,48,233,351,0,90,261,351,124,0,227,351,54,25,272,351,108,0,243,351
5055275,1756,239735,dpv2,completed,353.0,7.4,162,191,0,81,272,353,109,0,244,353,100,54,199,353,56,0,297,353,122,0,231,353
5055275,1756,239735,new-0.0,completed,314.0,6.95,217,97,0,33,281,314,88,0,226,314,81,0,233,314,64,0,250,314,96,0,218,314
5055275,1756,239735,new-0.5,completed,331.0,7.65,197,134,0,55,276,331,89,0,242,331,86,1,244,331,67,2,262,331,100,11,220,331
5055275,1756,239735,new-1.0,completed,355.0,7.6,185,170,110,0,245,355,72,53,230,355,0,82,273,355,115,7,233,355,57,28,270,355
5055275,1756,675528,base,completed,342.0,6.75,197,145,119,0,223,342,0,87,255,342,58,0,284,342,116,0,226,342,89,0,253,342
5055275,1756,675528,base+,completed,342.0,6.7,201,141,111,0,231,342,0,90,252,342,51,0,291,342,81,0,261,342,83,0,259,342
5055275,1756,675528,dpv1,completed,372.0,7.15,200,172,75,55,242,372,115,0,257,372,0,113,259,372,134,0,238,372,56,37,279,372
5055275,1756,675528,dpv2,completed,338.0,7.55,211,127,82,4,252,338,98,0,240,338,0,69,269,338,54,0,284,338,118,0,220,338
5055275,1756,675528,new-0.0,completed,300.0,6.9,213,87,82,0,218,300,78,0,222,300,0,39,261,300,45,0,255,300,48,0,252,300
5055275,1756,675528,new-0.5,completed,390.0,7.65,187,203,72,74,244,390,117,0,273,390,177,0,213,390,54,66,270,390,0,142,248,390
5055275,1756,675528,new-1.0,completed,359.0,7.7,191,168,107,0,252,359,73,51,235,359,0,84,275,359,124,0,235,359,53,49,257,359
5055275,1756,380692,base,completed,339.0,6.9,214,125,0,67,272,339,123,0,216,339,58,0,281,339,125,0,214,339,91,0,248,339
5055275,1756,380692,base+,completed,343.0,7.1,158,185,65,0,278,343,85,0,258,343,82,28,233,343,0,100,243,343,117,0,226,343
5055275,1756,380692,dpv1,completed,332.0,7.05,192,140,86,0,246,332,83,10,239,332,59,0,273,332,58,0,274,332,0,81,251,332
5055275,1756,380692,dpv2,completed,339.0,7.75,192,147,104,0,235,339,74,43,222,339,0,73,266,339,105,0,234,339,58,8,273,339
5055275,1756,380692,new-0.0,completed,305.0,7.0,210,95,82,0,223,305,76,0,229,305,0,41,264,305,54,0,251,305,79,0,226,305
5055275,1756,380692,new-0.5,completed,326.0,7.55,179,147,0,55,271,326,83,16,227,326,109,0,217,326,63,0,263,326,63,15,248,326
5055275,1756,380692,new-1.0,completed,361.0,7.65,177,184,52,25,284,361,68,70,223,361,0,96,265,361,98,13,250,361,118,0,243,361
6058019,1764,310811,base,completed,352.0,6.75,161,191,30,71,251,352,46,8,298,352,0,83,269,352,63,118,171,352,73,0,279,352
6058019,1764,310811,base+,completed,317.0,6.85,180,137,28,66,223,317,0,60,257,317,11,0,306,317,71,0,246,317,46,0,271,317
6058019,1764,310811,dpv1,completed,325.0,7.25,186,139,13,0,312,325,67,0,258,325,0,72,253,325,85,45,195,325,39,16,270,325
6058019,1764,310811,dpv2,completed,296.0,7.25,201,95,66,0,230,296,54,29,213,296,0,43,253,296,10,0,286,296,12,0,284,296
6058019,1764,310811,new-0.0,completed,289.0,6.95,209,80,47,0,242,289,0,3,286,289,19,12,258,289,37,0,252,289,68,0,221,289
6058019,1764,310811,new-0.5,completed,293.0,7.25,222,71,51,0,242,293,36,0,257,293,0,0,293,293,71,0,222,293,63,0,230,293
6058019,1764,310811,new-1.0,completed,292.0,7.3,183,109,46,0,246,292,52,0,240,292,2,13,277,292,35,26,231,292,0,32,260,292
6058019,1764,208428,base,completed,314.0,6.85,194,120,63,0,251,314,32,0,282,314,0,106,208,314,51,0,263,314,14,0,300,314
6058019,1764,208428,base+,completed,346.0,6.95,183,163,88,3,255,346,60,49,237,346,18,54,274,346,0,84,262,346,99,0,247,346
6058019,1764,208428,dpv1,completed,337.0,7.25,177,160,68,18,251,337,15,0,322,337,0,99,238,337,81,56,200,337,33,35,269,337
6058019,1764,208428,dpv2,completed,306.0,7.3,188,118,55,0,251,306,75,30,201,306,14,0,292,306,26,0,280,306,0,81,225,306
6058019,1764,208428,new-0.0,completed,276.0,7.0,223,53,25,4,247,276,40,0,236,276,0,0,276,276,28,0,248,276,53,0,223,276
6058019,1764,208428,new-0.5,completed,267.0,7.25,216,51,17,0,250,267,20,0,247,267,17,0,250,267,0,0,267,267,6,31,230,267
6058019,1764,208428,new-1.0,completed,298.0,7.3,180,118,0,0,298,298,9,22,267,298,54,28,216,298,23,0,275,298,48,28,222,298
6058019,1764,460300,base,completed,311.0,6.9,215,96,55,0,256,311,61,0,250,311,0,0,311,311,72,24,215,311,42,0,269,311
6058019,1764,460300,base+,completed,308.0,6.95,198,110,19,0,289,308,11,38,259,308,62,12,234,308,0,44,264,308,59,12,237,308
6058019,1764,460300,dpv1,completed,349.0,7.2,169,180,75,23,251,349,15,0,334,349,0,107,242,349,41,38,270,349,89,63,197,349
6058019,1764,460300,dpv2,completed,321.0,7.3,194,127,56,0,265,321,17,31,273,321,86,0,235,321,36,0,285,321,0,84,237,321
6058019,1764,460300,new-0.0,completed,304.0,7.0,220,84,84,0,220,304,0,0,304,304,48,0,256,304,53,0,251,304,81,0,223,304
6058019,1764,460300,new-0.5,completed,299.0,7.25,231,68,68,0,231,299,41,0,258,299,0,0,299,299,60,0,239,299,57,0,242,299
6058019,1764,460300,new-1.0,completed,294.0,7.3,203,91,45,0,249,294,0,6,288,294,10,28,256,294,39,0,255,294,39,20,235,294
6058019,1764,309704,base,completed,313.0,6.85,187,126,14,76,223,313,29,42,242,313,0,15,298,313,31,22,260,313,43,0,270,313
6058019,1764,309704,base+,completed,322.0,6.9,192,130,40,43,239,322,84,0,238,322,10,0,312,322,52,0,270,322,0,77,245,322
6058019,1764,309704,dpv1,completed,356.0,7.3,165,191,90,5,261,356,101,0,255,356,0,126,230,356,15,60,281,356,53,28,275,356
6058019,1764,309704,dpv2,completed,316.0,7.3,205,111,63,0,253,316,97,14,205,316,15,0,301,316,48,0,268,316,0,82,234,316
6058019,1764,309704,new-0.0,completed,285.0,6.95,225,60,20,3,262,285,36,0,249,285,49,0,236,285,0,11,274,285,48,0,237,285
6058019,1764,309704,new-0.5,completed,306.0,7.3,204,102,48,0,258,306,95,0,211,306,0,11,295,306,51,1,254,306,76,6,224,306
6058019,1764,309704,new-1.0,completed,294.0,7.3,203,91,0,0,294,294,42,0,252,294,10,0,284,294,58,7,229,294,58,26,210,294
6058019,1764,247588,base,completed,310.0,7.1,189,121,16,0,294,310,66,0,244,310,75,0,235,310,19,0,291,310,0,105,205,310
6058019,1764,247588,base+,completed,330.0,6.95,182,148,93,0,237,330,0,84,246,330,14,44,272,330,52,10,268,330,84,15,231,330
6058019,1764,247588,dpv1,completed,347.0,7.2,181,166,0,118,229,347,79,17,251,347,50,33,264,347,90,54,203,347,13,0,334,347
6058019,1764,247588,dpv2,completed,325.0,7.3,166,159,65,27,233,325,35,15,275,325,0,119,206,325,15,11,299,325,77,0,248,325
6058019,1764,247588,new-0.0,completed,289.0,6.95,209,80,0,1,288,289,50,0,239,289,80,0,209,289,8,0,281,289,53,0,236,289
6058019,1764,247588,new-0.5,completed,292.0,7.3,215,77,49,0,243,292,77,0,215,292,0,0,292,292,48,0,244,292,71,0,221,292
6058019,1764,247588,new-1.0,completed,298.0,7.3,183,115,18,0,280,298,0,0,298,298,32,21,245,298,60,0,238,298,53,55,190,298
6058019,1764,203195,base,completed,321.0,6.75,209,112,72,0,249,321,77,13,231,321,18,0,303,321,59,0,262,321,0,81,240,321
6058019,1764,203195,base+,completed,309.0,6.95,218,91,0,46,263,309,73,0,236,309,30,18,261,309,13,0,296,309,54,0,255,309
6058019,1764,203195,dpv1,completed,355.0,7.3,150,205,73,26,256,355,14,0,341,355,0,120,235,355,48,27,280,355,88,90,177,355
6058019,1764,203195,dpv2,completed,295.0,7.25,205,90,0,26,269,295,59,31,205,295,40,0,255,295,15,0,280,295,34,1,260,295
6058019,1764,203195,new-0.0,completed,286.0,7.0,230,56,22,0,264,286,48,0,238,286,0,8,278,286,47,0,239,286,46,0,240,286
6058019,1764,203195,new-0.5,completed,282.0,7.25,212,70,14,0,268,282,0,0,282,282,68,0,214,282,15,0,267,282,70,0,212,282
6058019,1764,203195,new-1.0,completed,293.0,7.3,180,113,46,0,247,293,56,2,235,293,3,9,281,293,37,22,234,293,0,35,258,293
6058019,1764,178029,base,completed,346.0,6.75,168,178,85,0,261,346,9,72,265,346,32,61,253,346,67,42,237,346,0,118,228,346
6058019,1764,178029,base+,completed,297.0,6.95,199,98,0,39,258,297,70,18,209,297,17,0,280,297,31,28,238,297,28,0,269,297
6058019,1764,178029,dpv1,completed,341.0,7.2,170,171,79,9,253,341,0,114,227,341,10,0,331,341,88,60,193,341,41,19,281,341
6058019,1764,178029,dpv2,completed,314.0,7.3,206,108,46,0,268,314,84,19,211,314,13,0,301,314,58,0,256,314,0,76,238,314
6058019,1764,178029,new-0.0,completed,276.0,7.0,234,42,42,0,234,276,33,0,243,276,0,0,276,276,30,0,246,276,17,0,259,276
6058019,1764,178029,new-0.5,completed,289.0,7.25,221,68,50,0,239,289,27,0,262,289,0,9,280,289,43,0,246,289,59,0,230,289
6058019,1764,178029,new-1.0,completed,292.0,7.3,198,94,10,0,282,292,0,0,292,292,58,25,209,292,31,0,261,292,60,9,223,292
6058019,1764,239735,base,completed,312.0,6.75,173,139,50,0,262,312,52,0,260,312,45,0,267,312,0,122,190,312,17,4,291,312
6058019,1764,239735,base+,completed,301.0,6.7,178,123,35,0,266,301,7,77,217,301,0,10,291,301,14,0,287,301,46,28,227,301
6058019,1764,239735,dpv1,completed,319.0,7.2,163,156,61,18,240,319,12,0,307,319,0,75,244,319,31,12,276,319,75,60,184,319
6058019,1764,239735,dpv2,completed,279.0,7.3,199,80,29,0,250,279,40,33,206,279,0,35,244,279,12,0,267,279,0,0,279,279
6058019,1764,239735,new-0.0,completed,282.0,6.95,203,79,56,0,226,282,34,0,248,282,33,0,249,282,0,26,256,282,48,0,234,282
6058019,1764,239735,new-0.5,completed,281.0,7.3,223,58,49,0,232,281,41,0,240,281,28,17,236,281,0,0,281,281,42,0,239,281
6058019,1764,239735,new-1.0,completed,290.0,7.3,161,129,0,0,290,290,11,13,266,290,32,52,206,290,52,0,238,290,10,28,252,290
6058019,1764,675528,base,completed,331.0,6.9,182,149,99,0,232,331,60,0,271,331,80,0,251,331,11,0,320,331,0,138,193,331
6058019,1764,675528,base+,completed,308.0,7.05,226,82,68,0,240,308,0,70,238,308,82,0,226,308,10,0,298,308,56,0,252,308
6058019,1764,675528,dpv1,completed,348.0,7.25,163,185,75,19,254,348,92,0,256,348,0,101,247,348,15,67,266,348,52,30,266,348
6058019,1764,675528,dpv2,completed,290.0,7.3,198,92,58,0,232,290,30,0,260,290,7,27,256,290,16,0,274,290,0,49,241,290
6058019,1764,675528,new-0.0,completed,284.0,6.95,234,50,48,0,236,284,47,0,237,284,10,0,274,284,0,0,284,284,50,0,234,284
6058019,1764,675528,new-0.5,completed,289.0,7.3,219,70,34,0,255,289,66,0,223,289,0,4,285,289,55,0,234,289,22,0,267,289
6058019,1764,675528,new-1.0,completed,291.0,7.3,198,93,0,0,291,291,6,0,285,291,48,25,218,291,43,0,248,291,50,18,223,291
6058019,1764,380692,base,completed,324.0,6.95,181,143,19,108,197,324,0,2,322,324,45,0,279,324,31,90,203,324,46,0,278,324
6058019,1764,380692,base+,completed,286.0,7.0,225,61,0,51,235,286,49,5,232,286,10,0,276,286,28,0,258,286,51,0,235,286
6058019,1764,380692,dpv1,completed,346.0,7.25,161,185,73,13,260,346,92,0,254,346,0,123,223,346,12,72,262,346,33,35,278,346
6058019,1764,380692,dpv2,completed,310.0,7.3,188,122,72,0,238,310,67,39,204,310,13,0,297,310,23,0,287,310,0,70,240,310
6058019,1764,380692,new-0.0,completed,262.0,7.0,231,31,29,0,233,262,22,0,240,262,1,2,259,262,10,0,252,262,0,0,262,262
6058019,1764,380692,new-0.5,completed,299.0,7.3,225,74,53,0,246,299,59,0,240,299,73,1,225,299,66,0,233,299,0,0,299,299
6058019,1764,380692,new-1.0,completed,304.0,7.3,170,134,0,0,304,304,6,0,298,304,51,27,226,304,56,32,216,304,59,19,226,304
6030697,1801,310811,base,completed,329.0,7.05,178,151,60,78,191,329,0,57,272,329,24,0,305,329,59,0,270,329,53,0,276,329
6030697,1801,310811,base+,completed,305.0,7.15,201,104,71,0,234,305,72,0,233,305,0,28,277,305,43,0,262,305,22,4,279,305
6030697,1801,310811,dpv1,completed,299.0,7.1,219,80,68,0,231,299,68,0,231,299,12,12,275,299,28,0,271,299,0,0,299,299
6030697,1801,310811,dpv2,completed,316.0,7.3,215,101,50,0,266,316,50,0,266,316,0,51,265,316,89,0,227,316,72,0,244,316
6030697,1801,310811,new-0.0,completed,289.0,7.35,229,60,60,0,229,289,0,0,289,289,32,0,257,289,60,0,229,289,14,0,275,289
6030697,1801,310811,new-0.5,completed,279.0,7.55,221,58,27,0,252,279,0,0,279,279,53,0,226,279,58,0,221,279,20,0,259,279
6030697,1801,310811,new-1.0,completed,308.0,7.45,156,152,48,0,260,308,19,42,247,308,0,49,259,308,42,49,217,308,19,0,289,308
6030697,1801,208428,base,completed,379.0,6.85,142,237,84,0,295,379,53,0,326,379,91,0,288,379,80,94,205,379,0,184,195,379
6030697,1801,208428,base+,completed,326.0,6.9,213,113,92,0,234,326,58,0,268,326,0,41,285,326,55,0,271,326,72,14,240,326
6030697,1801,208428,dpv1,completed,296.0,7.15,225,71,57,0,239,296,4,14,278,296,0,0,296,296,30,0,266,296,57,0,239,296
6030697,1801,208428,dpv2,completed,281.0,7.6,221,60,0,0,281,281,46,0,235,281,4,14,263,281,17,0,264,281,16,0,265,281
6030697,1801,208428,new-0.0,completed,310.0,7.25,228,82,74,0,236,310,0,0,310,310,51,0,259,310,70,0,240,310,82,0,228,310
6030697,1801,208428,new-0.5,completed,293.0,7.65,221,72,30,0,263,293,72,0,221,293,64,0,229,293,0,0,293,293,28,0,265,293
6030697,1801,208428,new-1.0,completed,283.0,7.6,219,64,25,0,258,283,31,0,252,283,25,6,252,283,0,27,256,283,31,0,252,283
6030697,1801,460300,base,completed,319.0,7.05,231,88,86,0,233,319,37,0,282,319,70,0,249,319,56,0,263,319,0,32,287,319
6030697,1801,460300,base+,completed,345.0,6.9,174,171,0,116,229,345,75,0,270,345,32,0,313,345,55,0,290,345,100,0,245,345
6030697,1801,460300,dpv1,completed,303.0,7.4,222,81,41,0,262,303,39,0,264,303,68,0,235,303,0,22,281,303,59,0,244,303
6030697,1801,460300,dpv2,completed,318.0,7.25,223,95,60,0,258,318,0,39,279,318,40,0,278,318,91,0,227,318,56,0,262,318
6030697,1801,460300,new-0.0,completed,293.0,7.35,236,57,48,0,245,293,0,0,293,293,43,0,250,293,57,0,236,293,25,0,268,293
6030697,1801,460300,new-0.5,completed,294.0,7.6,220,74,22,0,272,294,0,0,294,294,66,0,228,294,34,0,260,294,74,0,220,294
6030697,1801,460300,new-1.0,completed,282.0,7.5,240,42,27,4,251,282,25,0,257,282,11,0,271,282,0,8,274,282,30,0,252,282
6030697,1801,309704,base,completed,302.0,6.9,223,79,74,0,228,302,29,0,273,302,0,27,275,302,32,0,270,302,52,0,250,302
6030697,1801,309704,base+,completed,318.0,7.05,189,129,50,0,268,318,90,0,228,318,0,79,239,318,63,0,255,318,33,0,285,318
6030697,1801,309704,dpv1,completed,283.0,7.5,209,74,56,0,227,283,22,0,261,283,8,0,275,283,37,0,246,283,0,18,265,283
6030697,1801,309704,dpv2,completed,321.0,7.35,220,101,62,0,259,321,87,0,234,321,37,0,284,321,0,39,282,321,98,0,223,321
6030697,1801,309704,new-0.0,completed,287.0,7.35,222,65,54,0,233,287,0,0,287,287,34,0,253,287,65,0,222,287,33,0,254,287
6030697,1801,309704,new-0.5,completed,292.0,7.45,219,73,73,0,219,292,33,0,259,292,0,0,292,292,72,0,220,292,20,0,272,292
6030697,1801,309704,new-1.0,completed,299.0,7.55,166,133,15,0,284,299,24,39,236,299,0,39,260,299,48,29,222,299,47,0,252,299
6030697,1801,247588,base,completed,303.0,7.25,162,141,4,17,282,303,0,0,303,303,15,75,213,303,41,0,262,303,66,0,237,303
6030697,1801,247588,base+,completed,294.0,7.15,207,87,41,0,253,294,38,0,256,294,0,38,256,294,49,0,245,294,33,0,261,294
6030697,1801,247588,dpv1,completed,296.0,7.25,206,90,26,0,270,296,57,0,239,296,0,43,253,296,23,0,273,296,47,0,249,296
6030697,1801,247588,dpv2,completed,299.0,7.5,193,106,49,0,250,299,48,32,219,299,0,25,274,299,48,0,251,299,24,0,275,299
6030697,1801,247588,new-0.0,completed,294.0,7.25,226,68,68,0,226,294,0,0,294,294,34,0,260,294,60,0,234,294,50,0,244,294
6030697,1801,247588,new-0.5,completed,273.0,7.65,233,40,15,0,258,273,0,0,273,273,40,0,233,273,39,0,234,273,40,0,233,273
6030697,1801,247588,new-1.0,completed,295.0,7.6,180,115,0,0,295,295,44,0,251,295,11,28,256,295,33,19,243,295,30,24,241,295
6030697,1801,203195,base,completed,332.0,7.0,242,90,0,37,295,332,88,0,244,332,53,0,279,332,59,0,273,332,79,0,253,332
6030697,1801,203195,base+,completed,314.0,7.05,176,138,0,5,309,314,66,1,247,314,23,56,235,314,15,8,291,314,72,4,238,314
6030697,1801,203195,dpv1,completed,287.0,7.4,212,75,53,0,234,287,36,0,251,287,48,0,239,287,0,0,287,287,2,22,263,287
6030697,1801,203195,dpv2,completed,300.0,7.55,213,87,0,0,300,300,72,0,228,300,17,2,281,300,27,13,260,300,55,0,245,300
6030697,1801,203195,new-0.0,completed,303.0,7.35,223,80,24,0,279,303,0,0,303,303,80,0,223,303,68,0,235,303,48,0,255,303
6030697,1801,203195,new-0.5,completed,276.0,7.6,223,53,1,0,275,276,14,0,262,276,36,0,240,276,0,0,276,276,53,0,223,276
6030697,1801,203195,new-1.0,completed,282.0,7.6,221,61,0,0,282,282,21,1,260,282,4,5,273,282,33,11,238,282,44,0,238,282
6030697,1801,178029,base,completed,292.0,7.0,197,95,2,0,290,292,53,0,239,292,0,46,246,292,49,0,243,292,3,28,261,292
6030697,1801,178029,base+,completed,305.0,6.9,227,78,0,23,282,305,37,0,268,305,59,0,246,305,34,0,271,305,55,0,250,305
6030697,1801,178029,dpv1,completed,295.0,7.3,206,89,62,0,233,295,60,0,235,295,32,0,263,295,0,0,295,295,12,27,256,295
6030697,1801,178029,dpv2,completed,317.0,7.35,216,101,54,0,263,317,70,0,247,317,28,0,289,317,0,47,270,317,76,0,241,317
6030697,1801,178029,new-0.0,completed,293.0,7.25,235,58,45,0,248,293,0,0,293,293,54,0,239,293,58,0,235,293,51,0,242,293
6030697,1801,178029,new-0.5,completed,300.0,7.65,227,73,30,0,270,300,0,0,300,300,73,0,227,300,62,0,238,300,54,0,246,300
6030697,1801,178029,new-1.0,completed,315.0,7.55,156,159,17,0,298,315,20,52,243,315,0,53,262,315,44,36,235,315,54,0,261,315
6030697,1801,239735,base,completed,317.0,7.0,228,89,82,0,235,317,56,0,261,317,23,0,294,317,51,0,266,317,0,38,279,317
6030697,1801,239735,base+,completed,313.0,7.4,222,91,87,0,226,313,44,0,269,313,78,0,235,313,0,32,281,313,59,0,254,313
6030697,1801,239735,dpv1,completed,298.0,7.55,200,98,36,0,262,298,77,0,221,298,0,46,252,298,52,0,246,298,35,0,263,298
6030697,1801,239735,dpv2,completed,309.0,7.4,199,110,72,0,237,309,27,2,280,309,50,0,259,309,0,50,259,309,58,4,247,309
6030697,1801,239735,new-0.0,completed,290.0,7.25,218,72,72,0,218,290,0,0,290,290,36,0,254,290,56,0,234,290,51,0,239,290
6030697,1801,239735,new-0.5,completed,276.0,7.65,201,75,24,0,252,276,0,0,276,276,59,9,208,276,66,0,210,276,15,0,261,276
6030697,1801,239735,new-1.0,completed,289.0,7.55,156,133,27,64,198,289,2,0,287,289,9,41,239,289,43,26,220,289,0,0,289,289
6030697,1801,675528,base,completed,304.0,7.15,144,160,21,99,184,304,16,0,288,304,0,20,284,304,61,0,243,304,30,0,274,304
6030697,1801,675528,base+,completed,319.0,6.9,183,136,0,46,273,319,53,0,266,319,74,0,245,319,35,37,247,319,50,0,269,319
6030697,1801,675528,dpv1,completed,294.0,7.4,207,87,57,0,237,294,40,0,254,294,64,0,230,294,0,0,294,294,8,30,256,294
6030697,1801,675528,dpv2,completed,315.0,7.35,220,95,53,0,262,315,81,0,234,315,25,0,290,315,0,42,273,315,82,0,233,315
6030697,1801,675528,new-0.0,completed,297.0,7.25,226,71,71,0,226,297,0,0,297,297,35,0,262,297,65,0,232,297,48,0,249,297
6030697,1801,675528,new-0.5,completed,293.0,7.5,220,73,0,0,293,293,42,0,251,293,73,0,220,293,65,0,228,293,29,0,264,293
6030697,1801,675528,new-1.0,completed,305.0,7.45,164,141,48,0,257,305,16,38,251,305,0,55,250,305,36,35,234,305,20,0,285,305
6030697,1801,380692,base,completed,306.0,7.1,183,123,26,0,280,306,41,32,233,306,36,67,203,306,0,2,304,306,54,0,252,306
6030697,1801,380692,base+,completed,323.0,7.1,204,119,87,0,236,323,46,0,277,323,89,0,234,323,0,64,259,323,55,0,268,323
6030697,1801,380692,dpv1,completed,299.0,7.3,211,88,71,0,228,299,65,0,234,299,40,0,259,299,0,0,299,299,18,17,264,299
6030697,1801,380692,dpv2,completed,315.0,7.45,225,90,33,0,282,315,79,0,236,315,0,36,279,315,56,0,259,315,54,0,261,315
6030697,1801,380692,new-0.0,completed,281.0,7.25,227,54,0,0,281,281,1,0,280,281,54,0,227,281,36,0,245,281,42,0,239,281
6030697,1801,380692,new-0.5,completed,295.0,7.5,226,69,0,0,295,295,38,0,257,295,68,0,227,295,69,0,226,295,37,0,258,295
6030697,1801,380692,new-1.0,completed,306.0,7.55,161,145,8,0,298,306,7,45,254,306,0,48,258,306,42,47,217,306,42,0,264,306
7957221,1727,310811,base,completed,364.0,6.65,122,242,61,61,242,364,96,12,256,364,62,32,270,364,65,125,174,364,0,20,344,364
7957221,1727,310811,base+,completed,369.0,6.75,113,256,96,0,273,369,74,13,282,369,0,218,151,369,38,0,331,369,60,82,227,369
7957221,1727,310811,dpv1,completed,353.0,6.85,113,240,113,0,240,353,55,63,235,353,0,94,259,353,36,0,317,353,66,110,177,353
7957221,1727,310811,dpv2,completed,345.0,6.9,111,234,0,82,263,345,34,0,311,345,76,0,269,345,27,92,226,345,44,121,180,345
7957221,1727,310811,new-0.0,completed,293.0,7.0,195,98,36,0,257,293,51,28,214,293,0,6,287,293,64,0,229,293,26,0,267,293
7957221,1727,310811,new-0.5,completed,296.0,7.05,188,108,11,19,266,296,52,31,213,296,38,6,252,296,68,0,228,296,0,0,296,296
7957221,1727,310811,new-1.0,completed,311.0,7.1,151,160,0,59,252,311,27,0,284,311,60,27,224,311,72,29,210,311,5,0,306,311
7957221,1727,208428,base,completed,370.0,6.9,81,289,0,152,218,370,63,149,158,370,49,62,259,370,37,0,333,370,73,0,297,370
7957221,1727,208428,base+,completed,344.0,6.9,139,205,108,19,217,344,78,41,225,344,53,75,216,344,38,0,306,344,0,42,302,344
7957221,1727,208428,dpv1,completed,343.0,6.8,142,201,31,0,312,343,57,72,214,343,56,64,223,343,0,75,268,343,94,0,249,343
7957221,1727,208428,dpv2,completed,348.0,6.9,112,236,50,106,192,348,0,76,272,348,36,0,312,348,83,0,265,348,40,87,221,348
7957221,1727,208428,new-0.0,completed,286.0,6.95,211,75,25,0,261,286,0,0,286,286,63,0,223,286,58,0,228,286,45,12,229,286
7957221,1727,208428,new-0.5,completed,286.0,6.95,211,75,25,0,261,286,0,0,286,286,63,0,223,286,58,0,228,286,45,12,229,286
7957221,1727,208428,new-1.0,completed,305.0,7.05,166,139,0,48,257,305,30,0,275,305,33,6,266,305,67,0,238,305,80,5,220,305
7957221,1727,460300,base,completed,355.0,6.9,115,240,0,151,204,355,32,63,260,355,59,120,176,355,11,0,344,355,39,47,269,355
7957221,1727,460300,base+,completed,367.0,6.85,155,212,67,20,280,367,58,145,164,367,41,0,326,367,113,0,254,367,0,100,267,367
7957221,1727,460300,dpv1,completed,348.0,6.8,152,196,99,0,249,348,51,57,240,348,68,75,205,348,0,71,277,348,34,0,314,348
7957221,1727,460300,dpv2,completed,337.0,6.95,79,258,0,0,337,337,44,30,263,337,18,72,247,337,73,0,264,337,4,174,159,337
7957221,1727,460300,new-0.0,completed,320.0,7.0,162,158,93,0,227,320,67,40,213,320,0,25,295,320,74,0,246,320,50,0,270,320
7957221,1727,460300,new-0.5,completed,320.0,7.0,162,158,93,0,227,320,67,40,213,320,0,25,295,320,74,0,246,320,50,0,270,320
7957221,1727,460300,new-1.0,completed,313.0,7.05,159,154,0,13,300,313,17,37,259,313,45,15,253,313,86,30,197,313,49,0,264,313
7957221,1727,309704,base,completed,365.0,6.7,88,277,0,17,348,365,64,61,240,365,93,134,138,365,38,25,302,365,88,22,255,365
7957221,1727,309704,base+,completed,360.0,6.75,119,241,37,0,323,360,61,53,246,360,0,204,156,360,99,0,261,360,57,29,274,360
7957221,1727,309704,dpv1,completed,352.0,6.8,93,259,64,73,215,352,91,0,261,352,0,69,283,352,41,0,311,352,75,110,167,352
7957221,1727,309704,dpv2,completed,335.0,7.05,121,214,0,58,277,335,39,24,272,335,60,61,214,335,49,58,228,335,86,0,249,335
7957221,1727,309704,new-0.0,completed,299.0,6.9,182,117,53,0,246,299,0,16,283,299,59,17,223,299,84,0,215,299,30,0,269,299
7957221,1727,309704,new-0.5,completed,299.0,6.9,182,117,53,0,246,299,0,16,283,299,59,17,223,299,84,0,215,299,30,0,269,299
7957221,1727,309704,new-1.0,completed,306.0,7.2,141,165,0,30,276,306,55,0,251,306,41,20,245,306,84,31,191,306,4,25,277,306
7957221,1727,247588,base,completed,388.0,6.7,98,290,44,125,219,388,62,54,272,388,86,43,259,388,0,256,132,388,28,0,360,388
7957221,1727,247588,base+,completed,360.0,6.9,100,260,98,8,254,360,58,78,224,360,46,134,180,360,0,132,228,360,30,0,330,360
7957221,1727,247588,dpv1,completed,339.0,6.85,129,210,0,63,276,339,59,79,201,339,92,0,247,339,58,64,217,339,38,0,301,339
7957221,1727,247588,dpv2,completed,378.0,7.0,112,266,53,57,268,378,98,0,280,378,57,110,211,378,32,26,320,378,0,234,144,378
7957221,1727,247588,new-0.0,completed,298.0,6.95,164,134,51,0,247,298,41,36,221,298,0,0,298,298,30,29,239,298,69,0,229,298
7957221,1727,247588,new-0.5,completed,289.0,6.95,164,125,4,31,254,289,35,37,217,289,0,0,289,289,10,29,250,289,59,0,230,289
7957221,1727,247588,new-1.0,completed,311.0,7.05,141,170,0,30,281,311,11,31,269,311,42,25,244,311,78,20,213,311,44,0,267,311
7957221,1727,203195,base,completed,338.0,6.9,89,249,0,136,202,338,51,1,286,338,63,23,252,338,89,0,249,338,66,0,272,338
7957221,1727,203195,base+,completed,365.0,6.95,173,192,0,155,210,365,58,17,290,365,95,0,270,365,44,135,186,365,33,5,327,365
7957221,1727,203195,dpv1,completed,364.0,6.8,62,302,34,0,330,364,0,110,254,364,57,77,230,364,109,0,255,364,67,121,176,364
7957221,1727,203195,dpv2,completed,373.0,6.95,102,271,69,38,266,373,0,112,261,373,20,126,227,373,32,14,327,373,69,121,183,373
7957221,1727,203195,new-0.0,completed,307.0,7.0,167,140,82,0,225,307,0,25,282,307,33,0,274,307,45,33,229,307,73,0,234,307
7957221,1727,203195,new-0.5,completed,307.0,7.0,167,140,82,0,225,307,0,25,282,307,33,0,274,307,45,33,229,307,73,0,234,307
7957221,1727,203195,new-1.0,completed,312.0,7.05,141,171,0,20,292,312,11,34,267,312,54,22,236,312,85,39,188,312,48,0,264,312
7957221,1727,178029,base,completed,330.0,6.9,118,212,36,0,294,330,69,100,161,330,24,63,243,330,32,23,275,330,0,84,246,330
7957221,1727,178029,base+,completed,352.0,6.75,172,180,46,27,279,352,37,0,315,352,0,132,220,352,73,53,226,352,50,73,229,352
7957221,1727,178029,dpv1,completed,348.0,6.9,143,205,49,61,238,348,103,0,245,348,32,82,234,348,0,70,278,348,57,25,266,348
7957221,1727,178029,dpv2,completed,369.0,6.95,127,242,72,61,236,369,23,0,346,369,38,11,320,369,74,132,163,369,0,204,165,369
7957221,1727,178029,new-0.0,completed,307.0,7.0,157,150,24,0,283,307,0,41,266,307,47,28,232,307,81,0,226,307,71,0,236,307
7957221,1727,178029,new-0.5,completed,307.0,7.0,157,150,24,0,283,307,0,41,266,307,47,28,232,307,81,0,226,307,71,0,236,307
7957221,1727,178029,new-1.0,completed,307.0,7.05,154,153,68,59,180,307,25,0,282,307,34,16,257,307,0,24,283,307,47,0,260,307
7957221,1727,239735,base,completed,375.0,7.1,85,290,55,165,155,375,54,46,275,375,0,84,291,375,40,0,335,375,94,81,200,375
7957221,1727,239735,base+,completed,349.0,6.6,135,214,29,0,320,349,94,7,248,349,59,0,290,349,49,92,208,349,0,185,164,349
7957221,1727,239735,dpv1,completed,319.0,6.8,76,243,61,0,258,319,28,33,258,319,0,46,273,319,38,41,240,319,32,117,170,319
7957221,1727,239735,dpv2,completed,347.0,6.9,133,214,96,0,251,347,71,80,196,347,33,0,314,347,55,67,225,347,0,100,247,347
7957221,1727,239735,new-0.0,completed,280.0,7.0,174,106,11,0,269,280,0,25,255,280,35,22,223,280,59,0,221,280,35,0,245,280
7957221,1727,239735,new-0.5,completed,280.0,7.0,174,106,11,0,269,280,0,25,255,280,35,22,223,280,59,0,221,280,35,0,245,280
7957221,1727,239735,new-1.0,completed,290.0,7.1,156,134,1,0,289,290,55,6,229,290,30,55,205,290,60,13,217,290,0,0,290,290
7957221,1727,675528,base,completed,432.0,6.95,85,347,22,164,246,432,48,0,384,432,31,126,275,432,0,222,210,432,22,274,136,432
7957221,1727,675528,base+,completed,331.0,6.85,118,213,63,0,268,331,0,179,152,331,18,1,312,331,19,39,273,331,34,41,256,331
7957221,1727,675528,dpv1,completed,350.0,6.75,115,235,0,92,258,350,62,98,190,350,36,0,314,350,56,80,214,350,97,0,253,350
7957221,1727,675528,dpv2,completed,327.0,6.9,129,198,48,97,182,327,28,7,292,327,0,60,267,327,5,103,219,327,55,0,272,327
7957221,1727,675528,new-0.0,completed,296.0,7.05,164,132,11,0,285,296,0,30,266,296,72,0,224,296,44,30,222,296,48,0,248,296
7957221,1727,675528,new-0.5,completed,296.0,7.05,164,132,11,0,285,296,0,30,266,296,72,0,224,296,44,30,222,296,48,0,248,296
7957221,1727,675528,new-1.0,completed,322.0,7.05,141,181,39,24,259,322,0,52,270,322,43,31,248,322,74,59,189,322,2,0,320,322
7957221,1727,380692,base,completed,360.0,6.9,153,207,67,0,293,360,42,100,218,360,0,159,201,360,33,140,187,360,0,20,340,360
7957221,1727,380692,base+,completed,360.0,6.95,124,236,84,0,276,360,41,82,237,360,56,22,282,360,0,204,156,360,32,0,328,360
7957221,1727,380692,dpv1,completed,337.0,6.9,140,197,37,59,241,337,59,0,278,337,0,69,268,337,60,65,212,337,104,0,233,337
7957221,1727,380692,dpv2,completed,344.0,6.95,118,226,81,0,263,344,0,80,264,344,37,0,307,344,42,86,216,344,52,115,177,344
7957221,1727,380692,new-0.0,completed,317.0,7.05,156,161,89,0,228,317,49,35,233,317,0,0,317,317,52,41,224,317,81,0,236,317
7957221,1727,380692,new-0.5,completed,317.0,7.05,156,161,89,0,228,317,49,35,233,317,0,0,317,317,52,41,224,317,81,0,236,317
7957221,1727,380692,new-1.0,completed,310.0,7.1,146,164,0,64,246,310,39,0,271,310,65,16,229,310,81,13,216,310,16,0,294,310
6430493,1742,310811,base,completed,329.0,7.15,164,165,8,98,223,329,65,0,264,329,30,0,299,329,67,53,209,329,0,87,242,329
6430493,1742,310811,base+,completed,336.0,6.9,157,179,0,101,235,336,95,38,203,336,28,0,308,336,33,0,303,336,96,39,201,336
6430493,1742,310811,dpv1,completed,303.0,7.2,149,154,36,65,202,303,62,8,233,303,0,38,265,303,28,0,275,303,25,25,253,303
6430493,1742,310811,dpv2,completed,319.0,7.4,127,192,47,68,204,319,34,42,243,319,87,0,232,319,0,40,279,319,43,16,260,319
6430493,1742,310811,new-0.0,completed,295.0,6.95,173,122,9,18,268,295,66,12,217,295,34,0,261,295,0,56,239,295,62,0,233,295
6430493,1742,310811,new-0.5,completed,306.0,7.5,154,152,0,21,285,306,33,23,250,306,1,55,250,306,70,25,211,306,62,14,230,306
6430493,1742,310811,new-1.0,completed,327.0,7.5,146,181,64,5,258,327,33,0,294,327,0,51,276,327,27,63,237,327,88,30,209,327
6430493,1742,208428,base,completed,351.0,6.95,141,210,0,80,271,351,85,46,220,351,93,0,258,351,50,94,207,351,46,0,305,351
6430493,1742,208428,base+,completed,316.0,6.75,156,160,7,0,309,316,59,7,250,316,66,44,206,316,0,65,251,316,28,40,248,316
6430493,1742,208428,dpv1,completed,365.0,7.45,140,225,69,45,251,365,60,0,305,365,0,42,323,365,96,68,201,365,102,87,176,365
6430493,1742,208428,dpv2,completed,331.0,7.6,135,196,30,123,178,331,0,21,310,331,8,7,316,331,27,42,262,331,73,61,197,331
6430493,1742,208428,new-0.0,completed,315.0,6.85,160,155,88,24,203,315,80,12,223,315,45,0,270,315,13,55,247,315,0,24,291,315
6430493,1742,208428,new-0.5,completed,315.0,7.4,178,137,47,17,251,315,76,19,220,315,7,55,253,315,0,9,306,315,76,6,233,315
6430493,1742,208428,new-1.0,completed,330.0,7.55,154,176,39,65,226,330,30,0,300,330,0,59,271,330,69,6,255,330,83,28,219,330
6430493,1742,460300,base,completed,390.0,6.9,109,281,0,100,290,390,60,152,178,390,74,17,299,390,65,11,314,390,49,168,173,390
6430493,1742,460300,base+,completed,363.0,7.0,150,213,76,49,238,363,70,87,206,363,79,39,245,363,0,0,363,363,83,37,243,363
6430493,1742,460300,dpv1,completed,354.0,7.35,157,197,56,0,298,354,71,36,247,354,0,2,352,354,93,49,212,354,98,90,166,354
6430493,1742,460300,dpv2,completed,305.0,7.4,137,168,39,65,201,305,27,30,248,305,72,0,233,305,0,32,273,305,35,5,265,305
6430493,1742,460300,new-0.0,completed,307.0,6.9,162,145,72,14,221,307,66,7,234,307,36,10,261,307,0,66,241,307,8,21,278,307
6430493,1742,460300,new-0.5,completed,309.0,7.5,178,131,0,12,297,309,31,16,262,309,1,60,248,309,71,15,223,309,66,0,243,309
6430493,1742,460300,new-1.0,completed,311.0,7.6,159,152,58,0,253,311,25,0,286,311,69,21,221,311,8,62,241,311,0,42,269,311
6430493,1742,309704,base,completed,372.0,7.0,128,244,0,0,372,372,61,142,169,372,57,128,187,372,46,48,278,372,34,91,247,372
6430493,1742,309704,base+,completed,289.0,6.85,188,101,46,0,243,289,51,50,188,289,50,0,239,289,0,0,289,289,3,20,266,289
6430493,1742,309704,dpv1,completed,358.0,7.45,140,218,70,58,230,358,54,0,304,358,0,13,345,358,91,74,193,358,98,89,171,358
6430493,1742,309704,dpv2,completed,317.0,7.5,107,210,27,112,178,317,4,54,259,317,0,0,317,317,74,49,194,317,15,0,302,317
6430493,1742,309704,new-0.0,completed,309.0,6.95,162,147,77,29,203,309,0,12,297,309,37,0,272,309,15,61,233,309,71,9,229,309
6430493,1742,309704,new-0.5,completed,311.0,7.55,159,152,77,9,225,311,0,27,284,311,0,58,253,311,35,20,256,311,67,5,239,311
6430493,1742,309704,new-1.0,completed,334.0,7.55,146,188,49,65,220,334,35,0,299,334,0,67,267,334,70,6,258,334,104,19,211,334
6430493,1742,247588,base,completed,315.0,6.9,186,129,50,0,265,315,57,24,234,315,82,21,212,315,53,0,262,315,0,35,280,315
6430493,1742,247588,base+,completed,374.0,6.95,139,235,109,45,220,374,96,65,213,374,68,97,209,374,74,43,257,374,0,36,338,374
6430493,1742,247588,dpv1,completed,287.0,7.4,180,107,1,38,248,287,37,3,247,287,41,0,246,287,34,45,208,287,0,9,278,287
6430493,1742,247588,dpv2,completed,316.0,7.5,151,165,0,79,237,316,58,46,212,316,61,0,255,316,64,0,252,316,23,19,274,316
6430493,1742,247588,new-0.0,completed,301.0,6.9,154,147,66,24,211,301,64,16,221,301,32,0,269,301,0,65,236,301,3,11,287,301
6430493,1742,247588,new-0.5,completed,293.0,7.45,171,122,0,20,273,293,53,21,219,293,18,45,230,293,61,9,223,293,54,0,239,293
6430493,1742,247588,new-1.0,completed,297.0,7.55,178,119,35,2,260,297,9,0,288,297,60,0,237,297,0,43,254,297,18,59,220,297
6430493,1742,203195,base,completed,352.0,6.9,133,219,62,86,204,352,0,145,207,352,3,19,330,352,31,0,321,352,63,71,218,352
6430493,1742,203195,base+,completed,362.0,7.05,112,250,88,84,190,362,21,32,309,362,83,40,239,362,0,69,293,362,36,93,233,362
6430493,1742,203195,dpv1,completed,346.0,7.35,143,203,45,0,301,346,65,41,240,346,0,11,335,346,79,60,207,346,94,98,154,346
6430493,1742,203195,dpv2,completed,319.0,7.45,119,200,61,27,231,319,66,44,209,319,60,0,259,319,0,61,258,319,18,33,268,319
6430493,1742,203195,new-0.0,completed,303.0,6.85,174,129,70,0,233,303,72,14,217,303,36,1,266,303,2,57,244,303,0,24,279,303
6430493,1742,203195,new-0.5,completed,319.0,7.45,158,161,73,0,246,319,43,33,243,319,16,59,244,319,0,28,291,319,75,18,226,319
6430493,1742,203195,new-1.0,completed,349.0,7.55,145,204,106,0,243,349,105,19,225,349,34,52,263,349,56,68,225,349,0,47,302,349
6430493,1742,178029,base,completed,304.0,7.15,142,162,2,9,293,304,28,0,276,304,0,74,230,304,56,0,248,304,64,66,174,304
6430493,1742,178029,base+,completed,333.0,7.05,143,190,33,73,227,333,0,0,333,333,66,0,267,333,59,62,212,333,73,70,190,333
6430493,1742,178029,dpv1,completed,324.0,7.25,133,191,35,73,216,324,73,93,158,324,0,6,318,324,30,0,294,324,12,28,284,324
6430493,1742,178029,dpv2,completed,326.0,7.5,139,187,80,18,228,326,76,38,212,326,15,7,304,326,0,65,261,326,85,7,234,326
6430493,1742,178029,new-0.0,completed,304.0,6.95,177,127,0,8,296,304,68,0,236,304,47,2,255,304,22,52,230,304,75,21,208,304
6430493,1742,178029,new-0.5,completed,317.0,7.45,182,135,0,20,297,317,47,16,254,317,25,50,242,317,80,16,221,317,82,2,233,317
6430493,1742,178029,new-1.0,completed,324.0,7.5,166,158,74,0,250,324,0,32,292,324,74,23,227,324,41,0,283,324,28,61,235,324
6430493,1742,239735,base,completed,330.0,6.95,119,211,34,60,236,330,20,0,310,330,73,22,235,330,82,35,213,330,0,104,226,330
6430493,1742,239735,base+,completed,353.0,7.1,106,247,0,114,239,353,57,80,216,353,72,20,261,353,28,13,312,353,53,115,185,353
6430493,1742,239735,dpv1,completed,312.0,7.4,150,162,63,13,236,312,61,47,204,312,78,0,234,312,2,60,250,312,0,0,312,312
6430493,1742,239735,dpv2,completed,347.0,7.5,115,232,40,0,307,347,0,125,222,347,99,26,222,347,42,60,245,347,107,10,230,347
6430493,1742,239735,new-0.0,completed,285.0,6.9,173,112,55,13,217,285,0,19,266,285,35,0,250,285,6,54,225,285,57,1,227,285
6430493,1742,239735,new-0.5,completed,290.0,7.45,173,117,58,21,211,290,51,6,233,290,12,49,229,290,31,1,258,290,0,26,264,290
6430493,1742,239735,new-1.0,completed,297.0,7.35,170,127,59,0,238,297,0,14,283,297,56,0,241,297,31,6,260,297,18,68,211,297
6430493,1742,675528,base,completed,313.0,7.05,153,160,37,0,276,313,66,61,186,313,30,94,189,313,7,0,306,313,0,58,255,313
6430493,1742,675528,base+,completed,298.0,6.7,170,128,40,13,245,298,6,20,272,298,47,81,170,298,33,3,262,298,0,0,298,298
6430493,1742,675528,dpv1,completed,339.0,7.35,136,203,56,48,235,339,0,19,320,339,76,50,213,339,41,0,298,339,83,78,178,339
6430493,1742,675528,dpv2,completed,331.0,7.5,146,185,47,29,255,331,40,48,243,331,25,67,239,331,49,76,206,331,0,40,291,331
6430493,1742,675528,new-0.0,completed,299.0,6.9,176,123,0,25,274,299,68,0,231,299,29,0,270,299,12,55,232,299,67,6,226,299
6430493,1742,675528,new-0.5,completed,338.0,7.45,170,168,0,40,298,338,92,18,228,338,26,67,245,338,49,0,289,338,91,9,238,338
6430493,1742,675528,new-1.0,completed,322.0,7.55,155,167,30,66,226,322,44,0,278,322,0,46,276,322,71,0,251,322,85,16,221,322
6430493,1742,380692,base,completed,328.0,7.05,131,197,67,64,197,328,61,0,267,328,0,68,260,328,71,92,165,328,24,0,304,328
6430493,1742,380692,base+,completed,340.0,7.1,126,214,7,112,221,340,30,17,293,340,60,71,209,340,0,61,279,340,70,79,191,340
6430493,1742,380692,dpv1,completed,359.0,7.45,133,226,64,53,242,359,54,0,305,359,0,32,327,359,95,46,218,359,97,101,161,359
6430493,1742,380692,dpv2,completed,343.0,7.6,106,237,61,39,243,343,31,36,276,343,55,75,213,343,43,82,218,343,0,60,283,343
6430493,1742,380692,new-0.0,completed,304.0,6.85,175,129,78,0,226,304,74,12,218,304,40,0,264,304,18,51,235,304,0,31,273,304
6430493,1742,380692,new-0.5,completed,312.0,7.35,157,155,34,23,255,312,74,0,238,312,0,9,303,312,83,23,206,312,21,52,239,312
6430493,1742,380692,new-1.0,completed,331.0,7.45,135,196,71,0,260,331,47,0,284,331,98,34,199,331,36,66,229,331,0,45,286,331
1105824,1699,310811,base,completed,288.0,7.05,178,110,34,24,230,288,9,0,279,288,62,24,202,288,0,0,288,288,68,0,220,288
1105824,1699,310811,base+,completed,286.0,7.15,207,79,66,3,217,286,42,1,243,286,0,0,286,286,12,0,274,286,75,0,211,286
1105824,1699,310811,dpv1,completed,276.0,7.55,203,73,17,13,246,276,38,12,226,276,59,0,217,276,15,0,261,276,0,0,276,276
1105824,1699,310811,dpv2,completed,280.0,7.6,215,65,52,0,228,280,58,0,222,280,37,7,236,280,0,0,280,280,25,0,255,280
1105824,1699,310811,new-0.0,completed,273.0,7.35,195,78,52,0,221,273,34,0,239,273,78,0,195,273,35,0,238,273,0,0,273,273
1105824,1699,310811,new-0.5,completed,279.0,7.75,213,66,65,0,214,279,66,0,213,279,0,0,279,279,26,0,253,279,19,0,260,279
1105824,1699,310811,new-1.0,completed,276.0,7.7,194,82,50,0,226,276,10,0,266,276,0,0,276,276,39,0,237,276,12,32,232,276
1105824,1699,208428,base,completed,282.0,7.2,216,66,58,0,224,282,8,10,264,282,16,20,246,282,33,0,249,282,0,0,282,282
1105824,1699,208428,base+,completed,270.0,7.2,213,57,0,18,252,270,57,0,213,270,26,0,244,270,16,0,254,270,3,9,258,270
1105824,1699,208428,dpv1,completed,276.0,7.5,182,94,32,18,226,276,0,0,276,276,9,24,243,276,12,6,258,276,54,10,212,276
1105824,1699,208428,dpv2,completed,271.0,7.65,205,66,47,0,224,271,66,0,205,271,23,0,248,271,0,0,271,271,6,0,265,271
1105824,1699,208428,new-0.0,completed,278.0,7.35,211,67,31,0,247,278,50,0,228,278,65,0,213,278,18,17,243,278,0,0,278,278
1105824,1699,208428,new-0.5,completed,271.0,7.75,197,74,23,0,248,271,0,0,271,271,23,0,248,271,74,0,197,271,9,0,262,271
1105824,1699,208428,new-1.0,completed,280.0,7.65,198,82,0,0,280,280,36,0,244,280,8,0,272,280,39,0,241,280,22,43,215,280
1105824,1699,460300,base,completed,310.0,7.1,154,156,0,84,226,310,52,0,258,310,2,123,185,310,43,0,267,310,23,11,276,310
1105824,1699,460300,base+,completed,274.0,7.1,219,55,8,0,266,274,13,14,247,274,35,0,239,274,41,0,233,274,0,4,270,274
1105824,1699,460300,dpv1,completed,268.0,7.35,201,67,0,0,268,268,2,6,260,268,54,0,214,268,27,13,228,268,0,6,262,268
1105824,1699,460300,dpv2,completed,282.0,7.6,211,71,0,0,282,282,57,0,225,282,48,0,234,282,71,0,211,282,18,0,264,282
1105824,1699,460300,new-0.0,completed,275.0,7.35,209,66,32,0,243,275,41,0,234,275,65,0,210,275,8,25,242,275,0,0,275,275
1105824,1699,460300,new-0.5,completed,267.0,7.65,207,60,51,0,216,267,8,0,259,267,40,0,227,267,13,12,242,267,0,0,267,267
1105824,1699,460300,new-1.0,completed,279.0,7.65,186,93,52,0,227,279,33,4,242,279,11,0,268,279,0,0,279,279,10,37,232,279
1105824,1699,309704,base,completed,294.0,7.1,144,150,24,0,270,294,4,74,216,294,1,0,293,294,66,38,190,294,0,15,279,294
1105824,1699,309704,base+,completed,283.0,7.1,151,132,64,5,214,283,35,68,180,283,8,0,275,283,7,0,276,283,0,0,283,283
1105824,1699,309704,dpv1,completed,281.0,7.6,179,102,0,0,281,281,49,14,218,281,28,23,230,281,70,6,205,281,1,0,280,281
1105824,1699,309704,dpv2,completed,282.0,7.6,212,70,46,5,231,282,65,0,217,282,0,0,282,282,7,0,275,282,61,0,221,282
1105824,1699,309704,new-0.0,completed,263.0,7.3,185,78,22,0,241,263,32,0,231,263,0,0,263,263,78,0,185,263,24,0,239,263
1105824,1699,309704,new-0.5,completed,270.0,7.65,209,61,61,0,209,270,0,0,270,270,0,0,270,270,13,5,252,270,36,0,234,270
1105824,1699,309704,new-1.0,completed,286.0,7.7,175,111,65,0,221,286,44,0,242,286,25,46,215,286,23,0,263,286,0,0,286,286
1105824,1699,247588,base,completed,283.0,6.9,157,126,62,0,221,283,8,6,269,283,7,0,276,283,0,0,283,283,31,64,188,283
1105824,1699,247588,base+,completed,285.0,7.2,211,74,65,0,220,285,74,0,211,285,36,0,249,285,0,0,285,285,35,0,250,285
1105824,1699,247588,dpv1,completed,287.0,7.35,176,111,38,18,231,287,15,10,262,287,0,0,287,287,61,32,194,287,21,11,255,287
1105824,1699,247588,dpv2,completed,287.0,7.65,217,70,34,0,253,287,62,0,225,287,70,0,217,287,0,0,287,287,53,0,234,287
1105824,1699,247588,new-0.0,completed,267.0,7.35,194,73,33,0,234,267,38,0,229,267,9,23,235,267,73,0,194,267,0,0,267,267
1105824,1699,247588,new-0.5,completed,268.0,7.75,203,65,65,0,203,268,46,0,222,268,30,4,234,268,6,0,262,268,0,0,268,268
1105824,1699,247588,new-1.0,completed,273.0,7.65,199,74,43,0,230,273,34,0,239,273,12,0,261,273,0,0,273,273,19,31,223,273
1105824,1699,203195,base,completed,277.0,7.15,206,71,0,0,277,277,58,0,219,277,13,0,264,277,30,0,247,277,14,29,234,277
1105824,1699,203195,base+,completed,274.0,7.1,208,66,41,0,233,274,66,0,208,274,0,0,274,274,6,0,268,274,6,0,268,274
1105824,1699,203195,dpv1,completed,282.0,7.65,201,81,0,0,282,282,72,0,210,282,45,9,228,282,25,12,245,282,9,0,273,282
1105824,1699,203195,dpv2,completed,283.0,7.5,222,61,36,0,247,283,61,0,222,283,50,0,233,283,0,0,283,283,45,0,238,283
1105824,1699,203195,new-0.0,completed,268.0,7.3,197,71,48,0,220,268,31,0,237,268,71,0,197,268,0,0,268,268,23,0,245,268
1105824,1699,203195,new-0.5,completed,270.0,7.75,197,73,0,0,270,270,57,0,213,270,33,0,237,270,73,0,197,270,4,0,266,270
1105824,1699,203195,new-1.0,completed,277.0,7.7,187,90,49,0,228,277,33,0,244,277,13,41,223,277,0,0,277,277,16,0,261,277
1105824,1699,178029,base,completed,278.0,7.2,208,70,51,0,227,278,26,9,243,278,40,10,228,278,0,0,278,278,41,0,237,278
1105824,1699,178029,base+,completed,264.0,7.1,211,53,53,0,211,264,2,0,262,264,44,0,220,264,9,0,255,264,0,0,264,264
1105824,1699,178029,dpv1,completed,298.0,7.65,192,106,57,4,237,298,81,17,200,298,40,16,242,298,22,0,276,298,0,0,298,298
1105824,1699,178029,dpv2,completed,282.0,7.6,211,71,71,0,211,282,62,0,220,282,0,0,282,282,39,0,243,282,6,0,276,282
1105824,1699,178029,new-0.0,completed,271.0,7.35,207,64,35,0,236,271,48,0,223,271,64,0,207,271,16,9,246,271,0,0,271,271
1105824,1699,178029,new-0.5,completed,277.0,7.65,203,74,74,0,203,277,27,10,240,277,12,0,265,277,0,0,277,277,40,0,237,277
1105824,1699,178029,new-1.0,completed,280.0,7.7,194,86,47,0,233,280,31,0,249,280,11,0,269,280,4,0,276,280,0,39,241,280
1105824,1699,239735,base,completed,278.0,7.05,215,63,0,16,262,278,25,0,253,278,63,0,215,278,19,0,259,278,4,24,250,278
1105824,1699,239735,base+,completed,286.0,7.25,142,144,0,69,217,286,2,0,284,286,4,27,255,286,53,50,183,286,25,0,261,286
1105824,1699,239735,dpv1,completed,265.0,7.6,188,77,0,0,265,265,53,0,212,265,31,22,212,265,10,0,255,265,11,10,244,265
1105824,1699,239735,dpv2,completed,277.0,7.65,206,71,63,0,214,277,29,0,248,277,62,0,215,277,0,8,269,277,15,0,262,277
1105824,1699,239735,new-0.0,completed,270.0,7.15,199,71,58,8,204,270,15,0,255,270,0,0,270,270,20,0,250,270,63,0,207,270
1105824,1699,239735,new-0.5,completed,261.0,7.65,190,71,71,0,190,261,1,0,260,261,26,3,232,261,44,0,217,261,0,0,261,261
1105824,1699,239735,new-1.0,completed,271.0,7.7,183,88,49,0,222,271,28,0,243,271,19,39,213,271,9,0,262,271,0,0,271,271
1105824,1699,675528,base,completed,289.0,7.3,176,113,65,26,198,289,5,45,239,289,0,1,288,289,31,0,258,289,28,0,261,289
1105824,1699,675528,base+,completed,270.0,6.9,219,51,7,0,263,270,51,0,219,270,0,0,270,270,48,0,222,270,8,0,262,270
1105824,1699,675528,dpv1,completed,281.0,7.65,201,80,37,11,233,281,62,0,219,281,10,0,271,281,16,18,247,281,0,0,281,281
1105824,1699,675528,dpv2,completed,282.0,7.55,220,62,52,0,230,282,62,0,220,282,58,0,224,282,0,0,282,282,19,0,263,282
1105824,1699,675528,new-0.0,completed,262.0,7.35,208,54,31,0,231,262,36,0,226,262,45,0,217,262,0,18,244,262,0,0,262,262
1105824,1699,675528,new-0.5,completed,273.0,7.7,198,75,75,0,198,273,51,0,222,273,25,4,244,273,9,0,264,273,0,0,273,273
1105824,1699,675528,new-1.0,completed,267.0,7.6,224,43,11,0,256,267,14,0,253,267,24,3,240,267,32,8,227,267,0,0,267,267
1105824,1699,380692,base,completed,278.0,7.15,194,84,11,0,267,278,48,0,230,278,0,0,278,278,28,24,226,278,78,0,200,278
1105824,1699,380692,base+,completed,275.0,7.0,196,79,1,0,274,275,60,0,215,275,14,6,255,275,31,9,235,275,0,45,230,275
1105824,1699,380692,dpv1,completed,275.0,7.4,200,75,9,0,266,275,0,0,275,275,35,11,229,275,58,3,214,275,16,15,244,275
1105824,1699,380692,dpv2,completed,274.0,7.6,221,53,47,0,227,274,53,0,221,274,32,0,242,274,0,0,274,274,24,0,250,274
1105824,1699,380692,new-0.0,completed,271.0,7.35,207,64,33,0,238,271,50,0,221,271,37,0,234,271,64,0,207,271,0,0,271,271
1105824,1699,380692,new-0.5,completed,280.0,7.6,202,78,78,0,202,280,13,0,267,280,0,0,280,280,31,0,249,280,59,0,221,280
1105824,1699,380692,new-1.0,completed,280.0,7.7,169,111,71,0,209,280,24,0,256,280,17,0,263,280,0,0,280,280,19,40,221,280
3778018,1542,310811,base,completed,242.0,7.1,198,44,22,0,220,242,23,0,219,242,33,0,209,242,44,0,198,242,0,0,242,242
3778018,1542,310811,base+,completed,248.0,6.85,202,46,26,8,214,248,38,0,210,248,0,0,248,248,25,0,223,248,30,0,218,248
3778018,1542,310811,dpv1,completed,256.0,7.25,190,66,0,0,256,256,66,0,190,256,19,0,237,256,48,0,208,256,60,0,196,256
3778018,1542,310811,dpv2,completed,243.0,7.45,186,57,0,0,243,243,8,0,235,243,57,0,186,243,28,0,215,243,22,0,221,243
3778018,1542,310811,new-0.0,completed,217.0,7.4,189,28,5,0,212,217,0,0,217,217,8,0,209,217,24,0,193,217,15,4,198,217
3778018,1542,310811,new-0.5,completed,266.0,7.7,194,72,72,0,194,266,0,0,266,266,71,0,195,266,42,0,224,266,71,0,195,266
3778018,1542,310811,new-1.0,completed,244.0,7.55,191,53,0,0,244,244,26,0,218,244,19,0,225,244,43,0,201,244,53,0,191,244
3778018,1542,208428,base,completed,248.0,6.9,199,49,0,0,248,248,49,0,199,248,47,0,201,248,20,0,228,248,32,0,216,248
3778018,1542,208428,base+,completed,253.0,6.75,208,45,0,0,253,253,45,0,208,253,44,0,209,253,44,0,209,253,13,0,240,253
3778018,1542,208428,dpv1,completed,252.0,7.2,185,67,67,0,185,252,30,0,222,252,40,0,212,252,58,0,194,252,0,0,252,252
3778018,1542,208428,dpv2,completed,230.0,7.55,204,26,8,0,222,230,0,0,230,230,25,0,205,230,25,0,205,230,26,0,204,230
3778018,1542,208428,new-0.0,completed,223.0,7.3,204,19,19,0,204,223,17,0,206,223,0,0,223,223,19,0,204,223,8,0,215,223
3778018,1542,208428,new-0.5,completed,240.0,7.55,200,40,32,0,208,240,40,0,200,240,0,0,240,240,28,0,212,240,32,0,208,240
3778018,1542,208428,new-1.0,completed,237.0,7.65,203,34,11,0,226,237,0,0,237,237,17,0,220,237,34,0,203,237,34,0,203,237
3778018,1542,460300,base,completed,248.0,6.85,208,40,29,0,219,248,22,0,226,248,36,0,212,248,0,0,248,248,40,0,208,248
3778018,1542,460300,base+,completed,265.0,6.9,194,71,0,0,265,265,42,0,223,265,34,0,231,265,18,0,247,265,71,0,194,265
3778018,1542,460300,dpv1,completed,244.0,7.15,193,51,33,0,211,244,35,0,209,244,21,0,223,244,38,13,193,244,0,0,244,244
3778018,1542,460300,dpv2,completed,247.0,7.5,203,44,31,0,216,247,44,0,203,247,0,0,247,247,28,0,219,247,38,0,209,247
3778018,1542,460300,new-0.0,completed,259.0,7.0,196,63,51,0,208,259,61,0,198,259,0,0,259,259,63,0,196,259,57,0,202,259
3778018,1542,460300,new-0.5,completed,231.0,7.55,193,38,7,0,224,231,18,0,213,231,0,0,231,231,38,0,193,231,15,0,216,231
3778018,1542,460300,new-1.0,completed,244.0,7.65,205,39,25,0,219,244,0,0,244,244,26,0,218,244,33,0,211,244,39,0,205,244
3778018,1542,309704,base,completed,253.0,6.85,195,58,0,0,253,253,58,0,195,253,43,0,210,253,19,0,234,253,35,0,218,253
3778018,1542,309704,base+,completed,252.0,7.3,190,62,50,0,202,252,55,7,190,252,28,0,224,252,0,0,252,252,48,0,204,252
3778018,1542,309704,dpv1,completed,258.0,7.4,198,60,47,0,211,258,49,0,209,258,0,0,258,258,60,0,198,258,56,0,202,258
3778018,1542,309704,dpv2,completed,242.0,7.55,191,51,0,0,242,242,4,0,238,242,37,6,199,242,36,0,206,242,45,0,197,242
3778018,1542,309704,new-0.0,completed,223.0,7.15,197,26,6,0,217,223,14,0,209,223,0,0,223,223,23,3,197,223,16,0,207,223
3778018,1542,309704,new-0.5,completed,229.0,7.5,197,32,10,0,219,229,8,0,221,229,32,0,197,229,0,0,229,229,6,0,223,229
3778018,1542,309704,new-1.0,completed,250.0,7.65,194,56,18,0,232,250,0,0,250,250,43,0,207,250,56,0,194,250,53,0,197,250
3778018,1542,247588,base,completed,235.0,6.8,195,40,18,0,217,235,24,0,211,235,0,0,235,235,13,0,222,235,31,9,195,235
3778018,1542,247588,base+,completed,240.0,7.0,183,57,0,0,240,240,4,37,199,240,25,0,215,240,48,0,192,240,21,0,219,240
3778018,1542,247588,dpv1,completed,248.0,7.3,179,69,31,0,217,248,18,0,230,248,53,0,195,248,69,0,179,248,0,0,248,248
3778018,1542,247588,dpv2,completed,231.0,7.55,195,36,8,0,223,231,0,0,231,231,26,9,196,231,27,0,204,231,17,0,214,231
3778018,1542,247588,new-0.0,completed,252.0,7.05,195,57,38,0,214,252,49,0,203,252,0,0,252,252,57,0,195,252,50,0,202,252
3778018,1542,247588,new-0.5,completed,231.0,7.5,195,36,15,0,216,231,19,0,212,231,36,0,195,231,0,0,231,231,2,0,229,231
3778018,1542,247588,new-1.0,completed,237.0,7.65,187,50,50,0,187,237,16,0,221,237,37,0,200,237,0,0,237,237,35,0,202,237
3778018,1542,203195,base,completed,253.0,6.75,194,59,23,0,230,253,59,0,194,253,15,0,238,253,0,0,253,253,47,0,206,253
3778018,1542,203195,base+,completed,247.0,6.8,202,45,27,0,220,247,4,0,243,247,29,0,218,247,45,0,202,247,0,0,247,247
3778018,1542,203195,dpv1,completed,253.0,7.25,193,60,46,0,207,253,24,0,229,253,0,0,253,253,51,0,202,253,60,0,193,253
3778018,1542,203195,dpv2,completed,233.0,7.5,192,41,10,0,223,233,2,0,231,233,32,9,192,233,23,0,210,233,0,0,233,233
3778018,1542,203195,new-0.0,completed,231.0,7.3,194,37,37,0,194,231,19,0,212,231,0,0,231,231,26,0,205,231,13,0,218,231
3778018,1542,203195,new-0.5,completed,225.0,7.55,187,38,1,0,224,225,10,0,215,225,0,0,225,225,38,0,187,225,11,0,214,225
3778018,1542,203195,new-1.0,completed,245.0,7.65,196,49,0,0,245,245,3,0,242,245,35,0,210,245,48,0,197,245,49,0,196,245
3778018,1542,178029,base,completed,254.0,6.9,202,52,0,0,254,254,52,0,202,254,49,0,205,254,39,0,215,254,46,0,208,254
3778018,1542,178029,base+,completed,266.0,6.85,197,69,0,0,266,266,49,0,217,266,59,0,207,266,48,0,218,266,69,0,197,266
3778018,1542,178029,dpv1,completed,259.0,7.25,180,79,0,0,259,259,34,0,225,259,65,0,194,259,41,7,211,259,38,13,208,259
3778018,1542,178029,dpv2,completed,240.0,7.35,200,40,11,0,229,240,0,0,240,240,40,0,200,240,22,0,218,240,23,0,217,240
3778018,1542,178029,new-0.0,completed,218.0,7.2,207,11,1,1,216,218,8,0,210,218,0,0,218,218,10,0,208,218,8,0,210,218
3778018,1542,178029,new-0.5,completed,231.0,7.5,195,36,18,0,213,231,17,0,214,231,0,0,231,231,29,0,202,231,36,0,195,231
3778018,1542,178029,new-1.0,completed,263.0,7.55,200,63,62,0,201,263,0,0,263,263,60,0,203,263,46,0,217,263,63,0,200,263
3778018,1542,239735,base,completed,248.0,6.95,199,49,14,0,234,248,49,0,199,248,37,0,211,248,24,0,224,248,0,0,248,248
3778018,1542,239735,base+,completed,245.0,6.85,198,47,43,0,202,245,10,0,235,245,47,0,198,245,0,0,245,245,37,0,208,245
3778018,1542,239735,dpv1,completed,248.0,7.3,179,69,13,0,235,248,69,0,179,248,53,0,195,248,47,0,201,248,0,0,248,248
3778018,1542,239735,dpv2,completed,232.0,7.45,203,29,0,0,232,232,25,0,207,232,0,0,232,232,26,0,206,232,29,0,203,232
3778018,1542,239735,new-0.0,completed,231.0,7.2,189,42,20,0,211,231,36,0,195,231,42,0,189,231,22,0,209,231,0,0,231,231
3778018,1542,239735,new-0.5,completed,222.0,7.55,190,32,32,0,190,222,21,0,201,222,0,0,222,222,15,0,207,222,15,0,207,222
3778018,1542,239735,new-1.0,completed,239.0,7.65,179,60,13,0,226,239,0,0,239,239,31,0,208,239,39,0,200,239,60,0,179,239
3778018,1542,675528,base,completed,241.0,7.25,197,44,44,0,197,241,35,0,206,241,32,0,209,241,0,0,241,241,19,0,222,241
3778018,1542,675528,base+,completed,240.0,7.15,185,55,37,0,203,240,16,0,224,240,22,0,218,240,0,0,240,240,55,0,185,240
3778018,1542,675528,dpv1,completed,242.0,7.6,187,55,17,0,225,242,0,0,242,242,38,0,204,242,55,0,187,242,27,0,215,242
3778018,1542,675528,dpv2,completed,232.0,7.7,196,36,0,0,232,232,3,0,229,232,36,0,196,232,20,0,212,232,15,0,217,232
3778018,1542,675528,new-0.0,completed,243.0,7.0,193,50,8,0,235,243,35,0,208,243,0,0,243,243,50,0,193,243,42,0,201,243
3778018,1542,675528,new-0.5,completed,224.0,7.55,205,19,14,0,210,224,19,0,205,224,0,0,224,224,11,0,213,224,14,0,210,224
3778018,1542,675528,new-1.0,completed,246.0,7.6,195,51,13,0,233,246,0,0,246,246,28,0,218,246,38,0,208,246,51,0,195,246
3778018,1542,380692,base,completed,254.0,6.75,184,70,0,0,254,254,19,0,235,254,58,0,196,254,50,0,204,254,70,0,184,254
3778018,1542,380692,base+,completed,241.0,6.8,199,42,38,0,203,241,0,0,241,241,24,0,217,241,42,0,199,241,23,0,218,241
3778018,1542,380692,dpv1,completed,246.0,7.25,183,63,41,0,205,246,44,0,202,246,46,17,183,246,25,0,221,246,0,0,246,246
3778018,1542,380692,dpv2,completed,233.0,7.6,192,41,18,0,215,233,4,0,229,233,21,0,212,233,41,0,192,233,0,0,233,233
3778018,1542,380692,new-0.0,completed,229.0,7.25,187,42,11,0,218,229,27,0,202,229,0,0,229,229,42,0,187,229,20,0,209,229
3778018,1542,380692,new-0.5,completed,248.0,7.7,196,52,45,0,203,248,0,0,248,248,52,0,196,248,23,0,225,248,52,0,196,248
3778018,1542,380692,new-1.0,completed,239.0,7.6,187,52,0,0,239,239,16,0,223,239,22,0,217,239,52,0,187,239,42,0,197,239
2662868,1612,310811,base,completed,303.0,6.95,135,168,5,31,267,303,37,93,173,303,17,71,215,303,45,0,258,303,0,70,233,303
2662868,1612,310811,base+,completed,313.0,7.15,139,174,73,85,155,313,16,27,270,313,66,1,246,313,0,0,313,313,83,46,184,313
2662868,1612,310811,dpv1,completed,335.0,7.3,113,222,75,86,174,335,63,147,125,335,53,31,251,335,2,19,314,335,0,40,295,335
2662868,1612,310811,dpv2,completed,341.0,7.4,97,244,30,156,155,341,47,143,151,341,22,31,288,341,0,41,300,341,41,8,292,341
2662868,1612,310811,new-0.0,completed,273.0,7.3,190,83,69,0,204,273,61,3,209,273,0,10,263,273,44,2,227,273,58,1,214,273
2662868,1612,310811,new-0.5,completed,268.0,7.6,190,78,38,0,230,268,47,4,217,268,74,0,194,268,0,0,268,268,26,9,233,268
2662868,1612,310811,new-1.0,completed,264.0,7.45,143,121,45,37,182,264,33,30,201,264,22,0,242,264,21,9,234,264,0,0,264,264
2662868,1612,208428,base,completed,296.0,6.95,162,134,84,0,212,296,6,30,260,296,70,20,206,296,0,4,292,296,75,0,221,296
2662868,1612,208428,base+,completed,291.0,7.05,109,182,26,0,265,291,8,11,272,291,27,100,164,291,0,0,291,291,15,127,149,291
2662868,1612,208428,dpv1,completed,342.0,7.25,115,227,13,33,296,342,58,152,132,342,73,106,163,342,58,31,253,342,0,46,296,342
2662868,1612,208428,dpv2,completed,368.0,7.35,82,286,73,12,283,368,22,207,139,368,19,52,297,368,0,99,269,368,9,192,167,368
2662868,1612,208428,new-0.0,completed,255.0,7.25,204,51,47,0,208,255,34,0,221,255,21,6,228,255,36,0,219,255,0,0,255,255
2662868,1612,208428,new-0.5,completed,252.0,7.5,196,56,56,0,196,252,28,0,224,252,8,11,233,252,25,0,227,252,0,0,252,252
2662868,1612,208428,new-1.0,completed,262.0,7.5,165,97,49,27,186,262,38,21,203,262,0,0,262,262,22,0,240,262,9,0,253,262
2662868,1612,460300,base,completed,359.0,7.0,90,269,80,137,142,359,89,0,270,359,72,41,246,359,40,55,264,359,0,128,231,359
2662868,1612,460300,base+,completed,285.0,7.0,142,143,49,0,236,285,12,0,273,285,63,0,222,285,0,11,274,285,37,86,162,285
2662868,1612,460300,dpv1,completed,334.0,7.15,107,227,16,15,303,334,65,151,118,334,60,17,257,334,76,78,180,334,0,35,299,334
2662868,1612,460300,dpv2,completed,331.0,7.35,91,240,12,42,277,331,46,133,152,331,31,134,166,331,53,39,239,331,0,2,329,331
2662868,1612,460300,new-0.0,completed,258.0,7.1,192,66,0,12,246,258,54,0,204,258,39,0,219,258,28,0,230,258,18,2,238,258
2662868,1612,460300,new-0.5,completed,279.0,7.55,198,81,71,0,208,279,38,0,241,279,0,0,279,279,45,16,218,279,53,3,223,279
2662868,1612,460300,new-1.0,completed,267.0,7.6,156,111,46,33,188,267,21,10,236,267,0,0,267,267,13,0,254,267,36,22,209,267
2662868,1612,309704,base,completed,321.0,7.15,132,189,22,118,181,321,3,49,269,321,6,147,168,321,0,0,321,321,26,61,234,321
2662868,1612,309704,base+,completed,276.0,7.0,128,148,14,42,220,276,47,0,229,276,0,8,268,276,24,73,179,276,14,0,262,276
2662868,1612,309704,dpv1,completed,342.0,7.2,111,231,67,16,259,342,68,149,125,342,82,89,171,342,21,2,319,342,0,54,288,342
2662868,1612,309704,dpv2,completed,346.0,7.35,101,245,21,24,301,346,36,151,159,346,0,51,295,346,11,51,284,346,25,165,156,346
2662868,1612,309704,new-0.0,completed,273.0,7.4,190,83,78,5,190,273,0,0,273,273,67,0,206,273,40,5,228,273,50,0,223,273
2662868,1612,309704,new-0.5,completed,268.0,7.5,199,69,69,0,199,268,55,0,213,268,35,0,233,268,0,0,268,268,38,0,230,268
2662868,1612,309704,new-1.0,completed,259.0,7.5,152,107,0,0,259,259,17,7,235,259,20,27,212,259,39,35,185,259,14,0,245,259
2662868,1612,247588,base,completed,285.0,6.85,122,163,16,57,212,285,43,0,242,285,5,26,254,285,18,83,184,285,0,0,285,285
2662868,1612,247588,base+,completed,337.0,7.2,95,242,68,104,165,337,0,117,220,337,15,21,301,337,71,31,235,337,82,57,198,337
2662868,1612,247588,dpv1,completed,334.0,7.25,113,221,21,15,298,334,61,145,128,334,76,90,168,334,65,29,240,334,0,31,303,334
2662868,1612,247588,dpv2,completed,363.0,7.4,91,272,0,220,143,363,14,206,143,363,59,44,260,363,0,78,285,363,13,17,333,363
2662868,1612,247588,new-0.0,completed,268.0,7.15,193,75,0,6,262,268,36,0,232,268,61,0,207,268,53,8,207,268,22,8,238,268
2662868,1612,247588,new-0.5,completed,271.0,7.5,194,77,41,4,226,271,42,1,228,271,76,0,195,271,52,0,219,271,0,0,271,271
2662868,1612,247588,new-1.0,completed,256.0,7.55,156,100,32,44,180,256,5,1,250,256,16,23,217,256,0,0,256,256,9,0,247,256
2662868,1612,203195,base,completed,309.0,6.95,119,190,58,11,240,309,43,87,179,309,52,0,257,309,0,0,309,309,53,72,184,309
2662868,1612,203195,base+,completed,290.0,7.3,139,151,32,71,187,290,34,6,250,290,8,0,282,290,22,87,181,290,0,0,290,290
2662868,1612,203195,dpv1,completed,330.0,7.2,106,224,0,3,327,330,78,29,223,330,11,46,273,330,76,118,136,330,87,62,181,330
2662868,1612,203195,dpv2,completed,365.0,7.35,88,277,67,24,274,365,15,204,146,365,12,36,317,365,0,98,267,365,3,206,156,365
2662868,1612,203195,new-0.0,completed,275.0,7.25,192,83,0,0,275,275,56,9,210,275,74,0,201,275,61,0,214,275,42,0,233,275
2662868,1612,203195,new-0.5,completed,264.0,7.5,198,66,25,15,224,264,39,0,225,264,0,0,264,264,66,0,198,264,23,0,241,264
2662868,1612,203195,new-1.0,completed,264.0,7.4,197,67,23,15,226,264,0,0,264,264,39,0,225,264,21,0,243,264,67,0,197,264
2662868,1612,178029,base,completed,301.0,6.9,95,206,28,33,240,301,8,34,259,301,6,55,240,301,0,92,209,301,44,59,198,301
2662868,1612,178029,base+,completed,358.0,6.85,101,257,5,78,275,358,59,51,248,358,0,50,308,358,75,135,148,358,65,97,196,358
2662868,1612,178029,dpv1,completed,360.0,7.3,116,244,83,103,174,360,72,161,127,360,69,40,251,360,0,31,329,360,14,56,290,360
2662868,1612,178029,dpv2,completed,364.0,7.4,83,281,18,46,300,364,22,196,146,364,8,195,161,364,0,98,266,364,73,1,290,364
2662868,1612,178029,new-0.0,completed,269.0,7.2,191,78,0,6,263,269,46,4,219,269,68,0,201,269,41,0,228,269,33,20,216,269
2662868,1612,178029,new-0.5,completed,274.0,7.55,192,82,78,4,192,274,0,0,274,274,40,0,234,274,39,10,225,274,49,0,225,274
2662868,1612,178029,new-1.0,completed,264.0,7.5,201,63,63,0,201,264,0,0,264,264,33,0,231,264,29,0,235,264,20,20,224,264
2662868,1612,239735,base,completed,281.0,7.3,133,148,56,77,148,281,36,0,245,281,71,2,208,281,16,0,265,281,0,0,281,281
2662868,1612,239735,base+,completed,277.0,7.1,131,146,25,0,252,277,38,91,148,277,51,56,170,277,9,0,268,277,0,6,271,277
2662868,1612,239735,dpv1,completed,326.0,7.3,109,217,66,85,175,326,56,151,119,326,55,20,251,326,1,10,315,326,0,54,272,326
2662868,1612,239735,dpv2,completed,337.0,7.35,86,251,65,0,272,337,15,181,141,337,10,35,292,337,2,56,279,337,0,184,153,337
2662868,1612,239735,new-0.0,completed,268.0,7.45,187,81,64,0,204,268,54,4,210,268,75,0,193,268,50,5,213,268,0,2,266,268
2662868,1612,239735,new-0.5,completed,262.0,7.5,194,68,63,0,199,262,39,2,221,262,38,0,224,262,0,0,262,262,48,5,209,262
2662868,1612,239735,new-1.0,completed,258.0,7.55,155,103,36,29,193,258,0,6,252,258,20,26,212,258,18,2,238,258,35,4,219,258
2662868,1612,675528,base,completed,268.0,7.05,176,92,73,0,195,268,24,12,232,268,53,18,197,268,33,1,234,268,0,0,268,268
2662868,1612,675528,base+,completed,275.0,7.2,112,163,0,0,275,275,60,0,215,275,48,0,227,275,37,108,130,275,21,0,254,275
2662868,1612,675528,dpv1,completed,360.0,7.3,111,249,0,100,260,360,73,164,123,360,62,46,252,360,5,24,331,360,77,56,227,360
2662868,1612,675528,dpv2,completed,363.0,7.35,81,282,64,11,288,363,15,213,135,363,11,52,300,363,0,82,281,363,0,202,161,363
2662868,1612,675528,new-0.0,completed,277.0,7.15,187,90,34,0,243,277,24,17,236,277,0,13,264,277,62,0,215,277,77,0,200,277
2662868,1612,675528,new-0.5,completed,267.0,7.4,192,75,0,0,267,267,38,0,229,267,24,9,234,267,38,0,229,267,75,0,192,267
2662868,1612,675528,new-1.0,completed,261.0,7.4,176,85,22,22,217,261,44,0,217,261,5,0,256,261,35,19,207,261,0,0,261,261
2662868,1612,380692,base,completed,261.0,7.05,177,84,57,0,204,261,0,0,261,261,12,17,232,261,20,35,206,261,23,17,221,261
2662868,1612,380692,base+,completed,298.0,6.9,125,173,33,0,265,298,0,0,298,298,42,74,182,298,28,131,139,298,12,2,284,298
2662868,1612,380692,dpv1,completed,348.0,7.25,103,245,18,20,310,348,80,156,112,348,0,107,241,348,56,32,260,348,84,39,225,348
2662868,1612,380692,dpv2,completed,328.0,7.35,88,240,24,0,304,328,35,151,142,328,9,25,294,328,0,58,270,328,23,155,150,328
2662868,1612,380692,new-0.0,completed,254.0,7.45,190,64,64,0,190,254,34,0,220,254,12,18,224,254,0,0,254,254,24,0,230,254
2662868,1612,380692,new-0.5,completed,254.0,7.6,198,56,56,0,198,254,22,0,232,254,14,16,224,254,0,0,254,254,26,0,228,254
2662868,1612,380692,new-1.0,completed,255.0,7.5,163,92,37,25,193,255,24,22,209,255,7,0,248,255,0,0,255,255,4,8,243,255
9157033,1834,310811,base,completed,330.0,6.85,129,201,66,0,264,330,37,0,293,330,0,164,166,330,65,0,265,330,2,11,317,330
9157033,1834,310811,base+,completed,307.0,6.75,242,65,27,0,280,307,65,0,242,307,0,0,307,307,65,0,242,307,58,0,249,307
9157033,1834,310811,dpv1,completed,395.0,7.05,138,257,0,49,346,395,96,0,299,395,12,207,176,395,95,23,277,395,50,131,214,395
9157033,1834,310811,dpv2,completed,336.0,7.35,150,186,78,46,212,336,34,108,194,336,0,0,336,336,25,0,311,336,88,0,248,336
9157033,1834,310811,new-0.0,completed,271.0,6.85,246,25,17,0,254,271,0,0,271,271,9,0,262,271,25,0,246,271,9,0,262,271
9157033,1834,310811,new-0.5,completed,291.0,7.4,229,62,9,0,282,291,48,0,243,291,0,0,291,291,62,0,229,291,52,0,239,291
9157033,1834,310811,new-1.0,completed,314.0,7.45,192,122,17,18,279,314,10,32,272,314,0,51,263,314,40,0,274,314,44,53,217,314
9157033,1834,208428,base,completed,329.0,6.9,159,170,16,54,259,329,45,0,284,329,0,6,323,329,12,84,233,329,56,59,214,329
9157033,1834,208428,base+,completed,325.0,7.05,223,102,67,0,258,325,24,35,266,325,81,0,244,325,0,0,325,325,84,0,241,325
9157033,1834,208428,dpv1,completed,328.0,7.25,207,121,86,0,242,328,46,0,282,328,0,40,288,328,79,0,249,328,14,40,274,328
9157033,1834,208428,dpv2,completed,314.0,7.35,173,141,53,53,208,314,17,27,270,314,38,0,276,314,0,11,303,314,65,0,249,314
9157033,1834,208428,new-0.0,completed,280.0,6.95,231,49,0,0,280,280,9,0,271,280,5,0,275,280,49,0,231,280,43,0,237,280
9157033,1834,208428,new-0.5,completed,282.0,7.3,230,52,0,0,282,282,4,0,278,282,52,0,230,282,10,0,272,282,35,0,247,282
9157033,1834,208428,new-1.0,completed,315.0,7.35,200,115,19,1,295,315,46,33,236,315,0,0,315,315,36,16,263,315,49,49,217,315
9157033,1834,460300,base,completed,336.0,6.85,129,207,60,0,276,336,0,144,192,336,13,13,310,336,38,39,259,336,50,0,286,336
9157033,1834,460300,base+,completed,294.0,6.9,239,55,0,0,294,294,4,0,290,294,52,0,242,294,55,0,239,294,18,0,276,294
9157033,1834,460300,dpv1,completed,347.0,7.1,182,165,86,0,261,347,93,0,254,347,0,64,283,347,58,0,289,347,22,57,268,347
9157033,1834,460300,dpv2,completed,324.0,7.35,174,150,45,53,226,324,8,52,264,324,66,0,258,324,0,14,310,324,57,0,267,324
9157033,1834,460300,new-0.0,completed,269.0,6.85,247,22,2,0,267,269,0,4,265,269,18,0,251,269,18,0,251,269,8,0,261,269
9157033,1834,460300,new-0.5,completed,282.0,7.4,238,44,37,7,238,282,18,0,264,282,0,0,282,282,23,0,259,282,16,0,266,282
9157033,1834,460300,new-1.0,completed,324.0,7.5,215,109,42,56,226,324,13,40,271,324,32,0,292,324,33,0,291,324,0,52,272,324
9157033,1834,309704,base,completed,305.0,6.9,186,119,67,0,238,305,0,0,305,305,32,52,221,305,31,0,274,305,66,0,239,305
9157033,1834,309704,base+,completed,297.0,6.8,243,54,0,0,297,297,48,0,249,297,46,0,251,297,54,0,243,297,37,0,260,297
9157033,1834,309704,dpv1,completed,404.0,7.0,138,266,93,0,311,404,2,68,334,404,39,145,220,404,0,227,177,404,91,18,295,404
9157033,1834,309704,dpv2,completed,317.0,7.35,169,148,44,61,212,317,8,43,266,317,44,0,273,317,0,12,305,317,72,0,245,317
9157033,1834,309704,new-0.0,completed,277.0,7.05,232,45,28,0,249,277,6,0,271,277,0,0,277,277,40,5,232,277,35,0,242,277
9157033,1834,309704,new-0.5,completed,283.0,7.35,212,71,0,0,283,283,71,0,212,283,1,0,282,283,30,0,253,283,31,0,252,283
9157033,1834,309704,new-1.0,completed,302.0,7.3,205,97,23,66,213,302,10,46,246,302,21,0,281,302,0,0,302,302,11,0,291,302
9157033,1834,247588,base,completed,338.0,6.6,167,171,45,0,293,338,62,0,276,338,8,115,215,338,0,98,240,338,34,0,304,338
9157033,1834,247588,base+,completed,344.0,6.8,190,154,99,47,198,344,9,77,258,344,47,0,297,344,0,40,304,344,101,0,243,344
9157033,1834,247588,dpv1,completed,332.0,7.05,148,184,76,0,256,332,42,0,290,332,51,58,223,332,0,0,332,332,16,142,174,332
9157033,1834,247588,dpv2,completed,321.0,7.2,150,171,53,0,268,321,21,118,182,321,66,0,255,321,0,0,321,321,65,0,256,321
9157033,1834,247588,new-0.0,completed,284.0,7.05,220,64,14,0,270,284,44,0,240,284,0,0,284,284,39,0,245,284,64,0,220,284
9157033,1834,247588,new-0.5,completed,285.0,7.4,224,61,11,0,274,285,43,0,242,285,0,0,285,285,61,0,224,285,52,0,233,285
9157033,1834,247588,new-1.0,completed,316.0,7.45,196,120,26,16,274,316,0,55,261,316,25,0,291,316,38,0,278,316,40,55,221,316
9157033,1834,203195,base,completed,311.0,6.75,234,77,0,0,311,311,45,0,266,311,33,0,278,311,77,0,234,311,70,0,241,311
9157033,1834,203195,base+,completed,316.0,6.95,193,123,0,0,316,316,18,31,267,316,49,0,267,316,60,11,245,316,57,25,234,316
9157033,1834,203195,dpv1,completed,348.0,6.95,136,212,33,139,176,348,0,0,348,348,64,0,284,348,72,0,276,348,73,67,208,348
9157033,1834,203195,dpv2,completed,332.0,7.3,159,173,0,36,296,332,49,89,194,332,75,0,257,332,84,0,248,332,21,0,311,332
9157033,1834,203195,new-0.0,completed,288.0,6.85,232,56,13,0,275,288,56,0,232,288,36,0,252,288,35,0,253,288,0,0,288,288
9157033,1834,203195,new-0.5,completed,295.0,7.25,209,86,9,0,286,295,86,0,209,295,38,0,257,295,35,0,260,295,0,0,295,295
9157033,1834,203195,new-1.0,completed,318.0,7.45,195,123,15,14,289,318,0,58,260,318,15,0,303,318,39,5,274,318,44,53,221,318
9157033,1834,178029,base,completed,320.0,7.1,163,157,52,0,268,320,0,76,244,320,37,53,230,320,59,0,261,320,0,14,306,320
9157033,1834,178029,base+,completed,303.0,6.7,146,157,0,0,303,303,40,0,263,303,46,62,195,303,6,36,261,303,5,25,273,303
9157033,1834,178029,dpv1,completed,331.0,7.25,202,129,70,0,261,331,41,0,290,331,4,85,242,331,91,0,240,331,0,8,323,331
9157033,1834,178029,dpv2,completed,323.0,7.35,165,158,53,65,205,323,13,40,270,323,53,0,270,323,0,10,313,323,64,0,259,323
9157033,1834,178029,new-0.0,completed,285.0,6.95,234,51,0,0,285,285,32,0,253,285,13,0,272,285,45,0,240,285,51,0,234,285
9157033,1834,178029,new-0.5,completed,293.0,7.35,221,72,6,0,287,293,32,0,261,293,72,0,221,293,34,0,259,293,0,0,293,293
9157033,1834,178029,new-1.0,completed,344.0,7.4,194,150,57,24,263,344,79,50,215,344,51,0,293,344,81,4,259,344,0,40,304,344
9157033,1834,239735,base,completed,292.0,6.65,237,55,31,0,261,292,55,0,237,292,0,0,292,292,20,0,272,292,44,0,248,292
9157033,1834,239735,base+,completed,297.0,6.8,189,108,46,36,215,297,0,7,290,297,35,0,262,297,57,0,240,297,12,19,266,297
9157033,1834,239735,dpv1,completed,354.0,6.95,136,218,0,13,341,354,45,0,309,354,43,106,205,354,6,175,173,354,83,0,271,354
9157033,1834,239735,dpv2,completed,322.0,7.4,146,176,0,44,278,322,34,110,178,322,66,0,256,322,65,0,257,322,17,0,305,322
9157033,1834,239735,new-0.0,completed,263.0,6.95,233,30,6,0,257,263,0,0,263,263,4,0,259,263,30,0,233,263,30,0,233,263
9157033,1834,239735,new-0.5,completed,263.0,7.35,216,47,0,0,263,263,47,0,216,263,0,0,263,263,5,0,258,263,23,0,240,263
9157033,1834,239735,new-1.0,completed,327.0,7.4,191,136,57,21,249,327,62,51,214,327,36,0,291,327,70,9,248,327,0,27,300,327
9157033,1834,675528,base,completed,341.0,6.8,206,135,14,56,271,341,92,21,228,341,101,0,240,341,48,0,293,341,0,39,302,341
9157033,1834,675528,base+,completed,318.0,6.9,187,131,25,13,280,318,39,0,279,318,0,13,305,318,72,0,246,318,60,45,213,318
9157033,1834,675528,dpv1,completed,370.0,7.0,138,232,95,0,275,370,0,17,353,370,45,109,216,370,0,187,183,370,56,0,314,370
9157033,1834,675528,dpv2,completed,343.0,7.25,144,199,48,0,295,343,0,66,277,343,10,151,182,343,59,0,284,343,57,0,286,343
9157033,1834,675528,new-0.0,completed,280.0,6.85,253,27,24,0,256,280,21,0,259,280,21,0,259,280,27,0,253,280,0,0,280,280
9157033,1834,675528,new-0.5,completed,293.0,7.25,224,69,18,0,275,293,67,0,226,293,29,0,264,293,35,2,256,293,0,0,293,293
9157033,1834,675528,new-1.0,completed,332.0,7.45,198,134,11,51,270,332,66,28,238,332,0,0,332,332,45,0,287,332,42,68,222,332
9157033,1834,380692,base,completed,319.0,7.15,162,157,0,5,314,319,10,113,196,319,75,0,244,319,44,0,275,319,52,0,267,319
9157033,1834,380692,base+,completed,328.0,6.95,159,169,69,0,259,328,52,0,276,328,0,17,311,328,13,117,198,328,67,0,261,328
9157033,1834,380692,dpv1,completed,312.0,7.1,203,109,54,0,258,312,70,0,242,312,8,68,236,312,41,0,271,312,0,1,311,312
9157033,1834,380692,dpv2,completed,334.0,7.25,142,192,0,0,334,334,78,0,256,334,46,114,174,334,65,0,269,334,16,51,267,334
9157033,1834,380692,new-0.0,completed,267.0,7.0,231,36,0,0,267,267,5,5,257,267,0,0,267,267,31,0,236,267,31,0,236,267
9157033,1834,380692,new-0.5,completed,283.0,7.25,206,77,5,0,278,283,77,0,206,283,29,0,254,283,22,0,261,283,0,0,283,283
9157033,1834,380692,new-1.0,completed,317.0,7.35,218,99,39,52,226,317,0,54,263,317,13,0,304,317,45,0,272,317,36,0,281,317
7844794,1732,310811,base,completed,387.0,7.4,71,316,71,0,316,387,15,4,368,387,25,68,294,387,0,237,150,387,24,239,124,387
7844794,1732,310811,base+,completed,315.0,7.2,89,226,0,69,246,315,26,77,212,315,35,33,247,315,47,25,243,315,36,0,279,315
7844794,1732,310811,dpv1,completed,385.0,7.25,84,301,50,66,269,385,60,158,167,385,72,0,313,385,0,87,298,385,73,96,216,385
7844794,1732,310811,dpv2,completed,314.0,7.5,138,176,22,17,275,314,62,49,203,314,68,0,246,314,31,26,257,314,0,61,253,314
7844794,1732,310811,new-0.0,completed,288.0,7.35,174,114,42,44,202,288,0,2,286,288,10,5,273,288,58,15,215,288,52,0,236,288
7844794,1732,310811,new-0.5,completed,289.0,7.7,169,120,56,12,221,289,11,7,271,289,46,30,213,289,0,18,271,289,51,9,229,289
7844794,1732,310811,new-1.0,completed,302.0,7.7,142,160,32,9,261,302,43,11,248,302,0,27,275,302,33,16,253,302,76,32,194,302
7844794,1732,208428,base,completed,338.0,7.0,92,246,71,0,267,338,34,0,304,338,28,0,310,338,71,77,190,338,0,131,207,338
7844794,1732,208428,base+,completed,309.0,7.25,142,167,62,24,223,309,56,75,178,309,0,29,280,309,25,11,273,309,12,13,284,309
7844794,1732,208428,dpv1,completed,368.0,7.55,66,302,0,0,368,368,49,170,149,368,71,53,244,368,27,80,261,368,68,87,213,368
7844794,1732,208428,dpv2,completed,299.0,7.75,174,125,54,21,224,299,25,0,274,299,63,0,236,299,38,19,242,299,0,47,252,299
7844794,1732,208428,new-0.0,completed,292.0,7.3,143,149,57,1,234,292,0,15,277,292,1,13,278,292,58,10,224,292,34,62,196,292
7844794,1732,208428,new-0.5,completed,308.0,7.35,156,152,60,23,225,308,31,6,271,308,76,0,232,308,0,37,271,308,77,9,222,308
7844794,1732,208428,new-1.0,completed,293.0,7.8,140,153,42,0,251,293,27,37,229,293,0,20,273,293,41,65,187,293,6,0,287,293
7844794,1732,460300,base,completed,489.0,7.1,68,421,49,145,295,489,57,235,197,489,37,44,408,489,0,285,204,489,61,260,168,489
7844794,1732,460300,base+,completed,320.0,7.05,138,182,59,47,214,320,0,77,243,320,55,0,265,320,20,5,295,320,36,35,249,320
7844794,1732,460300,dpv1,completed,358.0,7.75,75,283,0,69,289,358,58,143,157,358,52,14,292,358,67,0,291,358,66,66,226,358
7844794,1732,460300,dpv2,completed,290.0,7.75,176,114,39,0,251,290,19,6,265,290,37,36,217,290,43,6,241,290,0,29,261,290
7844794,1732,460300,new-0.0,completed,284.0,7.35,170,114,36,36,212,284,0,7,277,284,61,8,215,284,8,2,274,284,53,0,231,284
7844794,1732,460300,new-0.5,completed,310.0,7.6,185,125,71,9,230,310,59,22,229,310,0,8,302,310,75,0,235,310,16,11,283,310
7844794,1732,460300,new-1.0,completed,313.0,7.75,160,153,0,0,313,313,34,44,235,313,63,25,225,313,46,15,252,313,71,8,234,313
7844794,1732,309704,base,completed,397.0,7.05,97,300,26,255,116,397,48,149,200,397,44,50,303,397,16,126,255,397,0,43,354,397
7844794,1732,309704,base+,completed,300.0,7.2,151,149,51,71,178,300,0,2,298,300,55,0,245,300,39,18,243,300,6,16,278,300
7844794,1732,309704,dpv1,completed,319.0,7.4,106,213,61,43,215,319,40,30,249,319,60,7,252,319,29,0,290,319,0,79,240,319
7844794,1732,309704,dpv2,completed,305.0,7.7,170,135,63,0,242,305,13,0,292,305,40,0,265,305,57,44,204,305,0,45,260,305
7844794,1732,309704,new-0.0,completed,306.0,7.3,169,137,70,0,236,306,72,5,229,306,26,0,280,306,0,0,306,306,41,62,203,306
7844794,1732,309704,new-0.5,completed,278.0,7.55,195,83,51,2,225,278,29,22,227,278,49,0,229,278,2,3,273,278,0,8,270,278
7844794,1732,309704,new-1.0,completed,290.0,7.75,154,136,68,10,212,290,22,2,266,290,32,24,234,290,22,4,264,290,0,28,262,290
7844794,1732,247588,base,completed,540.0,6.9,70,470,0,443,97,540,91,63,386,540,20,0,520,540,93,319,128,540,15,372,153,540
7844794,1732,247588,base+,completed,345.0,7.3,89,256,47,77,221,345,22,32,291,345,14,58,273,345,0,175,170,345,49,0,296,345
7844794,1732,247588,dpv1,completed,364.0,7.85,63,301,70,7,287,364,52,171,141,364,0,50,314,364,66,100,198,364,16,82,266,364
7844794,1732,247588,dpv2,completed,329.0,7.65,140,189,28,2,299,329,43,46,240,329,73,0,256,329,74,85,170,329,0,40,289,329
7844794,1732,247588,new-0.0,completed,289.0,7.3,162,127,49,19,221,289,0,13,276,289,64,7,218,289,17,0,272,289,36,26,227,289
7844794,1732,247588,new-0.5,completed,276.0,7.7,182,94,49,10,217,276,47,0,229,276,0,10,266,276,3,0,273,276,36,25,215,276
7844794,1732,247588,new-1.0,completed,325.0,7.55,118,207,0,61,264,325,41,47,237,325,58,22,245,325,45,57,223,325,70,0,255,325
7844794,1732,203195,base,completed,416.0,7.15,52,364,16,102,298,416,28,43,345,416,0,320,96,416,75,0,341,416,74,175,167,416
7844794,1732,203195,base+,completed,299.0,7.15,171,128,25,9,265,299,21,0,278,299,51,30,218,299,59,0,240,299,0,54,245,299
7844794,1732,203195,dpv1,completed,307.0,7.25,125,182,9,0,298,307,42,15,250,307,0,31,276,307,45,0,262,307,43,99,165,307
7844794,1732,203195,dpv2,completed,353.0,7.7,107,246,28,83,242,353,38,74,241,353,0,59,294,353,70,4,279,353,65,108,180,353
7844794,1732,203195,new-0.0,completed,310.0,7.35,128,182,40,64,206,310,61,22,227,310,14,19,277,310,66,24,220,310,0,23,287,310
7844794,1732,203195,new-0.5,completed,295.0,7.8,149,146,43,46,206,295,0,0,295,295,4,2,289,295,19,51,225,295,38,29,228,295
7844794,1732,203195,new-1.0,completed,290.0,7.75,161,129,52,38,200,290,24,8,258,290,31,22,237,290,16,23,251,290,0,0,290,290
7844794,1732,178029,base,completed,387.0,7.25,65,322,0,238,149,387,36,92,259,387,70,0,317,387,22,17,348,387,50,157,180,387
7844794,1732,178029,base+,completed,329.0,6.9,67,262,59,91,179,329,0,20,309,329,27,43,259,329,57,33,239,329,15,67,247,329
7844794,1732,178029,dpv1,completed,351.0,7.3,83,268,50,142,159,351,64,69,218,351,66,0,285,351,38,40,273,351,0,74,277,351
7844794,1732,178029,dpv2,completed,300.0,7.6,174,126,48,0,252,300,29,0,271,300,47,43,210,300,34,24,242,300,0,30,270,300
7844794,1732,178029,new-0.0,completed,286.0,7.3,185,101,49,21,216,286,0,1,285,286,52,0,234,286,13,0,273,286,30,27,229,286
7844794,1732,178029,new-0.5,completed,303.0,7.65,167,136,67,0,236,303,35,6,262,303,0,6,297,303,56,24,223,303,43,38,222,303
7844794,1732,178029,new-1.0,completed,296.0,7.75,158,138,5,13,278,296,57,0,239,296,33,72,191,296,0,5,291,296,55,0,241,296
7844794,1732,239735,base,completed,511.0,7.0,80,431,0,383,128,511,4,0,507,511,13,317,181,511,19,175,317,511,29,381,101,511
7844794,1732,239735,base+,completed,379.0,7.3,70,309,0,106,273,379,68,17,294,379,62,56,261,379,34,103,242,379,46,183,150,379
7844794,1732,239735,dpv1,completed,326.0,7.25,103,223,60,0,266,326,51,23,252,326,69,50,207,326,0,0,326,326,68,81,177,326
7844794,1732,239735,dpv2,completed,308.0,7.9,139,169,60,5,243,308,34,27,247,308,0,56,252,308,25,47,236,308,61,0,247,308
7844794,1732,239735,new-0.0,completed,294.0,7.35,148,146,37,54,203,294,54,29,211,294,51,0,243,294,20,2,272,294,0,13,281,294
7844794,1732,239735,new-0.5,completed,296.0,7.55,164,132,56,22,218,296,70,0,226,296,0,5,291,296,32,5,259,296,41,45,210,296
7844794,1732,239735,new-1.0,completed,293.0,7.65,149,144,0,8,285,293,19,28,246,293,37,3,253,293,34,28,231,293,58,42,193,293
7844794,1732,675528,base,completed,349.0,7.3,69,280,56,159,134,349,67,0,282,349,59,106,184,349,36,33,280,349,0,22,327,349
7844794,1732,675528,base+,completed,368.0,7.0,75,293,53,107,208,368,0,71,297,368,48,0,320,368,43,180,145,368,6,82,280,368
7844794,1732,675528,dpv1,completed,363.0,7.45,65,298,70,57,236,363,40,173,150,363,0,0,363,363,65,74,224,363,18,76,269,363
7844794,1732,675528,dpv2,completed,327.0,7.65,124,203,22,16,289,327,63,67,197,327,67,0,260,327,34,49,244,327,0,78,249,327
7844794,1732,675528,new-0.0,completed,299.0,7.35,168,131,41,30,228,299,10,24,265,299,68,0,231,299,64,0,235,299,0,9,290,299
7844794,1732,675528,new-0.5,completed,314.0,7.7,155,159,16,0,298,314,52,25,237,314,0,8,306,314,65,40,209,314,67,25,222,314
7844794,1732,675528,new-1.0,completed,304.0,7.75,165,139,0,0,304,304,38,0,266,304,43,21,240,304,25,36,243,304,68,35,201,304
7844794,1732,380692,base,completed,367.0,6.8,81,286,2,185,180,367,44,23,300,367,22,168,177,367,0,100,267,367,50,0,317,367
7844794,1732,380692,base+,completed,324.0,6.95,84,240,0,14,310,324,54,3,267,324,60,11,253,324,38,139,147,324,31,39,254,324
7844794,1732,380692,dpv1,completed,308.0,7.25,130,178,44,77,187,308,28,3,277,308,0,31,277,308,44,8,256,308,43,23,242,308
7844794,1732,380692,dpv2,completed,321.0,7.9,131,190,26,16,279,321,41,25,255,321,0,71,250,321,69,52,200,321,68,0,253,321
7844794,1732,380692,new-0.0,completed,297.0,7.4,161,136,61,16,220,297,70,6,221,297,18,8,271,297,0,15,282,297,48,21,228,297
7844794,1732,380692,new-0.5,completed,304.0,7.35,153,151,51,37,216,304,20,21,263,304,67,0,237,304,0,29,275,304,70,3,231,304
7844794,1732,380692,new-1.0,completed,296.0,7.7,157,139,51,24,221,296,30,26,240,296,10,26,260,296,52,22,222,296,0,0,296,296
8854943,1827,310811,base,completed,338.0,7.2,168,170,49,0,289,338,0,81,257,338,23,66,249,338,21,0,317,338,31,102,205,338
8854943,1827,310811,base+,completed,315.0,7.2,124,191,0,9,306,315,1,128,186,315,48,0,267,315,38,13,264,315,11,15,289,315
8854943,1827,310811,dpv1,completed,336.0,7.3,85,251,4,58,274,336,39,0,297,336,0,0,336,336,10,63,263,336,45,175,116,336
8854943,1827,310811,dpv2,completed,332.0,7.6,84,248,12,67,253,332,0,166,166,332,34,0,298,332,66,0,266,332,17,0,315,332
8854943,1827,310811,new-0.0,completed,275.0,7.3,248,27,27,0,248,275,27,0,248,275,13,0,262,275,0,0,275,275,18,0,257,275
8854943,1827,310811,new-0.5,completed,283.0,7.8,195,88,12,30,241,283,31,0,252,283,0,0,283,283,33,22,228,283,15,3,265,283
8854943,1827,310811,new-1.0,completed,295.0,7.7,204,91,17,3,275,295,32,0,263,295,43,35,217,295,15,41,239,295,0,3,292,295
8854943,1827,208428,base,completed,315.0,7.1,181,134,44,68,203,315,14,29,272,315,26,20,269,315,0,0,315,315,42,0,273,315
8854943,1827,208428,base+,completed,302.0,7.25,174,128,0,0,302,302,32,86,184,302,42,0,260,302,32,0,270,302,10,0,292,302
8854943,1827,208428,dpv1,completed,326.0,7.5,99,227,5,56,265,326,16,16,294,326,0,5,321,326,25,0,301,326,33,173,120,326
8854943,1827,208428,dpv2,completed,337.0,7.75,108,229,34,129,174,337,60,47,230,337,55,0,282,337,22,24,291,337,0,0,337,337
8854943,1827,208428,new-0.0,completed,285.0,7.4,236,49,48,0,237,285,30,0,255,285,37,1,247,285,0,0,285,285,21,0,264,285
8854943,1827,208428,new-0.5,completed,281.0,7.7,252,29,29,0,252,281,26,0,255,281,2,0,279,281,0,0,281,281,27,0,254,281
8854943,1827,208428,new-1.0,completed,305.0,7.45,174,131,19,20,266,305,44,0,261,305,31,32,242,305,0,37,268,305,50,0,255,305
8854943,1827,460300,base,completed,411.0,7.0,107,304,5,260,146,411,11,137,263,411,0,93,318,411,77,131,203,411,21,0,390,411
8854943,1827,460300,base+,completed,303.0,7.15,213,90,0,0,303,303,34,41,228,303,42,7,254,303,41,0,262,303,33,0,270,303
8854943,1827,460300,dpv1,completed,307.0,7.4,137,170,9,15,283,307,11,0,296,307,33,0,274,307,28,0,279,307,0,123,184,307
8854943,1827,460300,dpv2,completed,334.0,7.6,92,242,63,78,193,334,5,22,307,334,0,60,274,334,12,2,320,334,26,102,206,334
8854943,1827,460300,new-0.0,completed,297.0,7.25,246,51,50,0,247,297,51,0,246,297,31,0,266,297,0,0,297,297,43,0,254,297
8854943,1827,460300,new-0.5,completed,308.0,7.55,160,148,46,0,262,308,16,33,259,308,0,24,284,308,5,44,259,308,20,41,247,308
8854943,1827,460300,new-1.0,completed,302.0,7.8,180,122,32,32,238,302,0,0,302,302,40,26,236,302,29,26,247,302,6,33,263,302
8854943,1827,309704,base,completed,378.0,7.0,147,231,27,89,262,378,79,30,269,378,36,0,342,378,0,184,194,378,10,111,257,378
8854943,1827,309704,base+,completed,282.0,7.15,183,99,2,36,244,282,30,0,252,282,34,0,248,282,8,29,245,282,0,8,274,282
8854943,1827,309704,dpv1,completed,324.0,7.3,109,215,10,6,308,324,0,0,324,324,24,33,267,324,45,159,120,324,40,0,284,324
8854943,1827,309704,dpv2,completed,336.0,7.6,134,202,12,65,259,336,51,109,176,336,10,0,326,336,42,36,258,336,0,50,286,336
8854943,1827,309704,new-0.0,completed,291.0,7.5,221,70,39,13,239,291,54,0,237,291,0,0,291,291,57,0,234,291,25,0,266,291
8854943,1827,309704,new-0.5,completed,289.0,7.5,242,47,17,0,272,289,47,0,242,289,46,0,243,289,0,0,289,289,38,0,251,289
8854943,1827,309704,new-1.0,completed,298.0,7.55,184,114,0,10,288,298,49,0,249,298,50,29,219,298,25,25,248,298,9,0,289,298
8854943,1827,247588,base,completed,313.0,6.85,147,166,15,98,200,313,0,0,313,313,37,0,276,313,8,0,305,313,8,116,189,313
8854943,1827,247588,base+,completed,324.0,7.3,170,154,0,95,229,324,33,10,281,324,7,0,317,324,31,106,187,324,19,36,269,324
8854943,1827,247588,dpv1,completed,328.0,7.4,108,220,0,8,320,328,6,35,287,328,6,59,263,328,43,155,130,328,27,0,301,328
8854943,1827,247588,dpv2,completed,340.0,7.65,91,249,67,22,251,340,11,23,306,340,0,56,284,340,12,60,268,340,33,103,204,340
8854943,1827,247588,new-0.0,completed,268.0,7.25,225,43,14,0,254,268,0,6,262,268,3,3,262,268,4,8,256,268,32,3,233,268
8854943,1827,247588,new-0.5,completed,282.0,7.5,236,46,0,0,282,282,46,0,236,282,21,0,261,282,37,0,245,282,32,0,250,282
8854943,1827,247588,new-1.0,completed,303.0,7.95,171,132,46,0,257,303,22,44,237,303,11,13,279,303,33,36,234,303,0,37,266,303
8854943,1827,203195,base,completed,376.0,7.15,158,218,30,0,346,376,11,174,191,376,0,192,184,376,8,128,240,376,21,0,355,376
8854943,1827,203195,base+,completed,362.0,7.05,131,231,14,7,341,362,3,74,285,362,0,136,226,362,29,53,280,362,46,111,205,362
8854943,1827,203195,dpv1,completed,347.0,7.35,79,268,12,68,267,347,48,0,299,347,0,0,347,347,20,65,262,347,55,182,110,347
8854943,1827,203195,dpv2,completed,326.0,7.45,139,187,43,0,283,326,6,0,320,326,0,57,269,326,12,55,259,326,53,92,181,326
8854943,1827,203195,new-0.0,completed,300.0,7.45,235,65,45,7,248,300,0,0,300,300,58,0,242,300,55,0,245,300,35,0,265,300
8854943,1827,203195,new-0.5,completed,306.0,7.7,178,128,33,18,255,306,53,0,253,306,0,0,306,306,54,30,222,306,27,26,253,306
8854943,1827,203195,new-1.0,completed,298.0,7.75,194,104,25,34,239,298,3,0,295,298,42,0,256,298,41,22,235,298,0,27,271,298
8854943,1827,178029,base,completed,341.0,7.05,179,162,0,0,341,341,34,0,307,341,45,82,214,341,33,117,191,341,0,80,261,341
8854943,1827,178029,base+,completed,315.0,7.3,123,192,0,134,181,315,41,0,274,315,16,17,282,315,31,0,284,315,18,37,260,315
8854943,1827,178029,dpv1,completed,382.0,7.35,105,277,32,74,276,382,24,55,303,382,0,81,301,382,6,44,332,382,91,171,120,382
8854943,1827,178029,dpv2,completed,322.0,7.8,120,202,11,0,311,322,39,47,236,322,36,0,286,322,0,26,296,322,16,106,200,322
8854943,1827,178029,new-0.0,completed,297.0,7.5,233,64,34,9,254,297,40,0,257,297,55,0,242,297,0,0,297,297,24,0,273,297
8854943,1827,178029,new-0.5,completed,298.0,7.65,197,101,28,0,270,298,44,0,254,298,0,0,298,298,26,35,237,298,17,22,259,298
8854943,1827,178029,new-1.0,completed,305.0,7.6,189,116,28,8,269,305,58,0,247,305,0,1,304,305,51,32,222,305,29,25,251,305
8854943,1827,239735,base,completed,333.0,7.2,152,181,47,0,286,333,34,0,299,333,33,120,180,333,31,98,204,333,0,0,333,333
8854943,1827,239735,base+,completed,295.0,7.25,182,113,7,41,247,295,13,57,225,295,0,19,276,295,29,0,266,295,26,0,269,295
8854943,1827,239735,dpv1,completed,363.0,7.35,86,277,7,114,242,363,8,66,289,363,27,0,336,363,0,78,285,363,71,174,118,363
8854943,1827,239735,dpv2,completed,289.0,7.7,131,158,19,0,270,289,48,11,230,289,0,16,273,289,7,5,277,289,8,94,187,289
8854943,1827,239735,new-0.0,completed,277.0,7.35,229,48,40,0,237,277,36,1,240,277,12,0,265,277,42,5,230,277,0,0,277,277
8854943,1827,239735,new-0.5,completed,285.0,7.85,175,110,9,42,234,285,19,0,266,285,0,4,281,285,34,30,221,285,16,4,265,285
8854943,1827,239735,new-1.0,completed,306.0,7.75,159,147,0,0,306,306,48,0,258,306,10,21,275,306,36,66,204,306,57,41,208,306
8854943,1827,675528,base,completed,311.0,7.1,181,130,21,40,250,311,42,0,269,311,0,0,311,311,45,0,266,311,28,78,205,311
8854943,1827,675528,base+,completed,348.0,7.15,82,266,18,67,263,348,5,45,298,348,0,59,289,348,36,196,116,348,32,0,316,348
8854943,1827,675528,dpv1,completed,335.0,7.4,103,232,12,42,281,335,32,0,303,335,0,0,335,335,6,62,267,335,48,168,119,335
8854943,1827,675528,dpv2,completed,321.0,7.7,100,221,29,0,292,321,45,42,234,321,0,54,267,321,4,0,317,321,14,118,189,321
8854943,1827,675528,new-0.0,completed,280.0,7.4,213,67,35,4,241,280,21,0,259,280,60,1,219,280,13,2,265,280,0,0,280,280
8854943,1827,675528,new-0.5,completed,303.0,7.8,195,108,29,21,253,303,54,0,249,303,0,0,303,303,47,0,256,303,34,33,236,303
8854943,1827,675528,new-1.0,completed,318.0,7.9,161,157,0,0,318,318,34,35,249,318,56,36,226,318,47,36,235,318,0,45,273,318
8854943,1827,380692,base,completed,324.0,6.9,170,154,30,99,195,324,38,0,286,324,28,3,293,324,0,0,324,324,44,83,197,324
8854943,1827,380692,base+,completed,284.0,7.25,192,92,5,7,272,284,5,15,264,284,13,0,271,284,47,39,198,284,0,32,252,284
8854943,1827,380692,dpv1,completed,325.0,7.35,107,218,0,63,262,325,28,0,297,325,51,0,274,325,6,33,286,325,9,134,182,325
8854943,1827,380692,dpv2,completed,334.0,7.5,138,196,11,59,264,334,8,18,308,334,0,63,271,334,26,45,263,334,55,96,183,334
8854943,1827,380692,new-0.0,completed,281.0,7.4,235,46,30,0,251,281,19,0,262,281,35,0,246,281,46,0,235,281,0,0,281,281
8854943,1827,380692,new-0.5,completed,274.0,7.55,247,27,0,0,274,274,27,0,247,274,5,0,269,274,26,0,248,274,25,0,249,274
8854943,1827,380692,new-1.0,completed,298.0,7.85,173,125,39,0,259,298,45,0,253,298,10,8,280,298,17,70,211,298,0,35,263,298
7300790,1646,310811,base,completed,288.0,6.75,94,194,4,78,206,288,26,0,262,288,0,92,196,288,51,0,237,288,2,29,257,288
7300790,1646,310811,base+,completed,293.0,6.85,144,149,0,52,241,293,20,0,273,293,25,0,268,293,18,54,221,293,48,49,196,293
7300790,1646,310811,dpv1,completed,276.0,7.2,152,124,55,0,221,276,39,0,237,276,14,25,237,276,16,31,229,276,0,27,249,276
7300790,1646,310811,dpv2,completed,285.0,7.25,134,151,0,43,242,285,45,43,197,285,23,1,261,285,29,6,250,285,11,46,228,285
7300790,1646,310811,new-0.0,completed,283.0,7.05,138,145,0,1,282,283,54,38,191,283,37,24,222,283,10,39,234,283,12,26,245,283
7300790,1646,310811,new-0.5,completed,273.0,7.3,141,132,0,32,241,273,44,15,214,273,38,0,235,273,1,25,247,273,18,25,230,273
7300790,1646,310811,new-1.0,completed,305.0,7.35,113,192,43,3,259,305,2,49,254,305,49,22,234,305,0,62,243,305,50,51,204,305
7300790,1646,208428,base,completed,297.0,6.85,105,192,0,109,188,297,5,27,265,297,54,48,195,297,8,0,289,297,22,0,275,297
7300790,1646,208428,base+,completed,282.0,6.85,146,136,39,0,243,282,15,36,231,282,18,0,264,282,43,47,192,282,0,38,244,282
7300790,1646,208428,dpv1,completed,279.0,7.15,150,129,53,6,220,279,31,0,248,279,0,21,258,279,33,23,223,279,23,37,219,279
7300790,1646,208428,dpv2,completed,284.0,7.25,135,149,0,37,247,284,50,41,193,284,0,49,235,284,15,20,249,284,26,2,256,284
7300790,1646,208428,new-0.0,completed,268.0,7.1,145,123,25,0,243,268,47,40,181,268,28,16,224,268,0,2,266,268,0,31,237,268
7300790,1646,208428,new-0.5,completed,290.0,7.25,150,140,17,0,273,290,0,37,253,290,60,6,224,290,36,17,237,290,58,50,182,290
7300790,1646,208428,new-1.0,completed,297.0,7.35,117,180,13,0,284,297,0,56,241,297,39,0,258,297,40,51,206,297,48,66,183,297
7300790,1646,460300,base,completed,302.0,6.85,148,154,26,10,266,302,0,85,217,302,56,0,246,302,19,105,178,302,4,20,278,302
7300790,1646,460300,base+,completed,293.0,6.9,93,200,46,69,178,293,0,44,249,293,33,39,221,293,26,5,262,293,2,0,291,293
7300790,1646,460300,dpv1,completed,278.0,7.45,163,115,4,0,274,278,50,42,186,278,0,21,257,278,31,0,247,278,25,13,240,278
7300790,1646,460300,dpv2,completed,288.0,7.2,134,154,4,48,236,288,6,27,255,288,49,49,190,288,0,18,270,288,42,7,239,288
7300790,1646,460300,new-0.0,completed,294.0,7.15,110,184,2,22,270,294,60,30,204,294,49,0,245,294,34,34,226,294,0,50,244,294
7300790,1646,460300,new-0.5,completed,286.0,7.3,135,151,0,37,249,286,45,40,201,286,40,6,240,286,3,28,255,286,18,30,238,286
7300790,1646,460300,new-1.0,completed,306.0,7.3,96,210,59,31,216,306,0,49,257,306,35,46,225,306,1,50,255,306,49,6,251,306
7300790,1646,309704,base,completed,321.0,6.85,104,217,27,5,289,321,0,0,321,321,37,102,182,321,52,131,138,321,54,0,267,321
7300790,1646,309704,base+,completed,275.0,7.1,137,138,5,39,231,275,8,31,236,275,0,30,245,275,48,26,201,275,13,0,262,275
7300790,1646,309704,dpv1,completed,278.0,7.2,155,123,56,0,222,278,45,0,233,278,15,35,228,278,14,16,248,278,0,27,251,278
7300790,1646,309704,dpv2,completed,292.0,7.35,130,162,11,33,248,292,0,24,268,292,62,51,179,292,25,29,238,292,41,10,241,292
7300790,1646,309704,new-0.0,completed,298.0,7.05,137,161,0,0,298,298,60,40,198,298,37,19,242,298,61,34,203,298,10,42,246,298
7300790,1646,309704,new-0.5,completed,285.0,7.35,161,124,25,8,252,285,57,28,200,285,33,12,240,285,52,0,233,285,0,42,243,285
7300790,1646,309704,new-1.0,completed,309.0,7.2,85,224,49,61,199,309,16,22,271,309,0,0,309,309,25,64,220,309,64,49,196,309
7300790,1646,247588,base,completed,316.0,6.85,119,197,31,60,225,316,0,0,316,316,25,147,144,316,41,32,243,316,15,19,282,316
7300790,1646,247588,base+,completed,268.0,6.85,158,110,0,20,248,268,46,38,184,268,6,0,262,268,9,36,223,268,30,0,238,268
7300790,1646,247588,dpv1,completed,281.0,7.2,146,135,50,0,231,281,53,4,224,281,0,26,255,281,16,39,226,281,16,28,237,281
7300790,1646,247588,dpv2,completed,282.0,7.1,130,152,2,32,248,282,51,47,184,282,0,50,232,282,17,23,242,282,19,6,257,282
7300790,1646,247588,new-0.0,completed,285.0,6.95,125,160,42,0,243,285,0,49,236,285,18,40,227,285,22,24,239,285,47,17,221,285
7300790,1646,247588,new-0.5,completed,270.0,7.2,151,119,0,0,270,270,5,20,245,270,51,39,180,270,31,22,217,270,20,0,250,270
7300790,1646,247588,new-1.0,completed,294.0,7.2,92,202,46,64,184,294,10,39,245,294,0,0,294,294,21,75,198,294,44,44,206,294
7300790,1646,203195,base,completed,313.0,6.85,72,241,45,44,224,313,15,128,170,313,0,66,247,313,47,0,266,313,14,2,297,313
7300790,1646,203195,base+,completed,287.0,7.1,141,146,41,0,246,287,44,53,190,287,0,0,287,287,40,51,196,287,0,52,235,287
7300790,1646,203195,dpv1,completed,284.0,7.2,148,136,51,10,223,284,35,0,249,284,50,0,234,284,11,47,226,284,0,47,237,284
7300790,1646,203195,dpv2,completed,283.0,7.25,135,148,0,30,253,283,6,37,240,283,52,48,183,283,18,26,239,283,31,0,252,283
7300790,1646,203195,new-0.0,completed,296.0,7.15,127,169,60,29,207,296,0,50,246,296,31,23,242,296,38,29,229,296,49,0,247,296
7300790,1646,203195,new-0.5,completed,274.0,7.25,140,134,34,0,240,274,50,38,186,274,2,27,245,274,0,12,262,274,21,19,234,274
7300790,1646,203195,new-1.0,completed,299.0,7.35,117,182,29,10,260,299,1,53,245,299,44,20,235,299,0,75,224,299,34,43,222,299
7300790,1646,178029,base,completed,292.0,6.75,73,219,0,0,292,292,0,103,189,292,36,75,181,292,17,39,236,292,49,0,243,292
7300790,1646,178029,base+,completed,284.0,6.95,154,130,43,30,211,284,0,24,260,284,50,11,223,284,17,13,254,284,3,42,239,284
7300790,1646,178029,dpv1,completed,280.0,7.1,162,118,13,18,249,280,9,0,271,280,45,0,235,280,0,52,228,280,35,55,190,280
7300790,1646,178029,dpv2,completed,307.0,7.05,99,208,0,68,239,307,5,60,242,307,44,78,185,307,11,26,270,307,13,32,262,307
7300790,1646,178029,new-0.0,completed,285.0,7.05,130,155,44,0,241,285,0,42,243,285,22,29,234,285,51,17,217,285,13,33,239,285
7300790,1646,178029,new-0.5,completed,285.0,7.1,138,147,0,19,266,285,5,11,269,285,57,15,213,285,17,32,236,285,40,57,188,285
7300790,1646,178029,new-1.0,completed,296.0,7.25,93,203,50,27,219,296,0,39,257,296,25,38,233,296,9,65,222,296,30,0,266,296
7300790,1646,239735,base,completed,289.0,6.95,122,167,22,13,254,289,0,0,289,289,18,13,258,289,43,0,246,289,50,98,141,289
7300790,1646,239735,base+,completed,281.0,7.0,93,188,29,9,243,281,3,57,221,281,15,16,250,281,57,46,178,281,0,35,246,281
7300790,1646,239735,dpv1,completed,273.0,7.15,158,115,3,0,270,273,41,0,232,273,51,40,182,273,0,29,244,273,11,24,238,273
7300790,1646,239735,dpv2,completed,284.0,7.25,120,164,0,40,244,284,16,41,227,284,47,59,178,284,8,28,248,284,28,3,253,284
7300790,1646,239735,new-0.0,completed,284.0,7.05,124,160,54,31,199,284,4,37,243,284,0,38,246,284,50,0,234,284,28,31,225,284
7300790,1646,239735,new-0.5,completed,291.0,7.2,148,143,66,2,223,291,16,0,275,291,0,28,263,291,65,45,181,291,42,22,227,291
7300790,1646,239735,new-1.0,completed,286.0,7.25,102,184,41,29,216,286,0,32,254,286,37,26,223,286,17,70,199,286,45,0,241,286
7300790,1646,675528,base,completed,306.0,7.0,103,203,27,73,206,306,2,9,295,306,44,32,230,306,30,159,117,306,0,0,306,306
7300790,1646,675528,base+,completed,291.0,6.9,114,177,24,5,262,291,0,55,236,291,1,28,262,291,50,40,201,291,3,53,235,291
7300790,1646,675528,dpv1,completed,284.0,7.2,163,121,13,2,269,284,7,0,277,284,0,21,263,284,46,41,197,284,36,53,195,284
7300790,1646,675528,dpv2,completed,292.0,7.35,137,155,12,0,280,292,55,66,171,292,17,34,241,292,39,0,253,292,0,38,254,292
7300790,1646,675528,new-0.0,completed,292.0,7.05,139,153,0,0,292,292,43,0,249,292,16,43,233,292,40,67,185,292,3,39,250,292
7300790,1646,675528,new-0.5,completed,280.0,7.3,139,141,44,0,236,280,32,0,248,280,0,30,250,280,20,35,225,280,0,32,248,280
7300790,1646,675528,new-1.0,completed,293.0,7.2,116,177,41,35,217,293,0,30,263,293,45,0,248,293,9,59,225,293,33,30,230,293
7300790,1646,380692,base,completed,316.0,6.8,89,227,32,17,267,316,0,22,294,316,25,67,224,316,40,43,233,316,63,130,123,316
7300790,1646,380692,base+,completed,290.0,6.8,112,178,37,5,248,290,0,61,229,290,55,39,196,290,19,8,263,290,16,48,226,290
7300790,1646,380692,dpv1,completed,292.0,7.3,151,141,15,15,262,292,55,0,237,292,0,23,269,292,59,40,193,292,27,30,235,292
7300790,1646,380692,dpv2,completed,286.0,7.3,110,176,8,53,225,286,43,66,177,286,22,11,253,286,0,10,276,286,0,35,251,286
7300790,1646,380692,new-0.0,completed,294.0,7.15,136,158,63,22,209,294,24,24,246,294,0,41,253,294,44,29,221,294,44,0,250,294
7300790,1646,380692,new-0.5,completed,276.0,7.35,156,120,4,24,248,276,54,16,206,276,40,0,236,276,36,19,221,276,0,22,254,276
7300790,1646,380692,new-1.0,completed,297.0,7.2,117,180,54,49,194,297,19,14,264,297,0,0,297,297,41,50,206,297,52,31,214,297
7654342,1723,310811,base,completed,269.0,6.7,228,41,32,0,237,269,41,0,228,269,8,0,261,269,19,0,250,269,0,0,269,269
7654342,1723,310811,base+,completed,287.0,6.8,208,79,56,0,231,287,8,0,279,287,35,0,252,287,54,0,233,287,0,32,255,287
7654342,1723,310811,dpv1,completed,301.0,7.05,193,108,0,55,246,301,92,0,209,301,24,0,277,301,44,0,257,301,56,0,245,301
7654342,1723,310811,dpv2,completed,279.0,7.1,191,88,49,0,230,279,55,0,224,279,24,3,252,279,0,0,279,279,45,30,204,279
7654342,1723,310811,new-0.0,completed,253.0,7.2,217,36,22,0,231,253,15,0,238,253,0,0,253,253,6,9,238,253,27,0,226,253
7654342,1723,310811,new-0.5,completed,291.0,7.35,213,78,69,0,222,291,74,0,217,291,78,0,213,291,43,0,248,291,0,0,291,291
7654342,1723,310811,new-1.0,completed,290.0,7.15,166,124,0,0,290,290,31,0,259,290,20,85,185,290,16,0,274,290,39,38,213,290
7654342,1723,208428,base,completed,299.0,6.65,136,163,0,113,186,299,16,0,283,299,52,12,235,299,37,0,262,299,40,0,259,299
7654342,1723,208428,base+,completed,279.0,6.7,202,77,16,0,263,279,37,0,242,279,50,0,229,279,37,0,242,279,0,30,249,279
7654342,1723,208428,dpv1,completed,341.0,7.05,176,165,75,0,266,341,17,67,257,341,0,116,225,341,85,0,256,341,113,0,228,341
7654342,1723,208428,dpv2,completed,278.0,7.15,191,87,30,0,248,278,11,13,254,278,45,0,233,278,45,29,204,278,0,0,278,278
7654342,1723,208428,new-0.0,completed,260.0,7.2,198,62,33,0,227,260,17,0,243,260,15,0,245,260,0,29,231,260,23,0,237,260
7654342,1723,208428,new-0.5,completed,289.0,7.25,206,83,76,0,213,289,78,0,211,289,56,5,228,289,25,0,264,289,0,0,289,289
7654342,1723,208428,new-1.0,completed,302.0,7.3,170,132,49,0,253,302,48,0,254,302,15,10,277,302,0,43,259,302,32,81,189,302
7654342,1723,460300,base,completed,305.0,6.55,177,128,0,81,224,305,30,0,275,305,69,0,236,305,17,0,288,305,70,0,235,305
7654342,1723,460300,base+,completed,285.0,7.0,217,68,68,0,217,285,38,0,247,285,23,0,262,285,52,0,233,285,0,7,278,285
7654342,1723,460300,dpv1,completed,283.0,7.0,203,80,75,0,208,283,18,0,265,283,0,33,250,283,17,0,266,283,34,0,249,283
7654342,1723,460300,dpv2,completed,278.0,7.15,185,93,37,0,241,278,3,22,253,278,41,0,237,278,0,0,278,278,44,27,207,278
7654342,1723,460300,new-0.0,completed,253.0,7.2,221,32,26,0,227,253,6,0,247,253,10,0,243,253,0,6,247,253,12,0,241,253
7654342,1723,460300,new-0.5,completed,284.0,7.25,208,76,71,0,213,284,0,0,284,284,48,3,233,284,13,0,271,284,73,0,211,284
7654342,1723,460300,new-1.0,completed,270.0,7.3,178,92,3,0,267,270,10,0,260,270,0,65,205,270,3,4,263,270,13,33,224,270
7654342,1723,309704,base,completed,300.0,6.7,166,134,59,0,241,300,49,54,197,300,23,0,277,300,60,0,240,300,0,24,276,300
7654342,1723,309704,base+,completed,271.0,6.75,202,69,38,0,233,271,54,0,217,271,23,0,248,271,0,15,256,271,3,4,264,271
7654342,1723,309704,dpv1,completed,340.0,6.9,183,157,0,84,256,340,28,60,252,340,136,0,204,340,97,0,243,340,93,0,247,340
7654342,1723,309704,dpv2,completed,276.0,7.15,209,67,25,3,248,276,57,0,219,276,0,0,276,276,60,4,212,276,33,0,243,276
7654342,1723,309704,new-0.0,completed,253.0,7.1,210,43,0,0,253,253,3,0,250,253,3,0,250,253,43,0,210,253,23,0,230,253
7654342,1723,309704,new-0.5,completed,255.0,7.35,223,32,22,0,233,255,0,0,255,255,9,0,246,255,12,0,243,255,32,0,223,255
7654342,1723,309704,new-1.0,completed,279.0,7.3,162,117,26,0,253,279,19,0,260,279,8,70,201,279,0,0,279,279,32,29,218,279
7654342,1723,247588,base,completed,284.0,6.8,213,71,60,0,224,284,0,0,284,284,22,11,251,284,57,0,227,284,59,0,225,284
7654342,1723,247588,base+,completed,267.0,7.0,208,59,21,0,246,267,19,0,248,267,0,0,267,267,59,0,208,267,24,0,243,267
7654342,1723,247588,dpv1,completed,261.0,7.05,195,66,50,0,211,261,13,0,248,261,1,21,239,261,17,0,244,261,0,0,261,261
7654342,1723,247588,dpv2,completed,272.0,7.15,191,81,43,0,229,272,9,1,262,272,33,0,239,272,55,25,192,272,0,0,272,272
7654342,1723,247588,new-0.0,completed,256.0,7.2,191,65,35,0,221,256,0,30,226,256,13,0,243,256,18,0,238,256,22,0,234,256
7654342,1723,247588,new-0.5,completed,286.0,7.25,201,85,74,0,212,286,0,0,286,286,16,0,270,286,53,0,233,286,56,11,219,286
7654342,1723,247588,new-1.0,completed,278.0,7.15,169,109,11,0,267,278,23,0,255,278,13,36,229,278,0,46,232,278,28,0,250,278
7654342,1723,203195,base,completed,290.0,6.65,149,141,25,61,204,290,24,0,266,290,0,37,253,290,11,4,275,290,43,0,247,290
7654342,1723,203195,base+,completed,281.0,6.4,224,57,15,6,260,281,49,0,232,281,51,0,230,281,0,0,281,281,23,0,258,281
7654342,1723,203195,dpv1,completed,340.0,7.15,169,171,77,0,263,340,85,0,255,340,15,75,250,340,0,125,215,340,123,0,217,340
7654342,1723,203195,dpv2,completed,310.0,7.2,144,166,60,0,250,310,20,54,236,310,60,0,250,310,0,47,263,310,49,68,193,310
7654342,1723,203195,new-0.0,completed,264.0,7.15,212,52,18,0,246,264,0,0,264,264,37,0,227,264,14,2,248,264,42,8,214,264
7654342,1723,203195,new-0.5,completed,293.0,7.35,217,76,69,0,224,293,0,0,293,293,71,0,222,293,40,0,253,293,76,0,217,293
7654342,1723,203195,new-1.0,completed,276.0,7.15,180,96,0,0,276,276,12,0,264,276,3,28,245,276,29,32,215,276,36,0,240,276
7654342,1723,178029,base,completed,273.0,6.75,175,98,23,0,250,273,44,0,229,273,19,54,200,273,0,0,273,273,9,0,264,273
7654342,1723,178029,base+,completed,282.0,6.65,198,84,0,37,245,282,44,0,238,282,20,0,262,282,4,0,278,282,47,0,235,282
7654342,1723,178029,dpv1,completed,340.0,7.1,184,156,108,0,232,340,0,110,230,340,11,35,294,340,88,0,252,340,92,2,246,340
7654342,1723,178029,dpv2,completed,277.0,7.15,207,70,35,0,242,277,0,0,277,277,15,9,253,277,62,3,212,277,48,0,229,277
7654342,1723,178029,new-0.0,completed,260.0,7.2,209,51,20,0,240,260,0,26,234,260,11,0,249,260,10,0,250,260,25,0,235,260
7654342,1723,178029,new-0.5,completed,283.0,7.3,211,72,61,0,222,283,0,0,283,283,72,0,211,283,31,0,252,283,37,0,246,283
7654342,1723,178029,new-1.0,completed,314.0,7.25,143,171,0,0,314,314,42,0,272,314,28,41,245,314,58,56,200,314,30,80,204,314
7654342,1723,239735,base,completed,299.0,6.7,175,124,44,20,235,299,57,0,242,299,0,55,244,299,38,0,261,299,17,49,233,299
7654342,1723,239735,base+,completed,272.0,6.5,194,78,0,0,272,272,62,0,210,272,2,32,238,272,44,0,228,272,36,0,236,272
7654342,1723,239735,dpv1,completed,274.0,7.0,194,80,26,0,248,274,39,0,235,274,68,0,206,274,0,33,241,274,23,0,251,274
7654342,1723,239735,dpv2,completed,284.0,7.15,176,108,59,0,225,284,18,19,247,284,49,0,235,284,0,0,284,284,52,30,202,284
7654342,1723,239735,new-0.0,completed,260.0,7.05,213,47,15,0,245,260,28,1,231,260,0,0,260,260,46,0,214,260,30,0,230,260
7654342,1723,239735,new-0.5,completed,267.0,7.35,208,59,35,0,232,267,7,0,260,267,59,0,208,267,0,0,267,267,48,0,219,267
7654342,1723,239735,new-1.0,completed,270.0,7.25,187,83,31,0,239,270,44,1,225,270,0,0,270,270,12,0,258,270,56,27,187,270
7654342,1723,675528,base,completed,266.0,6.55,212,54,11,0,255,266,41,0,225,266,0,13,253,266,7,0,259,266,32,0,234,266
7654342,1723,675528,base+,completed,289.0,6.55,206,83,24,0,265,289,0,35,254,289,30,0,259,289,53,0,236,289,71,0,218,289
7654342,1723,675528,dpv1,completed,303.0,6.8,191,112,0,62,241,303,22,5,276,303,39,0,264,303,92,0,211,303,62,0,241,303
7654342,1723,675528,dpv2,completed,290.0,7.15,193,97,45,0,245,290,15,11,264,290,58,0,232,290,0,0,290,290,58,28,204,290
7654342,1723,675528,new-0.0,completed,260.0,7.2,214,46,26,0,234,260,0,0,260,260,18,0,242,260,19,4,237,260,42,0,218,260
7654342,1723,675528,new-0.5,completed,291.0,7.35,215,76,60,0,231,291,0,0,291,291,67,0,224,291,42,0,249,291,76,0,215,291
7654342,1723,675528,new-1.0,completed,270.0,7.35,175,95,7,0,263,270,16,0,254,270,0,46,224,270,10,2,258,270,27,28,215,270
7654342,1723,380692,base,completed,282.0,6.55,176,106,27,48,207,282,53,0,229,282,0,12,270,282,23,0,259,282,34,0,248,282
7654342,1723,380692,base+,completed,283.0,6.8,171,112,31,0,252,283,42,26,215,283,0,20,263,283,58,0,225,283,19,9,255,283
7654342,1723,380692,dpv1,completed,369.0,6.8,200,169,105,23,241,369,166,0,203,369,0,118,251,369,25,82,262,369,87,0,282,369
7654342,1723,380692,dpv2,completed,270.0,7.1,193,77,25,0,245,270,39,0,231,270,3,0,267,270,0,0,270,270,34,38,198,270
7654342,1723,380692,new-0.0,completed,272.0,7.15,197,75,52,0,220,272,0,24,248,272,26,0,246,272,22,13,237,272,50,0,222,272
7654342,1723,380692,new-0.5,completed,282.0,7.35,196,86,37,0,245,282,85,0,197,282,71,1,210,282,40,0,242,282,0,0,282,282
7654342,1723,380692,new-1.0,completed,284.0,7.35,175,109,53,0,231,284,18,0,266,284,40,0,244,284,66,15,203,284,0,28,256,284
9711838,1752,310811,base,completed,588.0,7.65,59,529,59,233,296,588,0,393,195,588,83,0,505,588,90,342,156,588,64,397,127,588
9711838,1752,310811,base+,completed,440.0,7.55,68,372,11,226,203,440,23,162,255,440,37,4,399,440,0,150,290,440,79,229,132,440
9711838,1752,310811,dpv1,completed,476.0,7.4,89,387,46,262,168,476,81,303,92,476,56,106,314,476,0,129,347,476,69,63,344,476
9711838,1752,310811,dpv2,completed,407.0,7.7,89,318,47,133,227,407,14,145,248,407,0,97,310,407,41,49,317,407,6,234,167,407
9711838,1752,310811,new-0.0,completed,419.0,7.15,113,306,47,95,277,419,17,153,249,419,0,158,261,419,65,119,235,419,39,121,259,419
9711838,1752,310811,new-0.5,completed,422.0,7.6,97,325,0,117,305,422,61,142,219,422,46,135,241,422,9,153,260,422,20,173,229,422
9711838,1752,310811,new-1.0,completed,423.0,7.65,111,312,10,101,312,423,41,185,197,423,37,143,243,423,3,160,260,423,0,161,262,423
9711838,1752,208428,base,completed,499.0,7.45,98,401,28,300,171,499,37,0,462,499,42,207,250,499,0,295,204,499,23,307,169,499
9711838,1752,208428,base+,completed,458.0,7.35,78,380,0,165,293,458,31,33,394,458,19,253,186,458,3,302,153,458,63,193,202,458
9711838,1752,208428,dpv1,completed,465.0,7.3,87,378,6,282,177,465,60,318,87,465,0,120,345,465,30,75,360,465,24,136,305,465
9711838,1752,208428,dpv2,completed,404.0,7.7,66,338,25,103,276,404,14,153,237,404,60,157,187,404,4,16,384,404,0,228,176,404
9711838,1752,208428,new-0.0,completed,420.0,7.15,112,308,0,105,315,420,26,155,239,420,36,158,226,420,61,123,236,420,65,118,237,420
9711838,1752,208428,new-0.5,completed,441.0,7.6,117,324,0,119,322,441,60,142,239,441,70,156,215,441,39,158,244,441,26,150,265,441
9711838,1752,208428,new-1.0,completed,444.0,7.65,106,338,17,117,310,444,36,208,200,444,56,169,219,444,0,188,256,444,5,166,273,444
9711838,1752,460300,base,completed,516.0,7.4,72,444,29,230,257,516,11,407,98,516,10,214,292,516,37,354,125,516,0,0,516,516
9711838,1752,460300,base+,completed,462.0,7.3,70,392,40,225,197,462,45,170,247,462,70,51,341,462,0,261,201,462,15,165,282,462
9711838,1752,460300,dpv1,completed,469.0,7.4,93,376,0,275,194,469,74,302,93,469,53,122,294,469,28,72,369,469,46,115,308,469
9711838,1752,460300,dpv2,completed,438.0,7.7,87,351,54,150,234,438,34,160,244,438,0,118,320,438,63,56,319,438,23,242,173,438
9711838,1752,460300,new-0.0,completed,419.0,7.35,102,317,0,103,316,419,44,146,229,419,14,163,242,419,85,113,221,419,43,101,275,419
9711838,1752,460300,new-0.5,completed,440.0,7.6,117,323,29,117,294,440,74,135,231,440,79,143,218,440,39,171,230,440,0,153,287,440
9711838,1752,460300,new-1.0,completed,435.0,7.65,120,315,20,110,305,435,41,186,208,435,35,154,246,435,0,178,257,435,15,155,265,435
9711838,1752,309704,base,completed,440.0,7.55,105,335,52,191,197,440,0,255,185,440,6,0,434,440,0,195,245,440,21,241,178,440
9711838,1752,309704,base+,completed,439.0,6.95,78,361,0,233,206,439,39,170,230,439,79,154,206,439,20,111,308,439,42,72,325,439
9711838,1752,309704,dpv1,completed,489.0,7.3,87,402,32,286,171,489,87,315,87,489,57,129,303,489,0,85,404,489,62,117,310,489
9711838,1752,309704,dpv2,completed,460.0,7.7,65,395,20,151,289,460,23,187,250,460,52,111,297,460,73,131,256,460,0,264,196,460
9711838,1752,309704,new-0.0,completed,427.0,7.2,117,310,66,101,260,427,57,120,250,427,23,164,240,427,64,119,244,427,0,167,260,427
9711838,1752,309704,new-0.5,completed,421.0,7.35,103,318,29,111,281,421,0,177,244,421,55,144,222,421,25,160,236,421,15,142,264,421
9711838,1752,309704,new-1.0,completed,457.0,7.65,98,359,0,112,345,457,72,172,213,457,16,182,259,457,36,164,257,457,31,215,211,457
9711838,1752,247588,base,completed,497.0,7.05,106,391,4,301,192,497,50,296,151,497,43,164,290,497,0,0,497,497,37,289,171,497
9711838,1752,247588,base+,completed,456.0,7.1,69,387,77,201,178,456,0,261,195,456,44,71,341,456,47,141,268,456,35,157,264,456
9711838,1752,247588,dpv1,completed,491.0,7.3,91,400,33,308,150,491,67,330,94,491,42,135,314,491,0,108,383,491,38,128,325,491
9711838,1752,247588,dpv2,completed,400.0,7.7,92,308,34,151,215,400,7,148,245,400,0,106,294,400,35,28,337,400,12,227,161,400
9711838,1752,247588,new-0.0,completed,414.0,7.2,106,308,11,112,291,414,32,166,216,414,0,153,261,414,53,132,229,414,59,129,226,414
9711838,1752,247588,new-0.5,completed,428.0,7.6,115,313,35,124,269,428,65,134,229,428,61,131,236,428,31,162,235,428,0,152,276,428
9711838,1752,247588,new-1.0,completed,441.0,7.65,106,335,33,113,295,441,39,188,214,441,53,160,228,441,0,187,254,441,22,155,264,441
9711838,1752,203195,base,completed,592.0,7.4,70,522,0,289,303,592,42,308,242,592,55,131,406,592,76,359,157,592,53,396,143,592
9711838,1752,203195,base+,completed,466.0,7.05,71,395,64,186,216,466,86,255,125,466,58,175,233,466,0,21,445,466,39,155,272,466
9711838,1752,203195,dpv1,completed,467.0,7.4,78,389,0,280,187,467,68,321,78,467,34,117,316,467,36,68,363,467,30,130,307,467
9711838,1752,203195,dpv2,completed,436.0,7.75,71,365,0,119,317,436,47,154,235,436,59,91,286,436,72,112,252,436,40,222,174,436
9711838,1752,203195,new-0.0,completed,437.0,7.05,112,325,13,110,314,437,49,161,227,437,0,164,273,437,75,133,229,437,78,135,224,437
9711838,1752,203195,new-0.5,completed,424.0,7.35,114,310,30,116,278,424,0,177,247,424,57,143,224,424,26,168,230,424,19,130,275,424
9711838,1752,203195,new-1.0,completed,453.0,7.65,98,355,0,113,340,453,14,154,285,453,84,174,195,453,51,162,240,453,48,188,217,453
9711838,1752,178029,base,completed,500.0,7.5,33,467,47,281,172,500,0,236,264,500,46,0,454,500,60,232,208,500,14,346,140,500
9711838,1752,178029,base+,completed,412.0,7.35,98,314,0,58,354,412,6,249,157,412,60,118,234,412,32,209,171,412,36,30,346,412
9711838,1752,178029,dpv1,completed,480.0,7.4,88,392,0,281,199,480,77,315,88,480,45,121,314,480,38,70,372,480,45,129,306,480
9711838,1752,178029,dpv2,completed,441.0,7.7,64,377,41,129,271,441,20,175,246,441,76,188,177,441,22,47,372,441,0,247,194,441
9711838,1752,178029,new-0.0,completed,428.0,7.35,114,314,0,114,314,428,40,170,218,428,6,181,241,428,70,119,239,428,40,138,250,428
9711838,1752,178029,new-0.5,completed,430.0,7.35,118,312,33,119,278,430,0,178,252,430,65,153,212,430,35,166,229,430,19,127,284,430
9711838,1752,178029,new-1.0,completed,455.0,7.65,96,359,0,112,343,455,77,170,208,455,19,194,242,455,26,169,260,455,44,204,207,455
9711838,1752,239735,base,completed,487.0,7.4,53,434,0,211,276,487,57,0,430,487,15,271,201,487,40,266,181,487,23,266,198,487
9711838,1752,239735,base+,completed,440.0,7.1,63,377,1,281,158,440,44,150,246,440,68,0,372,440,0,239,201,440,28,166,246,440
9711838,1752,239735,dpv1,completed,437.0,7.4,118,319,0,260,177,437,3,289,145,437,30,113,294,437,28,104,305,437,26,116,295,437
9711838,1752,239735,dpv2,completed,431.0,7.7,64,367,38,124,269,431,0,166,265,431,73,184,174,431,32,32,367,431,31,237,163,431
9711838,1752,239735,new-0.0,completed,417.0,7.35,108,309,0,100,317,417,48,159,210,417,17,168,232,417,68,122,227,417,41,115,261,417
9711838,1752,239735,new-0.5,completed,409.0,7.45,115,294,0,108,301,409,37,144,228,409,55,137,217,409,27,148,234,409,8,126,275,409
9711838,1752,239735,new-1.0,completed,439.0,7.65,99,340,0,109,330,439,75,152,212,439,21,162,256,439,42,148,249,439,41,190,208,439
9711838,1752,675528,base,completed,540.0,7.15,62,478,41,0,499,540,9,298,233,540,0,430,110,540,29,345,166,540,74,211,255,540
9711838,1752,675528,base+,completed,456.0,7.3,94,362,40,190,226,456,17,68,371,456,72,274,110,456,0,110,346,456,26,210,220,456
9711838,1752,675528,dpv1,completed,472.0,7.4,117,355,0,276,196,472,13,307,152,472,40,114,318,472,39,130,303,472,46,132,294,472
9711838,1752,675528,dpv2,completed,431.0,7.55,68,363,31,117,283,431,37,155,239,431,78,171,182,431,48,20,363,431,0,229,202,431
9711838,1752,675528,new-0.0,completed,420.0,7.25,103,317,0,120,300,420,34,154,232,420,4,163,253,420,76,119,225,420,43,119,258,420
9711838,1752,675528,new-0.5,completed,433.0,7.6,119,314,26,123,284,433,66,129,238,433,71,138,224,433,28,153,252,433,0,151,282,433
9711838,1752,675528,new-1.0,completed,422.0,7.65,104,318,5,115,302,422,32,184,206,422,49,154,219,422,0,168,254,422,4,150,268,422
9711838,1752,380692,base,completed,532.0,7.2,63,469,30,382,120,532,63,0,469,532,0,419,113,532,1,316,215,532,11,153,368,532
9711838,1752,380692,base+,completed,437.0,7.2,93,344,12,238,187,437,51,198,188,437,0,164,273,437,51,24,362,437,1,195,241,437
9711838,1752,380692,dpv1,completed,470.0,7.45,89,381,0,286,184,470,69,307,94,470,30,118,322,470,40,77,353,470,42,130,298,470
9711838,1752,380692,dpv2,completed,414.0,7.8,79,335,0,105,309,414,17,144,253,414,40,97,277,414,68,80,266,414,30,227,157,414
9711838,1752,380692,new-0.0,completed,411.0,7.15,115,296,0,107,304,411,30,151,230,411,25,159,227,411,63,112,236,411,64,111,236,411
9711838,1752,380692,new-0.5,completed,432.0,7.6,119,313,0,122,310,432,58,144,230,432,58,148,226,432,19,158,255,432,29,160,243,432
9711838,1752,380692,new-1.0,completed,433.0,7.65,107,326,1,113,319,433,39,194,200,433,51,166,216,433,0,181,252,433,1,161,271,433
1409824,1755,310811,base,completed,298.0,6.8,147,151,58,0,240,298,0,61,237,298,1,0,297,298,5,0,293,298,8,72,218,298
1409824,1755,310811,base+,completed,280.0,6.9,187,93,28,19,233,280,37,7,236,280,27,3,250,280,67,0,213,280,0,0,280,280
1409824,1755,310811,dpv1,completed,330.0,7.35,114,216,4,61,265,330,1,123,206,330,57,0,273,330,38,26,266,330,0,71,259,330
1409824,1755,310811,dpv2,completed,336.0,7.3,147,189,47,0,289,336,67,96,173,336,0,1,335,336,67,0,269,336,49,93,194,336
1409824,1755,310811,new-0.0,completed,283.0,7.15,161,122,13,0,270,283,0,33,250,283,7,0,276,283,63,5,215,283,23,36,224,283
1409824,1755,310811,new-0.5,completed,284.0,7.4,184,100,14,0,270,284,15,25,244,284,64,2,218,284,42,13,229,284,0,0,284,284
1409824,1755,310811,new-1.0,completed,316.0,7.2,120,196,22,5,289,316,0,29,287,316,40,66,210,316,76,52,188,316,33,0,283,316
1409824,1755,208428,base,completed,371.0,6.9,66,305,0,108,263,371,19,149,203,371,69,0,302,371,38,0,333,371,15,169,187,371
1409824,1755,208428,base+,completed,319.0,7.0,126,193,0,30,289,319,36,5,278,319,33,127,159,319,67,10,242,319,29,0,290,319
1409824,1755,208428,dpv1,completed,296.0,7.55,154,142,31,27,238,296,0,28,268,296,28,13,255,296,33,15,248,296,59,25,212,296
1409824,1755,208428,dpv2,completed,325.0,7.35,138,187,44,0,281,325,0,89,236,325,66,0,259,325,64,0,261,325,35,96,194,325
1409824,1755,208428,new-0.0,completed,287.0,7.05,190,97,26,0,261,287,0,25,262,287,42,0,245,287,29,1,257,287,34,30,223,287
1409824,1755,208428,new-0.5,completed,292.0,7.4,160,132,20,26,246,292,19,0,273,292,14,0,278,292,0,42,250,292,59,40,193,292
1409824,1755,208428,new-1.0,completed,297.0,7.5,154,143,17,0,280,297,26,61,210,297,16,61,220,297,0,39,258,297,10,0,287,297
1409824,1755,460300,base,completed,371.0,7.05,78,293,63,0,308,371,39,151,181,371,33,32,306,371,44,69,258,371,0,158,213,371
1409824,1755,460300,base+,completed,308.0,7.0,158,150,8,35,265,308,69,0,239,308,22,0,286,308,0,0,308,308,8,94,206,308
1409824,1755,460300,dpv1,completed,306.0,7.55,151,155,43,26,237,306,0,27,279,306,42,12,252,306,38,11,257,306,68,26,212,306
1409824,1755,460300,dpv2,completed,334.0,7.55,149,185,41,88,205,334,69,92,173,334,63,0,271,334,0,0,334,334,39,1,294,334
1409824,1755,460300,new-0.0,completed,312.0,7.2,165,147,42,0,270,312,0,36,276,312,41,2,269,312,57,11,244,312,81,42,189,312
1409824,1755,460300,new-0.5,completed,327.0,7.25,156,171,69,67,191,327,0,48,279,327,38,0,289,327,49,19,259,327,49,22,256,327
1409824,1755,460300,new-1.0,completed,320.0,7.0,128,192,19,0,301,320,0,60,260,320,39,65,216,320,26,0,294,320,78,32,210,320
1409824,1755,309704,base,completed,333.0,6.95,157,176,70,0,263,333,29,41,263,333,35,111,187,333,35,85,213,333,0,0,333,333
1409824,1755,309704,base+,completed,311.0,6.85,134,177,12,138,161,311,0,4,307,311,13,34,264,311,49,2,260,311,67,0,244,311
1409824,1755,309704,dpv1,completed,329.0,7.25,135,194,49,83,197,329,75,0,254,329,44,20,265,329,35,17,277,329,0,52,277,329
1409824,1755,309704,dpv2,completed,320.0,7.5,146,174,39,78,203,320,45,87,188,320,38,0,282,320,1,32,287,320,0,13,307,320
1409824,1755,309704,new-0.0,completed,275.0,7.1,209,66,29,0,246,275,0,20,255,275,23,0,252,275,24,0,251,275,27,17,231,275
1409824,1755,309704,new-0.5,completed,308.0,7.05,181,127,30,18,260,308,34,0,274,308,69,56,183,308,35,0,273,308,0,23,285,308
1409824,1755,309704,new-1.0,completed,305.0,7.25,145,160,7,4,294,305,17,24,264,305,41,40,224,305,60,58,187,305,0,0,305,305
1409824,1755,247588,base,completed,361.0,6.9,121,240,52,20,289,361,8,36,317,361,29,31,301,361,0,121,240,361,28,188,145,361
1409824,1755,247588,base+,completed,342.0,7.0,101,241,0,0,342,342,80,0,262,342,36,83,223,342,38,168,136,342,34,42,266,342
1409824,1755,247588,dpv1,completed,337.0,7.5,126,211,66,0,271,337,47,96,194,337,42,38,257,337,53,51,233,337,0,64,273,337
1409824,1755,247588,dpv2,completed,300.0,7.2,158,142,20,65,215,300,30,110,160,300,9,2,289,300,30,0,270,300,0,0,300,300
1409824,1755,247588,new-0.0,completed,293.0,7.1,156,137,14,0,279,293,34,44,215,293,54,20,219,293,25,0,268,293,0,47,246,293
1409824,1755,247588,new-0.5,completed,275.0,7.2,185,90,22,0,253,275,0,3,272,275,29,4,242,275,0,0,275,275,50,33,192,275
1409824,1755,247588,new-1.0,completed,280.0,7.2,184,96,32,15,233,280,0,0,280,280,22,15,243,280,59,0,221,280,30,7,243,280
1409824,1755,203195,base,completed,323.0,6.95,148,175,35,11,277,323,15,45,263,323,2,0,321,323,29,140,154,323,0,40,283,323
1409824,1755,203195,base+,completed,315.0,6.8,129,186,40,56,219,315,10,23,282,315,0,37,278,315,8,74,233,315,65,0,250,315
1409824,1755,203195,dpv1,completed,334.0,7.5,126,208,67,0,267,334,43,88,203,334,37,29,268,334,46,39,249,334,0,61,273,334
1409824,1755,203195,dpv2,completed,331.0,7.35,148,183,34,2,295,331,0,0,331,331,71,73,187,331,75,1,255,331,38,101,192,331
1409824,1755,203195,new-0.0,completed,288.0,7.25,155,133,14,0,274,288,25,4,259,288,22,47,219,288,0,0,288,288,64,31,193,288
1409824,1755,203195,new-0.5,completed,302.0,7.15,159,143,26,6,270,302,32,1,269,302,68,56,178,302,27,6,269,302,0,40,262,302
1409824,1755,203195,new-1.0,completed,290.0,7.5,157,133,16,0,274,290,24,42,224,290,20,58,212,290,0,27,263,290,13,0,277,290
1409824,1755,178029,base,completed,311.0,6.85,126,185,80,35,196,311,9,43,259,311,0,2,309,311,41,51,219,311,43,1,267,311
1409824,1755,178029,base+,completed,332.0,6.95,114,218,63,0,269,332,16,69,247,332,26,159,147,332,0,23,309,332,1,0,331,332
1409824,1755,178029,dpv1,completed,332.0,7.35,124,208,0,67,265,332,1,131,200,332,55,0,277,332,39,32,261,332,4,66,262,332
1409824,1755,178029,dpv2,completed,318.0,7.25,152,166,15,3,300,318,50,97,171,318,32,78,208,318,47,0,271,318,0,0,318,318
1409824,1755,178029,new-0.0,completed,306.0,7.1,147,159,0,33,273,306,76,0,230,306,40,3,263,306,33,0,273,306,37,50,219,306
1409824,1755,178029,new-0.5,completed,292.0,7.05,161,131,2,19,271,292,22,15,255,292,54,44,194,292,3,13,276,292,0,31,261,292
1409824,1755,178029,new-1.0,completed,319.0,7.25,139,180,53,0,266,319,0,44,275,319,38,67,214,319,44,54,221,319,33,0,286,319
1409824,1755,239735,base,completed,385.0,7.1,71,314,42,22,321,385,72,0,313,385,39,160,186,385,0,176,209,385,38,136,211,385
1409824,1755,239735,base+,completed,306.0,6.8,133,173,62,64,180,306,5,0,301,306,17,0,289,306,0,119,187,306,2,46,258,306
1409824,1755,239735,dpv1,completed,302.0,7.45,94,208,53,0,249,302,2,98,202,302,32,7,263,302,5,59,238,302,0,53,249,302
1409824,1755,239735,dpv2,completed,328.0,7.25,132,196,42,85,201,328,73,94,161,328,46,0,282,328,68,6,254,328,0,0,328,328
1409824,1755,239735,new-0.0,completed,284.0,7.15,154,130,12,0,272,284,0,44,240,284,14,17,253,284,53,0,231,284,32,42,210,284
1409824,1755,239735,new-0.5,completed,262.0,7.5,174,88,11,24,227,262,22,7,233,262,0,23,239,262,2,1,259,262,42,0,220,262
1409824,1755,239735,new-1.0,completed,311.0,7.05,109,202,0,37,274,311,65,57,189,311,32,69,210,311,33,4,274,311,24,0,287,311
1409824,1755,675528,base,completed,327.0,6.95,101,226,17,0,310,327,0,82,245,327,37,143,147,327,16,33,278,327,75,5,247,327
1409824,1755,675528,base+,completed,298.0,7.0,183,115,63,0,235,298,44,2,252,298,42,23,233,298,42,9,247,298,0,29,269,298
1409824,1755,675528,dpv1,completed,330.0,7.2,129,201,44,27,259,330,68,0,262,330,37,25,268,330,41,91,198,330,0,55,275,330
1409824,1755,675528,dpv2,completed,344.0,7.3,134,210,56,97,191,344,84,90,170,344,50,0,294,344,82,3,259,344,0,0,344,344
1409824,1755,675528,new-0.0,completed,280.0,7.1,162,118,0,36,244,280,53,0,227,280,8,0,272,280,1,0,279,280,16,29,235,280
1409824,1755,675528,new-0.5,completed,288.0,7.5,159,129,0,0,288,288,27,30,231,288,56,18,214,288,7,43,238,288,3,17,268,288
1409824,1755,675528,new-1.0,completed,306.0,7.25,132,174,1,0,305,306,21,33,252,306,41,47,218,306,58,60,188,306,0,9,297,306
1409824,1755,380692,base,completed,396.0,6.9,103,293,0,85,311,396,22,0,374,396,30,150,216,396,29,223,144,396,64,137,195,396
1409824,1755,380692,base+,completed,301.0,7.05,115,186,0,0,301,301,21,139,141,301,13,24,264,301,3,0,298,301,47,0,254,301
1409824,1755,380692,dpv1,completed,308.0,7.45,114,194,62,0,246,308,0,95,213,308,25,9,274,308,0,51,257,308,2,33,273,308
1409824,1755,380692,dpv2,completed,327.0,7.35,129,198,39,0,288,327,65,96,166,327,63,0,264,327,0,0,327,327,30,98,199,327
1409824,1755,380692,new-0.0,completed,284.0,7.1,178,106,22,0,262,284,0,27,257,284,18,2,264,284,56,0,228,284,36,22,226,284
1409824,1755,380692,new-0.5,completed,300.0,7.25,129,171,64,0,236,300,0,37,263,300,35,40,225,300,23,25,252,300,26,5,269,300
1409824,1755,380692,new-1.0,completed,310.0,7.15,126,184,0,37,273,310,56,54,200,310,25,65,220,310,13,0,297,310,28,0,282,310
6003422,1582,310811,base,completed,279.0,7.4,197,82,76,0,203,279,46,9,224,279,0,0,279,279,73,0,206,279,65,0,214,279
6003422,1582,310811,base+,completed,312.0,7.0,67,245,0,215,97,312,25,0,287,312,78,0,234,312,63,0,249,312,30,0,282,312
6003422,1582,310811,dpv1,completed,268.0,7.1,167,101,6,33,229,268,0,0,268,268,43,0,225,268,53,0,215,268,38,30,200,268
6003422,1582,310811,dpv2,completed,280.0,7.4,170,110,0,80,200,280,30,0,250,280,67,0,213,280,43,0,237,280,47,0,233,280
6003422,1582,310811,new-0.0,completed,260.0,7.35,201,59,46,0,214,260,59,0,201,260,23,0,237,260,38,0,222,260,0,31,229,260
6003422,1582,310811,new-0.5,completed,279.0,7.55,186,93,80,0,199,279,66,0,213,279,0,8,271,279,29,26,224,279,59,0,220,279
6003422,1582,310811,new-1.0,completed,262.0,7.7,187,75,42,0,220,262,0,48,214,262,0,0,262,262,26,18,218,262,75,0,187,262
6003422,1582,208428,base,completed,269.0,7.1,184,85,51,0,218,269,0,27,242,269,2,0,267,269,48,0,221,269,28,30,211,269
6003422,1582,208428,base+,completed,297.0,6.8,66,231,0,206,91,297,25,8,264,297,41,0,256,297,35,0,262,297,33,0,264,297
6003422,1582,208428,dpv1,completed,288.0,7.3,122,166,19,0,269,288,21,0,267,288,80,0,208,288,34,24,230,288,0,108,180,288
6003422,1582,208428,dpv2,completed,258.0,7.4,183,75,46,0,212,258,27,0,231,258,16,27,215,258,47,0,211,258,0,21,237,258
6003422,1582,208428,new-0.0,completed,268.0,7.15,206,62,62,0,206,268,38,0,230,268,58,0,210,268,0,31,237,268,27,0,241,268
6003422,1582,208428,new-0.5,completed,268.0,7.55,202,66,0,0,268,268,37,0,231,268,29,13,226,268,53,0,215,268,64,0,204,268
6003422,1582,208428,new-1.0,completed,261.0,7.55,205,56,38,0,223,261,32,0,229,261,0,33,228,261,28,0,233,261,23,13,225,261
6003422,1582,460300,base,completed,275.0,6.85,151,124,24,0,251,275,59,0,216,275,0,100,175,275,50,0,225,275,13,0,262,275
6003422,1582,460300,base+,completed,280.0,7.25,186,94,44,9,227,280,45,0,235,280,28,22,230,280,0,57,223,280,60,0,220,280
6003422,1582,460300,dpv1,completed,300.0,7.25,104,196,72,0,228,300,38,0,262,300,0,0,300,300,28,140,132,300,56,50,194,300
6003422,1582,460300,dpv2,completed,257.0,7.15,196,61,11,0,246,257,27,0,230,257,0,34,223,257,58,0,199,257,36,0,221,257
6003422,1582,460300,new-0.0,completed,270.0,7.15,199,71,29,0,241,270,0,42,228,270,69,0,201,270,25,0,245,270,58,0,212,270
6003422,1582,460300,new-0.5,completed,257.0,7.5,180,77,45,0,212,257,66,0,191,257,0,44,213,257,27,0,230,257,11,0,246,257
6003422,1582,460300,new-1.0,completed,275.0,7.55,156,119,51,42,182,275,23,0,252,275,65,0,210,275,0,49,226,275,28,0,247,275
6003422,1582,309704,base,completed,271.0,7.2,191,80,44,0,227,271,76,0,195,271,63,3,205,271,32,14,225,271,0,0,271,271
6003422,1582,309704,base+,completed,288.0,6.9,169,119,57,0,231,288,69,0,219,288,35,62,191,288,59,0,229,288,0,0,288,288
6003422,1582,309704,dpv1,completed,263.0,7.05,161,102,1,32,230,263,33,0,230,263,24,0,239,263,0,0,263,263,60,37,166,263
6003422,1582,309704,dpv2,completed,280.0,7.45,176,104,0,73,207,280,31,0,249,280,70,0,210,280,46,0,234,280,64,0,216,280
6003422,1582,309704,new-0.0,completed,256.0,7.15,202,54,28,6,222,256,0,23,233,256,48,0,208,256,4,0,252,256,45,0,211,256
6003422,1582,309704,new-0.5,completed,258.0,7.65,196,62,0,0,258,258,46,0,212,258,37,0,221,258,41,0,217,258,9,21,228,258
6003422,1582,309704,new-1.0,completed,274.0,7.55,189,85,45,0,229,274,0,56,218,274,59,0,215,274,39,0,235,274,29,25,220,274
6003422,1582,247588,base,completed,292.0,7.05,74,218,25,0,267,292,38,0,254,292,0,193,99,292,14,0,278,292,62,0,230,292
6003422,1582,247588,base+,completed,275.0,6.9,171,104,16,64,195,275,40,0,235,275,56,0,219,275,66,0,209,275,0,0,275,275
6003422,1582,247588,dpv1,completed,278.0,7.15,101,177,0,110,168,278,62,0,216,278,5,0,273,278,25,42,211,278,22,0,256,278
6003422,1582,247588,dpv2,completed,255.0,7.2,201,54,25,0,230,255,0,26,229,255,26,0,229,255,54,0,201,255,50,0,205,255
6003422,1582,247588,new-0.0,completed,251.0,7.2,196,55,41,0,210,251,17,0,234,251,0,29,222,251,24,0,227,251,55,0,196,251
6003422,1582,247588,new-0.5,completed,250.0,7.45,195,55,0,0,250,250,39,0,211,250,3,22,225,250,30,0,220,250,55,0,195,250
6003422,1582,247588,new-1.0,completed,276.0,7.65,194,82,0,51,225,276,44,0,232,276,31,18,227,276,53,0,223,276,45,0,231,276
6003422,1582,203195,base,completed,328.0,7.05,97,231,0,60,268,328,63,0,265,328,76,142,110,328,36,0,292,328,29,103,196,328
6003422,1582,203195,base+,completed,291.0,7.2,187,104,31,0,260,291,73,0,218,291,79,0,212,291,44,23,224,291,0,50,241,291
6003422,1582,203195,dpv1,completed,304.0,7.15,102,202,50,71,183,304,28,0,276,304,0,39,265,304,24,113,167,304,61,0,243,304
6003422,1582,203195,dpv2,completed,265.0,7.35,179,86,0,54,211,265,33,0,232,265,32,0,233,265,70,0,195,265,23,0,242,265
6003422,1582,203195,new-0.0,completed,265.0,7.25,182,83,25,0,240,265,67,8,190,265,0,50,215,265,25,13,227,265,41,0,224,265
6003422,1582,203195,new-0.5,completed,275.0,7.45,188,87,0,0,275,275,55,0,220,275,35,28,212,275,59,3,213,275,75,0,200,275
6003422,1582,203195,new-1.0,completed,264.0,7.55,195,69,28,4,232,264,42,0,222,264,0,0,264,264,69,0,195,264,0,40,224,264
6003422,1582,178029,base,completed,271.0,6.85,189,82,29,0,242,271,57,0,214,271,68,0,203,271,0,56,215,271,26,0,245,271
6003422,1582,178029,base+,completed,266.0,7.25,207,59,59,0,207,266,0,28,238,266,52,0,214,266,29,0,237,266,29,0,237,266
6003422,1582,178029,dpv1,completed,276.0,7.2,154,122,34,0,242,276,0,55,221,276,66,0,210,276,17,0,259,276,29,38,209,276
6003422,1582,178029,dpv2,completed,270.0,7.35,188,82,0,0,270,270,63,0,207,270,29,6,235,270,53,19,198,270,45,0,225,270
6003422,1582,178029,new-0.0,completed,259.0,7.15,195,64,43,0,216,259,0,39,220,259,25,0,234,259,47,0,212,259,19,0,240,259
6003422,1582,178029,new-0.5,completed,271.0,7.7,191,80,54,0,217,271,71,0,200,271,0,5,266,271,54,0,217,271,34,21,216,271
6003422,1582,178029,new-1.0,completed,259.0,7.6,199,60,33,2,224,259,33,0,226,259,43,0,216,259,47,0,212,259,0,27,232,259
6003422,1582,239735,base,completed,262.0,7.0,194,68,64,0,198,262,14,26,222,262,0,0,262,262,52,0,210,262,42,0,220,262
6003422,1582,239735,base+,completed,256.0,7.05,164,92,0,3,253,256,46,44,166,256,14,0,242,256,48,0,208,256,40,0,216,256
6003422,1582,239735,dpv1,completed,298.0,7.15,104,194,63,55,180,298,35,98,165,298,73,0,225,298,29,33,236,298,0,0,298,298
6003422,1582,239735,dpv2,completed,257.0,7.15,194,63,28,0,229,257,0,36,221,257,27,0,230,257,62,0,195,257,22,0,235,257
6003422,1582,239735,new-0.0,completed,254.0,7.25,193,61,0,0,254,254,61,0,193,254,36,0,218,254,8,25,221,254,57,0,197,254
6003422,1582,239735,new-0.5,completed,256.0,7.6,188,68,42,0,214,256,65,0,191,256,3,0,253,256,0,39,217,256,29,0,227,256
6003422,1582,239735,new-1.0,completed,256.0,7.6,183,73,26,9,221,256,44,0,212,256,36,0,220,256,17,0,239,256,0,47,209,256
6003422,1582,675528,base,completed,240.0,7.25,198,42,0,0,240,240,22,7,211,240,0,17,223,240,25,0,215,240,35,0,205,240
6003422,1582,675528,base+,completed,284.0,6.8,186,98,40,0,244,284,66,0,218,284,72,0,212,284,13,58,213,284,0,0,284,284
6003422,1582,675528,dpv1,completed,291.0,7.25,106,185,33,0,258,291,4,0,287,291,28,0,263,291,0,157,134,291,75,0,216,291
6003422,1582,675528,dpv2,completed,283.0,7.4,187,96,0,66,217,283,74,0,209,283,30,0,253,283,53,0,230,283,56,0,227,283
6003422,1582,675528,new-0.0,completed,261.0,7.25,191,70,10,31,220,261,0,0,261,261,68,0,193,261,39,0,222,261,38,0,223,261
6003422,1582,675528,new-0.5,completed,270.0,7.55,185,85,17,26,227,270,61,0,209,270,43,0,227,270,47,0,223,270,0,18,252,270
6003422,1582,675528,new-1.0,completed,251.0,7.6,204,47,46,0,205,251,4,0,247,251,25,0,226,251,0,15,236,251,32,0,219,251
6003422,1582,380692,base,completed,258.0,6.65,183,75,26,0,232,258,52,0,206,258,2,49,207,258,51,0,207,258,0,0,258,258
6003422,1582,380692,base+,completed,258.0,7.45,181,77,61,4,193,258,0,42,216,258,56,0,202,258,28,3,227,258,11,0,247,258
6003422,1582,380692,dpv1,completed,271.0,7.25,108,163,12,0,259,271,10,0,261,271,28,0,243,271,64,25,182,271,0,110,161,271
6003422,1582,380692,dpv2,completed,274.0,7.35,179,95,0,63,211,274,33,0,241,274,32,0,242,274,67,0,207,274,53,0,221,274
6003422,1582,380692,new-0.0,completed,239.0,7.3,197,42,25,0,214,239,21,6,212,239,0,15,224,239,24,0,215,239,13,0,226,239
6003422,1582,380692,new-0.5,completed,264.0,7.65,184,80,41,0,223,264,0,0,264,264,25,18,221,264,52,15,197,264,65,0,199,264
6003422,1582,380692,new-1.0,completed,259.0,7.65,201,58,0,0,259,259,3,31,225,259,58,0,201,259,27,0,232,259,57,0,202,259
1799185,1826,310811,base,completed,401.0,6.85,158,243,84,6,311,401,0,119,282,401,143,63,195,401,131,23,247,401,110,28,263,401
1799185,1826,310811,base+,completed,344.0,6.75,187,157,66,23,255,344,0,9,335,344,67,0,277,344,72,60,212,344,58,25,261,344
1799185,1826,310811,dpv1,completed,392.0,7.25,150,242,63,49,280,392,0,206,186,392,28,0,364,392,58,166,168,392,86,0,306,392
1799185,1826,310811,dpv2,completed,386.0,7.25,121,265,108,98,180,386,88,70,228,386,0,77,309,386,90,15,281,386,96,0,290,386
1799185,1826,310811,new-0.0,completed,357.0,6.9,187,170,102,0,255,357,105,22,230,357,111,15,231,357,81,0,276,357,0,48,309,357
1799185,1826,310811,new-0.5,completed,364.0,7.4,169,195,94,51,219,364,114,16,234,364,69,3,292,364,88,20,256,364,0,65,299,364
1799185,1826,310811,new-1.0,completed,334.0,7.3,153,181,60,26,248,334,60,9,265,334,104,0,230,334,0,68,266,334,77,0,257,334
1799185,1826,208428,base,completed,354.0,6.8,152,202,47,0,307,354,22,139,193,354,10,4,340,354,43,0,311,354,0,183,171,354
1799185,1826,208428,base+,completed,310.0,6.6,155,155,30,0,280,310,37,1,272,310,9,32,269,310,0,0,310,310,3,140,167,310
1799185,1826,208428,dpv1,completed,401.0,7.2,138,263,52,198,151,401,0,207,194,401,89,0,312,401,52,58,291,401,26,0,375,401
1799185,1826,208428,dpv2,completed,391.0,7.25,145,246,100,0,291,391,78,87,226,391,121,51,219,391,0,106,285,391,110,23,258,391
1799185,1826,208428,new-0.0,completed,364.0,6.95,182,182,111,27,226,364,111,9,244,364,0,42,322,364,105,31,228,364,79,0,285,364
1799185,1826,208428,new-0.5,completed,381.0,7.25,146,235,0,61,320,381,106,67,208,381,84,8,289,381,103,13,265,381,128,42,211,381
1799185,1826,208428,new-1.0,completed,360.0,7.3,184,176,124,35,201,360,84,0,276,360,0,55,305,360,112,0,248,360,91,0,269,360
1799185,1826,460300,base,completed,367.0,6.7,143,224,8,0,359,367,32,159,176,367,45,0,322,367,54,25,288,367,0,161,206,367
1799185,1826,460300,base+,completed,325.0,6.7,180,145,37,27,261,325,63,0,262,325,26,106,193,325,25,0,300,325,0,0,325,325
1799185,1826,460300,dpv1,completed,346.0,7.2,135,211,0,196,150,346,1,0,345,346,15,0,331,346,2,157,187,346,26,0,320,346
1799185,1826,460300,dpv2,completed,356.0,7.2,179,177,108,6,242,356,83,0,273,356,81,18,257,356,82,52,222,356,0,50,306,356
1799185,1826,460300,new-0.0,completed,379.0,6.9,187,192,118,0,261,379,139,0,240,379,122,31,226,379,0,61,318,379,83,10,286,379
1799185,1826,460300,new-0.5,completed,362.0,7.35,185,177,101,0,261,362,0,64,298,362,127,6,229,362,87,0,275,362,117,16,229,362
1799185,1826,460300,new-1.0,completed,370.0,7.3,179,191,105,32,233,370,0,71,299,370,72,32,266,370,84,0,286,370,106,39,225,370
1799185,1826,309704,base,completed,402.0,6.7,75,327,71,74,257,402,82,0,320,402,69,44,289,402,0,80,322,402,90,183,129,402
1799185,1826,309704,base+,completed,364.0,6.95,156,208,0,0,364,364,63,124,177,364,69,27,268,364,28,149,187,364,48,0,316,364
1799185,1826,309704,dpv1,completed,401.0,7.15,144,257,29,0,372,401,0,200,201,401,65,52,284,401,62,179,160,401,80,0,321,401
1799185,1826,309704,dpv2,completed,376.0,7.35,173,203,116,47,213,376,0,44,332,376,101,12,263,376,87,77,212,376,101,0,275,376
1799185,1826,309704,new-0.0,completed,361.0,6.9,174,187,105,20,236,361,104,31,226,361,116,26,219,361,0,58,303,361,73,0,288,361
1799185,1826,309704,new-0.5,completed,375.0,7.3,171,204,106,29,240,375,82,0,293,375,136,16,223,375,0,94,281,375,98,19,258,375
1799185,1826,309704,new-1.0,completed,368.0,7.35,191,177,124,23,221,368,84,0,284,368,118,0,250,368,130,14,224,368,0,53,315,368
1799185,1826,247588,base,completed,397.0,7.1,174,223,75,0,322,397,0,115,282,397,127,50,220,397,90,74,233,397,98,28,271,397
1799185,1826,247588,base+,completed,341.0,6.7,139,202,0,174,167,341,22,0,319,341,46,0,295,341,18,0,323,341,23,154,164,341
1799185,1826,247588,dpv1,completed,364.0,7.05,146,218,23,0,341,364,0,174,190,364,61,0,303,364,36,32,296,364,34,168,162,364
1799185,1826,247588,dpv2,completed,379.0,7.15,126,253,93,67,219,379,71,126,182,379,0,80,299,379,93,0,286,379,87,0,292,379
1799185,1826,247588,new-0.0,completed,372.0,7.0,171,201,111,25,236,372,0,73,299,372,129,23,220,372,114,37,221,372,82,0,290,372
1799185,1826,247588,new-0.5,completed,354.0,7.25,185,169,98,7,249,354,96,23,235,354,104,33,217,354,74,10,270,354,0,48,306,354
1799185,1826,247588,new-1.0,completed,360.0,7.35,169,191,97,25,238,360,77,0,283,360,126,34,200,360,122,0,238,360,0,58,302,360
1799185,1826,203195,base,completed,362.0,6.85,131,231,46,47,269,362,0,144,218,362,80,0,282,362,57,38,267,362,67,0,295,362
1799185,1826,203195,base+,completed,329.0,6.85,176,153,0,25,304,329,66,0,263,329,51,63,215,329,30,0,299,329,56,15,258,329
1799185,1826,203195,dpv1,completed,391.0,7.15,124,267,79,161,151,391,78,0,313,391,98,0,293,391,0,21,370,391,105,110,176,391
1799185,1826,203195,dpv2,completed,409.0,7.25,159,250,103,0,306,409,0,64,345,409,130,89,190,409,84,120,205,409,116,38,255,409
1799185,1826,203195,new-0.0,completed,372.0,6.85,178,194,102,13,257,372,0,60,312,372,81,0,291,372,105,45,222,372,131,27,214,372
1799185,1826,203195,new-0.5,completed,391.0,7.35,156,235,0,86,305,391,89,4,298,391,111,70,210,391,108,1,282,391,140,31,220,391
1799185,1826,203195,new-1.0,completed,359.0,7.45,173,186,115,39,205,359,105,0,254,359,99,0,260,359,80,0,279,359,0,65,294,359
1799185,1826,178029,base,completed,385.0,6.95,131,254,55,95,235,385,54,149,182,385,23,74,288,385,0,91,294,385,89,0,296,385
1799185,1826,178029,base+,completed,356.0,6.7,150,206,43,0,313,356,20,155,181,356,63,91,202,356,0,0,356,356,67,33,256,356
1799185,1826,178029,dpv1,completed,391.0,7.2,149,242,0,19,372,391,82,120,189,391,106,0,285,391,108,127,156,391,84,0,307,391
1799185,1826,178029,dpv2,completed,388.0,7.3,179,209,113,31,244,388,0,80,308,388,128,6,254,388,82,92,214,388,106,0,282,388
1799185,1826,178029,new-0.0,completed,368.0,6.9,193,175,112,0,256,368,128,1,239,368,117,23,228,368,0,68,300,368,75,0,293,368
1799185,1826,178029,new-0.5,completed,380.0,7.3,175,205,120,25,235,380,143,6,231,380,0,71,309,380,89,17,274,380,119,11,250,380
1799185,1826,178029,new-1.0,completed,346.0,7.35,160,186,96,41,209,346,67,0,279,346,0,53,293,346,87,0,259,346,96,10,240,346
1799185,1826,239735,base,completed,412.0,7.0,156,256,101,66,245,412,92,0,320,412,106,57,249,412,0,132,280,412,69,150,193,412
1799185,1826,239735,base+,completed,333.0,7.05,167,166,0,0,333,333,86,69,178,333,87,0,246,333,41,24,268,333,63,0,270,333
1799185,1826,239735,dpv1,completed,376.0,7.2,136,240,35,194,147,376,0,188,188,376,76,0,300,376,34,50,292,376,17,0,359,376
1799185,1826,239735,dpv2,completed,349.0,7.25,164,185,78,0,271,349,0,13,336,349,74,20,255,349,63,83,203,349,71,78,200,349
1799185,1826,239735,new-0.0,completed,355.0,7.05,185,170,128,0,227,355,118,5,232,355,0,81,274,355,102,0,253,355,77,0,278,355
1799185,1826,239735,new-0.5,completed,338.0,7.3,178,160,70,30,238,338,66,0,272,338,99,15,224,338,0,64,274,338,61,20,257,338
1799185,1826,239735,new-1.0,completed,309.0,7.35,140,169,16,64,229,309,55,0,254,309,67,30,212,309,0,38,271,309,27,0,282,309
1799185,1826,675528,base,completed,421.0,6.85,115,306,104,87,230,421,0,231,190,421,98,61,262,421,103,54,264,421,67,0,354,421
1799185,1826,675528,base+,completed,349.0,6.65,205,144,82,0,267,349,62,55,232,349,97,0,252,349,75,23,251,349,0,22,327,349
1799185,1826,675528,dpv1,completed,376.0,7.2,157,219,53,37,286,376,22,0,354,376,0,189,187,376,49,154,173,376,60,0,316,376
1799185,1826,675528,dpv2,completed,416.0,7.25,147,269,106,0,310,416,74,103,239,416,137,67,212,416,0,133,283,416,115,39,262,416
1799185,1826,675528,new-0.0,completed,386.0,7.0,188,198,115,46,225,386,111,12,263,386,127,28,231,386,94,14,278,386,0,52,334,386
1799185,1826,675528,new-0.5,completed,381.0,7.3,176,205,113,31,237,381,107,14,260,381,132,28,221,381,79,14,288,381,0,72,309,381
1799185,1826,675528,new-1.0,completed,359.0,7.3,196,163,121,20,218,359,0,55,304,359,121,8,230,359,93,3,263,359,76,0,283,359
1799185,1826,380692,base,completed,403.0,6.9,179,224,90,0,313,403,153,18,232,403,0,140,263,403,70,124,209,403,119,0,284,403
1799185,1826,380692,base+,completed,334.0,7.1,154,180,0,52,282,334,81,67,186,334,41,28,265,334,37,63,234,334,35,0,299,334
1799185,1826,380692,dpv1,completed,393.0,7.2,155,238,113,0,280,393,94,109,190,393,0,26,367,393,111,121,161,393,81,0,312,393
1799185,1826,380692,dpv2,completed,381.0,7.3,153,228,84,0,297,381,0,73,308,381,96,64,221,381,81,21,279,381,83,83,215,381
1799185,1826,380692,new-0.0,completed,377.0,6.95,205,172,126,16,235,377,132,5,240,377,121,6,250,377,91,0,286,377,0,53,324,377
1799185,1826,380692,new-0.5,completed,377.0,7.25,165,212,115,4,258,377,148,0,229,377,91,1,285,377,115,19,243,377,0,94,283,377
1799185,1826,380692,new-1.0,completed,354.0,7.3,189,165,101,0,253,354,80,0,274,354,105,0,249,354,0,52,302,354,107,44,203,354
1735311,1687,310811,base,completed,273.0,7.05,199,74,0,0,273,273,9,56,208,273,12,44,217,273,4,0,269,273,45,0,228,273
1735311,1687,310811,base+,completed,284.0,6.75,163,121,29,0,255,284,0,54,230,284,5,0,279,284,9,44,231,284,18,32,234,284
1735311,1687,310811,dpv1,completed,290.0,7.1,146,144,0,0,290,290,12,0,278,290,25,56,209,290,22,0,268,290,7,122,161,290
1735311,1687,310811,dpv2,completed,303.0,7.5,149,154,0,0,303,303,11,128,164,303,27,37,239,303,48,0,255,303,47,0,256,303
1735311,1687,310811,new-0.0,completed,286.0,7.1,206,80,74,1,211,286,0,6,280,286,60,0,226,286,65,0,221,286,14,20,252,286
1735311,1687,310811,new-0.5,completed,280.0,7.2,190,90,38,0,242,280,43,27,210,280,7,32,241,280,0,0,280,280,47,5,228,280
1735311,1687,310811,new-1.0,completed,291.0,7.3,150,141,0,27,264,291,46,0,245,291,31,0,260,291,8,37,246,291,46,70,175,291
1735311,1687,208428,base,completed,300.0,6.7,123,177,47,0,253,300,0,11,289,300,10,0,290,300,54,0,246,300,15,148,137,300
1735311,1687,208428,base+,completed,301.0,6.8,130,171,47,0,254,301,52,16,233,301,9,132,160,301,0,0,301,301,21,0,280,301
1735311,1687,208428,dpv1,completed,292.0,7.1,110,182,16,152,124,292,0,0,292,292,55,26,211,292,17,0,275,292,9,0,283,292
1735311,1687,208428,dpv2,completed,282.0,7.5,145,137,4,0,278,282,15,111,156,282,25,34,223,282,0,0,282,282,31,0,251,282
1735311,1687,208428,new-0.0,completed,284.0,7.1,212,72,66,0,218,284,9,31,244,284,49,0,235,284,59,0,225,284,0,1,283,284
1735311,1687,208428,new-0.5,completed,291.0,7.3,172,119,51,34,206,291,37,15,239,291,18,12,261,291,47,0,244,291,0,26,265,291
1735311,1687,208428,new-1.0,completed,296.0,7.55,160,136,62,41,193,296,46,12,238,296,46,0,250,296,36,27,233,296,0,22,274,296
1735311,1687,460300,base,completed,417.0,6.7,103,314,0,235,182,417,48,0,369,417,69,96,252,417,13,231,173,417,58,103,256,417
1735311,1687,460300,base+,completed,298.0,6.85,143,155,0,16,282,298,39,0,259,298,55,78,165,298,22,24,252,298,4,0,294,298
1735311,1687,460300,dpv1,completed,298.0,7.05,109,189,9,166,123,298,23,0,275,298,0,0,298,298,16,39,243,298,15,0,283,298
1735311,1687,460300,dpv2,completed,286.0,7.35,149,137,0,12,274,286,11,115,160,286,22,0,264,286,6,0,280,286,49,0,237,286
1735311,1687,460300,new-0.0,completed,290.0,7.05,213,77,74,0,216,290,0,3,287,290,68,0,222,290,17,20,253,290,60,0,230,290
1735311,1687,460300,new-0.5,completed,281.0,7.4,179,102,22,1,258,281,23,14,244,281,15,8,258,281,39,50,192,281,0,0,281,281
1735311,1687,460300,new-1.0,completed,288.0,7.5,168,120,0,27,261,288,4,0,284,288,43,0,245,288,43,68,177,288,19,15,254,288
1735311,1687,309704,base,completed,315.0,7.05,130,185,62,67,186,315,17,0,298,315,0,0,315,315,8,143,164,315,53,0,262,315
1735311,1687,309704,base+,completed,288.0,6.8,133,155,30,34,224,288,36,36,216,288,30,0,258,288,0,49,239,288,13,23,252,288
1735311,1687,309704,dpv1,completed,297.0,7.05,120,177,15,148,134,297,60,39,198,297,21,0,276,297,0,0,297,297,3,0,294,297
1735311,1687,309704,dpv2,completed,280.0,7.5,154,126,14,3,263,280,18,98,164,280,0,0,280,280,28,0,252,280,8,20,252,280
1735311,1687,309704,new-0.0,completed,291.0,7.1,196,95,80,0,211,291,14,26,251,291,0,8,283,291,83,2,206,291,70,0,221,291
1735311,1687,309704,new-0.5,completed,282.0,7.25,199,83,51,1,230,282,9,19,254,282,58,9,215,282,41,2,239,282,0,3,279,282
1735311,1687,309704,new-1.0,completed,303.0,7.55,156,147,68,57,178,303,34,21,248,303,48,3,252,303,23,34,246,303,0,47,256,303
1735311,1687,247588,base,completed,293.0,6.9,120,173,16,0,277,293,53,0,240,293,0,11,282,293,13,0,280,293,13,145,135,293
1735311,1687,247588,base+,completed,311.0,6.55,131,180,46,0,265,311,0,67,244,311,74,0,237,311,11,93,207,311,51,0,260,311
1735311,1687,247588,dpv1,completed,303.0,6.95,116,187,18,159,126,303,32,0,271,303,6,0,297,303,31,57,215,303,0,0,303,303
1735311,1687,247588,dpv2,completed,293.0,7.55,146,147,18,5,270,293,48,82,163,293,36,0,257,293,60,0,233,293,0,24,269,293
1735311,1687,247588,new-0.0,completed,273.0,7.1,208,65,61,0,212,273,9,15,249,273,0,0,273,273,56,0,217,273,65,0,208,273
1735311,1687,247588,new-0.5,completed,276.0,7.35,191,85,11,31,234,276,35,5,236,276,42,0,234,276,0,6,270,276,34,15,227,276
1735311,1687,247588,new-1.0,completed,288.0,7.45,156,132,0,21,267,288,44,1,243,288,43,0,245,288,18,80,190,288,28,13,247,288
1735311,1687,203195,base,completed,297.0,6.6,121,176,15,56,226,297,34,75,188,297,48,0,249,297,19,0,278,297,0,0,297,297
1735311,1687,203195,base+,completed,304.0,6.7,105,199,12,86,206,304,10,0,294,304,41,86,177,304,0,36,268,304,11,0,293,304
1735311,1687,203195,dpv1,completed,298.0,7.0,110,188,9,162,127,298,0,41,257,298,52,0,246,298,44,0,254,298,10,0,288,298
1735311,1687,203195,dpv2,completed,272.0,7.45,149,123,10,0,262,272,12,93,167,272,29,0,243,272,1,0,271,272,0,24,248,272
1735311,1687,203195,new-0.0,completed,273.0,7.1,203,70,0,8,265,273,11,15,247,273,47,0,226,273,41,0,232,273,50,2,221,273
1735311,1687,203195,new-0.5,completed,265.0,7.5,180,85,14,11,240,265,26,0,239,265,34,40,191,265,0,2,263,265,6,0,259,265
1735311,1687,203195,new-1.0,completed,303.0,7.45,156,147,70,42,191,303,73,0,230,303,0,0,303,303,23,35,245,303,13,49,241,303
1735311,1687,178029,base,completed,290.0,6.7,134,156,2,19,269,290,0,0,290,290,12,0,278,290,14,132,144,290,65,0,225,290
1735311,1687,178029,base+,completed,339.0,6.65,119,220,65,73,201,339,0,19,320,339,37,0,302,339,44,163,132,339,51,13,275,339
1735311,1687,178029,dpv1,completed,296.0,6.95,116,180,16,147,133,296,39,0,257,296,13,0,283,296,44,28,224,296,0,0,296,296
1735311,1687,178029,dpv2,completed,291.0,7.5,151,140,18,0,273,291,31,100,160,291,43,0,248,291,0,0,291,291,14,39,238,291
1735311,1687,178029,new-0.0,completed,281.0,7.15,206,75,0,0,281,281,47,2,232,281,50,0,231,281,44,0,237,281,15,25,241,281
1735311,1687,178029,new-0.5,completed,266.0,7.35,186,80,12,7,247,266,23,0,243,266,2,1,263,266,0,3,263,266,27,47,192,266
1735311,1687,178029,new-1.0,completed,286.0,7.45,172,114,12,22,252,286,35,6,245,286,42,0,244,286,0,63,223,286,39,4,243,286
1735311,1687,239735,base,completed,300.0,6.85,166,134,51,0,249,300,0,48,252,300,52,0,248,300,9,70,221,300,52,10,238,300
1735311,1687,239735,base+,completed,287.0,6.9,159,128,15,30,242,287,0,42,245,287,42,0,245,287,36,20,231,287,47,41,199,287
1735311,1687,239735,dpv1,completed,275.0,7.1,148,127,29,0,246,275,18,0,257,275,7,46,222,275,10,102,163,275,0,0,275,275
1735311,1687,239735,dpv2,completed,286.0,7.3,149,137,54,17,215,286,13,112,161,286,28,0,258,286,17,0,269,286,0,0,286,286
1735311,1687,239735,new-0.0,completed,283.0,7.1,194,89,64,0,219,283,15,34,234,283,0,0,283,283,77,0,206,283,77,0,206,283
1735311,1687,239735,new-0.5,completed,276.0,7.5,164,112,15,30,231,276,24,0,252,276,40,62,174,276,0,21,255,276,23,0,253,276
1735311,1687,239735,new-1.0,completed,286.0,7.4,149,137,42,23,221,286,0,0,286,286,33,0,253,286,43,84,159,286,13,14,259,286
1735311,1687,675528,base,completed,315.0,6.7,161,154,11,127,177,315,51,0,264,315,84,0,231,315,0,73,242,315,43,0,272,315
1735311,1687,675528,base+,completed,289.0,6.95,150,139,14,0,275,289,0,68,221,289,57,0,232,289,35,23,231,289,17,0,272,289
1735311,1687,675528,dpv1,completed,302.0,7.05,112,190,7,167,128,302,27,0,275,302,36,41,225,302,0,0,302,302,3,0,299,302
1735311,1687,675528,dpv2,completed,313.0,7.5,149,164,0,0,313,313,10,141,162,313,43,42,228,313,52,0,261,313,49,0,264,313
1735311,1687,675528,new-0.0,completed,279.0,7.1,208,71,70,0,209,279,47,0,232,279,0,1,278,279,16,19,244,279,61,0,218,279
1735311,1687,675528,new-0.5,completed,278.0,7.5,189,89,13,20,245,278,25,0,253,278,38,38,202,278,0,2,276,278,7,1,270,278
1735311,1687,675528,new-1.0,completed,318.0,7.45,154,164,16,78,224,318,90,0,228,318,0,0,318,318,49,32,237,318,91,23,204,318
1735311,1687,380692,base,completed,323.0,6.55,96,227,48,46,229,323,70,75,178,323,13,64,246,323,0,0,323,323,35,96,192,323
1735311,1687,380692,base+,completed,286.0,7.1,100,186,11,29,246,286,29,0,257,286,0,11,275,286,13,129,144,286,33,0,253,286
1735311,1687,380692,dpv1,completed,291.0,6.95,121,170,18,142,131,291,24,0,267,291,9,0,282,291,28,42,221,291,0,0,291,291
1735311,1687,380692,dpv2,completed,283.0,7.45,204,79,57,13,213,283,0,0,283,283,66,0,217,283,10,16,257,283,63,0,220,283
1735311,1687,380692,new-0.0,completed,294.0,7.25,202,92,84,0,210,294,20,30,244,294,79,0,215,294,76,0,218,294,0,8,286,294
1735311,1687,380692,new-0.5,completed,284.0,7.3,207,77,46,0,238,284,46,9,229,284,0,14,270,284,41,0,243,284,15,22,247,284
1735311,1687,380692,new-1.0,completed,276.0,7.45,168,108,0,5,271,276,28,4,244,276,4,0,272,276,42,61,173,276,14,1,261,276
4383796,1854,310811,base,completed,338.0,7.25,169,169,5,51,282,338,49,109,180,338,0,0,338,338,60,0,278,338,54,0,284,338
4383796,1854,310811,base+,completed,316.0,7.0,180,136,9,0,307,316,0,0,316,316,32,54,230,316,57,0,259,316,14,79,223,316
4383796,1854,310811,dpv1,completed,309.0,7.3,177,132,19,0,290,309,58,74,177,309,7,31,271,309,0,0,309,309,37,0,272,309
4383796,1854,310811,dpv2,completed,333.0,7.75,157,176,7,33,293,333,38,86,209,333,57,0,276,333,0,33,300,333,65,19,249,333
4383796,1854,310811,new-0.0,completed,304.0,7.05,206,98,0,0,304,304,59,3,242,304,81,6,217,304,12,5,287,304,50,3,251,304
4383796,1854,310811,new-0.5,completed,301.0,7.95,199,102,69,5,227,301,37,26,238,301,0,0,301,301,0,0,301,301,47,17,237,301
4383796,1854,310811,new-1.0,completed,307.0,7.75,165,142,0,0,307,307,40,39,228,307,86,17,204,307,6,0,301,307,28,0,279,307
4383796,1854,208428,base,completed,410.0,7.25,111,299,0,172,238,410,12,128,270,410,62,0,348,410,93,86,231,410,80,54,276,410
4383796,1854,208428,base+,completed,343.0,7.25,156,187,0,31,312,343,63,54,226,343,12,21,310,343,60,0,283,343,21,116,206,343
4383796,1854,208428,dpv1,completed,303.0,7.35,186,117,22,0,281,303,0,0,303,303,25,61,217,303,56,0,247,303,10,15,278,303
4383796,1854,208428,dpv2,completed,319.0,7.9,186,133,70,35,214,319,58,5,256,319,7,23,289,319,0,0,319,319,61,0,258,319
4383796,1854,208428,new-0.0,completed,285.0,7.2,210,75,27,0,258,285,0,0,285,285,1,15,269,285,49,9,227,285,24,2,259,285
4383796,1854,208428,new-0.5,completed,306.0,7.65,234,72,50,0,256,306,70,2,234,306,61,0,245,306,32,0,274,306,0,0,306,306
4383796,1854,208428,new-1.0,completed,324.0,7.75,201,123,51,36,237,324,75,17,232,324,61,1,262,324,0,0,324,324,26,0,298,324
4383796,1854,460300,base,completed,331.0,7.25,165,166,35,89,207,331,23,65,243,331,4,33,294,331,55,0,276,331,0,0,331,331
4383796,1854,460300,base+,completed,328.0,7.1,178,150,68,0,260,328,43,71,214,328,0,0,328,328,47,63,218,328,12,0,316,328
4383796,1854,460300,dpv1,completed,318.0,7.4,194,124,44,0,274,318,0,0,318,318,24,16,278,318,58,0,260,318,33,66,219,318
4383796,1854,460300,dpv2,completed,341.0,7.75,173,168,0,32,309,341,52,75,214,341,73,0,268,341,52,58,231,341,1,0,340,341
4383796,1854,460300,new-0.0,completed,307.0,7.2,223,84,48,0,259,307,17,2,288,307,0,0,307,307,68,14,225,307,57,0,250,307
4383796,1854,460300,new-0.5,completed,321.0,7.6,206,115,73,0,248,321,75,3,243,321,0,0,321,321,24,33,264,321,76,3,242,321
4383796,1854,460300,new-1.0,completed,319.0,7.85,203,116,53,22,244,319,0,21,298,319,50,4,265,319,19,2,298,319,77,0,242,319
4383796,1854,309704,base,completed,321.0,7.1,167,154,49,42,230,321,18,0,303,321,61,29,231,321,0,0,321,321,27,46,248,321
4383796,1854,309704,base+,completed,327.0,7.25,138,189,72,24,231,327,4,112,211,327,0,16,311,327,49,0,278,327,49,10,268,327
4383796,1854,309704,dpv1,completed,299.0,7.4,195,104,48,0,251,299,0,0,299,299,10,10,279,299,10,0,289,299,22,56,221,299
4383796,1854,309704,dpv2,completed,324.0,7.55,152,172,62,0,262,324,10,0,314,324,15,23,286,324,66,9,249,324,0,83,241,324
4383796,1854,309704,new-0.0,completed,306.0,7.2,226,80,77,0,229,306,65,0,241,306,0,2,304,306,24,1,281,306,50,0,256,306
4383796,1854,309704,new-0.5,completed,309.0,7.8,206,103,32,0,277,309,70,1,238,309,0,0,309,309,20,21,268,309,79,2,228,309
4383796,1854,309704,new-1.0,completed,322.0,7.9,201,121,80,14,228,322,0,15,307,322,37,0,285,322,47,12,263,322,65,1,256,322
4383796,1854,247588,base,completed,323.0,7.1,154,169,17,61,245,323,69,0,254,323,23,0,300,323,22,0,301,323,0,71,252,323
4383796,1854,247588,base+,completed,335.0,7.0,161,174,54,55,226,335,54,107,174,335,0,6,329,335,67,0,268,335,5,0,330,335
4383796,1854,247588,dpv1,completed,309.0,7.45,183,126,59,0,250,309,0,0,309,309,27,4,278,309,60,0,249,309,32,66,211,309
4383796,1854,247588,dpv2,completed,331.0,7.75,154,177,13,40,278,331,35,95,201,331,68,0,263,331,47,50,234,331,0,0,331,331
4383796,1854,247588,new-0.0,completed,300.0,7.05,195,105,16,10,274,300,42,12,246,300,76,3,221,300,0,0,300,300,54,8,238,300
4383796,1854,247588,new-0.5,completed,291.0,7.75,205,86,14,0,277,291,0,2,289,291,53,0,238,291,9,14,268,291,48,17,226,291
4383796,1854,247588,new-1.0,completed,299.0,7.8,194,105,62,2,235,299,34,28,237,299,23,21,255,299,0,0,299,299,5,0,294,299
4383796,1854,203195,base,completed,317.0,7.15,194,123,30,23,264,317,48,27,242,317,0,0,317,317,43,0,274,317,75,0,242,317
4383796,1854,203195,base+,completed,332.0,6.8,192,140,0,0,332,332,53,62,217,332,60,0,272,332,12,0,320,332,42,75,215,332
4383796,1854,203195,dpv1,completed,327.0,7.35,179,148,49,0,278,327,58,90,179,327,52,0,275,327,0,0,327,327,13,30,284,327
4383796,1854,203195,dpv2,completed,347.0,7.75,163,184,11,34,302,347,53,91,203,347,72,0,275,347,60,59,228,347,0,0,347,347
4383796,1854,203195,new-0.0,completed,312.0,7.25,240,72,70,0,242,312,65,0,247,312,66,0,246,312,31,2,279,312,0,0,312,312
4383796,1854,203195,new-0.5,completed,309.0,7.85,206,103,42,25,242,309,70,0,239,309,0,0,309,309,11,0,298,309,49,20,240,309
4383796,1854,203195,new-1.0,completed,320.0,7.9,188,132,61,16,243,320,48,71,201,320,53,0,267,320,17,0,303,320,0,0,320,320
4383796,1854,178029,base,completed,366.0,6.9,134,232,54,121,191,366,50,54,262,366,4,124,238,366,0,94,272,366,9,0,357,366
4383796,1854,178029,base+,completed,325.0,6.9,180,145,28,76,221,325,0,0,325,325,69,0,256,325,45,60,220,325,11,0,314,325
4383796,1854,178029,dpv1,completed,313.0,7.25,165,148,72,0,241,313,18,37,258,313,40,0,273,313,13,8,292,313,0,31,282,313
4383796,1854,178029,dpv2,completed,338.0,7.75,160,178,6,38,294,338,38,88,212,338,68,0,270,338,42,54,242,338,0,0,338,338
4383796,1854,178029,new-0.0,completed,305.0,7.25,219,86,48,3,254,305,55,8,242,305,12,7,286,305,57,11,237,305,0,0,305,305
4383796,1854,178029,new-0.5,completed,313.0,7.7,219,94,62,10,241,313,71,0,242,313,59,15,239,313,32,0,281,313,0,0,313,313
4383796,1854,178029,new-1.0,completed,317.0,7.85,202,115,71,9,237,317,60,43,214,317,52,1,264,317,20,0,297,317,0,0,317,317
4383796,1854,239735,base,completed,332.0,6.8,169,163,70,61,201,332,47,0,285,332,30,93,209,332,0,13,319,332,27,0,305,332
4383796,1854,239735,base+,completed,331.0,7.25,167,164,48,76,207,331,9,20,302,331,76,0,255,331,41,56,234,331,0,0,331,331
4383796,1854,239735,dpv1,completed,314.0,7.4,171,143,53,0,261,314,0,0,314,314,30,88,196,314,55,0,259,314,25,24,265,314
4383796,1854,239735,dpv2,completed,323.0,7.55,150,173,0,0,323,323,38,0,285,323,39,3,281,323,62,85,176,323,28,72,223,323
4383796,1854,239735,new-0.0,completed,294.0,7.15,215,79,0,0,294,294,60,5,229,294,24,0,270,294,73,1,220,294,29,0,265,294
4383796,1854,239735,new-0.5,completed,303.0,7.75,206,97,40,0,263,303,75,4,224,303,71,0,232,303,31,9,263,303,0,9,294,303
4383796,1854,239735,new-1.0,completed,290.0,7.6,191,99,0,0,290,290,56,8,226,290,38,43,209,290,3,0,287,290,25,0,265,290
4383796,1854,675528,base,completed,318.0,6.95,173,145,60,0,258,318,0,28,290,318,3,0,315,318,26,49,243,318,36,42,240,318
4383796,1854,675528,base+,completed,330.0,7.2,166,164,72,0,258,330,62,1,267,330,0,57,273,330,28,0,302,330,43,61,226,330
4383796,1854,675528,dpv1,completed,313.0,7.4,202,111,0,0,313,313,7,0,306,313,16,22,275,313,48,0,265,313,22,63,228,313
4383796,1854,675528,dpv2,completed,335.0,7.55,159,176,61,0,274,335,42,0,293,335,25,28,282,335,64,18,253,335,0,84,251,335
4383796,1854,675528,new-0.0,completed,315.0,7.25,230,85,0,0,315,315,72,0,243,315,72,0,243,315,21,13,281,315,70,0,245,315
4383796,1854,675528,new-0.5,completed,318.0,7.7,220,98,0,0,318,318,29,0,289,318,65,4,249,318,81,0,237,318,68,17,233,318
4383796,1854,675528,new-1.0,completed,305.0,7.5,188,117,12,0,293,305,0,23,282,305,31,23,251,305,71,0,234,305,29,2,274,305
4383796,1854,380692,base,completed,330.0,7.1,171,159,47,83,200,330,0,0,330,330,70,43,217,330,51,9,270,330,7,49,274,330
4383796,1854,380692,base+,completed,321.0,7.0,165,156,36,100,185,321,0,0,321,321,48,0,273,321,34,56,231,321,5,0,316,321
4383796,1854,380692,dpv1,completed,329.0,7.35,169,160,48,0,281,329,68,92,169,329,8,0,321,329,62,0,267,329,0,36,293,329
4383796,1854,380692,dpv2,completed,317.0,7.75,177,140,36,12,269,317,80,24,213,317,8,24,285,317,65,0,252,317,0,0,317,317
4383796,1854,380692,new-0.0,completed,296.0,7.15,226,70,0,5,291,296,54,2,240,296,16,5,275,296,55,3,238,296,38,0,258,296
4383796,1854,380692,new-0.5,completed,301.0,7.9,209,92,68,6,227,301,51,18,232,301,14,0,287,301,34,0,267,301,0,0,301,301
4383796,1854,380692,new-1.0,completed,307.0,7.75,198,109,5,0,302,307,70,2,235,307,0,26,281,307,47,26,234,307,15,0,292,307
